ID,GameID,Team,PlayerID,Number,Name,Min,FGM,FGA,FGP,FGM2,FGA2,FGP2,FGM3,FGA3,FGP3,FTM,FTA,FTP,Oreb,Dreb,Reb,Ast,PF,TO,STL,BLK,PTS
374975,422_14_01,CROATIA,1844,4,ante tomic,25,3,4,75,3,4,75,0,0,0,2,2,100,3,8,11,4,0,5,1,0,8
374976,422_14_01,CROATIA,1121,5,luksa andric,0,0,0,0,0,0,0,0,0,0,0,0,0,0,0,0,0,0,0,0,0,0
374977,422_14_01,CROATIA,25431,6,oliver lafayette,28,2,5,40,2,2,100,0,3,0,0,2,0,1,0,1,2,3,0,0,0,4
374978,422_14_01,CROATIA,6280,7,bojan bogdanovic,39,9,18,50,7,14,50,2,4,50,6,6,100,1,2,3,1,4,6,2,0,26
374979,422_14_01,CROATIA,15894,8,dario saric,29,4,8,50,4,5,80,0,3,0,2,2,100,4,5,9,4,5,3,1,1,10
374980,422_14_01,CROATIA,1846,9,damjan rudez,14,1,5,20,1,1,100,0,4,0,2,2,100,0,1,1,0,1,0,1,0,4
374981,422_14_01,CROATIA,4585,10,roko ukic,17,2,4,50,1,2,50,1,2,50,0,0,0,0,0,0,1,2,0,0,0,5
374982,422_14_01,CROATIA,1249,11,krunoslav simon,30,3,7,42.9,1,3,33.3,2,4,50,4,4,100,0,7,7,3,3,2,1,0,12
374983,422_14_01,CROATIA,1250,12,damir markota,14,2,5,40,1,2,50,1,3,33.3,0,0,0,1,3,4,1,2,0,0,2,5
374984,422_14_01,CROATIA,18415,13,mario hezonja,0,0,0,0,0,0,0,0,0,0,0,0,0,0,0,0,0,0,0,0,0,0
374985,422_14_01,CROATIA,16607,14,luka zoric,22,1,3,33.3,1,3,33.3,0,0,0,2,2,100,0,5,5,0,3,4,1,1,4
374986,422_14_01,CROATIA,13759,15,luka babic,7,1,2,50,0,0,0,1,2,50,0,0,0,0,1,1,0,0,0,0,0,3
374987,422_14_01,CROATIA,0,TOTALS,CROATIA,225,28,61,45.9,21,36,58.3,7,25,28,18,20,90,10,33,43,16,23,21,7,4,81
374988,422_14_01,PHILIPPINES,9696,4,jim alapag,24,1,4,25,0,0,0,1,4,25,1,1,100,1,1,2,6,1,0,1,0,4
374989,422_14_01,PHILIPPINES,23359,5,lewis tenorio,11,1,4,25,1,4,25,0,0,0,0,0,0,2,1,3,0,3,0,0,0,2
374990,422_14_01,PHILIPPINES,25432,6,jeff chan,30,5,10,50,1,4,25,4,6,66.7,3,3,100,0,1,1,0,1,2,4,0,17
374991,422_14_01,PHILIPPINES,23361,7,jayson william,14,2,8,25,1,4,25,1,4,25,1,2,50,0,1,1,2,3,1,0,0,6
374992,422_14_01,PHILIPPINES,23362,8,gary david,0,0,0,0,0,0,0,0,0,0,0,0,0,0,0,0,0,0,0,0,0,0
374993,422_14_01,PHILIPPINES,18657,9,ranidel de ocampo,15,2,7,28.6,1,2,50,1,5,20,0,0,0,0,1,1,0,0,0,0,0,5
374994,422_14_01,PHILIPPINES,9700,10,gabe norwood,31,1,6,16.7,1,3,33.3,0,3,0,0,0,0,2,1,3,2,5,1,1,0,2
374995,422_14_01,PHILIPPINES,25433,11,andray blatche,41,10,24,41.7,7,20,35,3,4,75,5,7,71.4,1,11,12,0,3,7,1,0,28
374996,422_14_01,PHILIPPINES,23364,12,june mar fajardo,9,1,2,50,1,2,50,0,0,0,0,0,0,1,2,3,0,2,0,0,1,2
374997,422_14_01,PHILIPPINES,25434,13,paul dalistan,15,1,4,25,1,2,50,0,2,0,0,0,0,1,0,1,2,1,0,0,0,2
374998,422_14_01,PHILIPPINES,14184,14,japeth aguilar,5,0,2,0,0,2,0,0,0,0,0,0,0,1,0,1,0,1,1,0,0,0
374999,422_14_01,PHILIPPINES,23365,15,marc pingris,30,5,8,62.5,5,8,62.5,0,0,0,0,0,0,3,1,4,1,3,3,1,0,10
375000,422_14_01,PHILIPPINES,0,TOTALS,PHILIPPINES,225,29,79,36.7,19,51,37.3,10,28,35.7,10,13,76.9,14,24,38,13,23,15,8,1,78
375001,422_14_02,UKRAINE,5790,4,maksym pustozvonov,16,1,3,33.3,1,2,50,0,1,0,3,4,75,0,2,2,2,2,1,3,1,5
375002,422_14_02,UKRAINE,25435,5,"eugene ""pooh"" jeter",28,5,12,41.7,2,6,33.3,3,6,50,3,4,75,0,1,1,2,2,4,0,0,16
375003,422_14_02,UKRAINE,12946,6,olexandr mishula,14,3,5,60,1,2,50,2,3,66.7,0,0,0,0,0,0,1,0,0,0,0,8
375004,422_14_02,UKRAINE,22292,7,sviatoslav mykhailiuk,0,0,0,0,0,0,0,0,0,0,0,0,0,0,0,0,0,0,0,0,0,0
375005,422_14_02,UKRAINE,7931,8,sergii gladyr,26,2,6,33.3,0,2,0,2,4,50,6,7,85.7,0,3,3,3,2,3,1,0,12
375006,422_14_02,UKRAINE,10926,9,oleksandr lypovyy,24,1,4,25,0,0,0,1,4,25,1,4,25,0,3,3,1,1,0,0,0,4
375007,422_14_02,UKRAINE,8223,10,kyryl natyazhko,20,1,6,16.7,1,6,16.7,0,0,0,0,0,0,1,5,6,1,1,2,1,0,2
375008,422_14_02,UKRAINE,1026,11,dmytro zabirchenko,14,1,2,50,0,0,0,1,2,50,0,0,0,0,0,0,0,3,1,0,0,3
375009,422_14_02,UKRAINE,5791,12,maxym kornienko,20,4,7,57.1,3,6,50,1,1,100,0,0,0,2,5,7,1,2,1,1,0,9
375010,422_14_02,UKRAINE,10713,13,ihor zaytsev,18,0,2,0,0,0,0,0,2,0,0,0,0,0,2,2,0,2,2,0,0,0
375011,422_14_02,UKRAINE,19863,14,artem pustovyi,0,0,0,0,0,0,0,0,0,0,0,0,0,0,0,0,0,0,0,0,0,0
375012,422_14_02,UKRAINE,5792,15,slava kravtsov,20,4,4,100,4,4,100,0,0,0,5,7,71.4,3,4,7,0,3,3,0,0,13
375013,422_14_02,UKRAINE,0,TOTALS,UKRAINE,200,22,51,43.1,12,28,42.9,10,23,43.5,18,26,69.2,6,30,36,11,18,17,6,1,72
375014,422_14_02,DOMINICAN REPUBLIC,19011,4,edgar sosa,28,4,9,44.4,3,4,75,1,5,20,2,4,50,0,3,3,2,3,2,0,0,11
375015,422_14_02,DOMINICAN REPUBLIC,461,5,manuel fortuna,3,0,1,0,0,0,0,0,1,0,0,0,0,0,0,0,0,0,0,0,0,0
375016,422_14_02,DOMINICAN REPUBLIC,14632,6,juan coronado,13,1,4,25,1,1,100,0,3,0,0,0,0,0,0,0,1,3,1,1,0,2
375017,422_14_02,DOMINICAN REPUBLIC,25436,7,victor liz,12,1,5,20,1,4,25,0,1,0,0,0,0,0,1,1,0,4,3,1,0,2
375018,422_14_02,DOMINICAN REPUBLIC,23761,8,edward santana,0,0,0,0,0,0,0,0,0,0,0,0,0,0,0,0,0,0,0,0,0,0
375019,422_14_02,DOMINICAN REPUBLIC,4116,9,francisco garcia,30,6,13,46.2,2,5,40,4,8,50,2,2,100,0,3,3,4,4,1,0,1,18
375020,422_14_02,DOMINICAN REPUBLIC,23762,10,james feldeine,31,4,13,30.8,2,6,33.3,2,7,28.6,0,1,0,1,3,4,1,1,2,2,0,10
375021,422_14_02,DOMINICAN REPUBLIC,19070,11,eloy vargas,22,1,3,33.3,1,3,33.3,0,0,0,2,4,50,2,7,9,1,1,1,0,1,4
375022,422_14_02,DOMINICAN REPUBLIC,19016,12,orlando sanchez,11,2,2,100,2,2,100,0,0,0,1,2,50,1,2,3,1,0,2,0,0,5
375023,422_14_02,DOMINICAN REPUBLIC,9947,13,eulis baez,28,2,6,33.3,2,5,40,0,1,0,0,0,0,6,3,9,3,4,3,0,0,4
375024,422_14_02,DOMINICAN REPUBLIC,16889,14,ronald ramon,4,0,0,0,0,0,0,0,0,0,0,0,0,0,0,0,0,0,0,0,0,0
375025,422_14_02,DOMINICAN REPUBLIC,430,15,jack martinez,18,3,8,37.5,3,7,42.9,0,1,0,0,1,0,2,3,5,0,2,2,0,0,6
375026,422_14_02,DOMINICAN REPUBLIC,0,TOTALS,DOMINICAN REPUBLIC,200,24,64,37.5,17,37,45.9,7,27,25.9,7,14,50,13,28,41,13,22,17,4,2,62
375027,422_14_03,ANGOLA,1,4,olimpio cipriano,28,6,12,50,2,7,28.6,4,5,80,0,0,0,0,1,1,3,2,1,2,0,16
375028,422_14_03,ANGOLA,3574,5,armando costa,33,2,5,40,1,2,50,1,3,33.3,1,2,50,0,6,6,6,4,1,0,0,6
375029,422_14_03,ANGOLA,16597,6,roberto fortes,17,0,2,0,0,1,0,0,1,0,0,0,0,0,1,1,1,2,1,0,0,0
375030,422_14_03,ANGOLA,13818,7,edson ndoniema,7,1,5,20,1,5,20,0,0,0,0,0,0,1,0,1,0,3,1,0,0,2
375031,422_14_03,ANGOLA,11834,8,gildo santos,0,0,0,0,0,0,0,0,0,0,0,0,0,0,0,0,0,0,0,0,0,0
375032,422_14_03,ANGOLA,7039,9,valdelicio joaquim,17,2,5,40,2,4,50,0,1,0,2,4,50,0,7,7,1,1,3,0,1,6
375033,422_14_03,ANGOLA,7,10,joaquim gomes,0,0,0,0,0,0,0,0,0,0,0,0,0,0,0,0,0,0,0,0,0,0
375034,422_14_03,ANGOLA,23104,11,reggie moore,17,3,5,60,1,3,33.3,2,2,100,2,2,100,0,6,6,0,1,2,1,0,10
375035,422_14_03,ANGOLA,11831,12,yanick moreira,23,7,11,63.6,7,11,63.6,0,0,0,2,2,100,6,4,10,0,1,2,0,0,16
375036,422_14_03,ANGOLA,13822,13,islando manuel,5,0,3,0,0,2,0,0,1,0,0,2,0,0,0,0,0,0,0,0,0,0
375037,422_14_03,ANGOLA,21052,14,milton barros,21,2,4,50,2,2,100,0,2,0,6,6,100,1,1,2,2,3,2,1,0,10
375038,422_14_03,ANGOLA,12,15,eduardo mingas,33,4,7,57.1,3,5,60,1,2,50,5,6,83.3,1,4,5,1,2,3,0,1,14
375039,422_14_03,ANGOLA,0,TOTALS,ANGOLA,200,27,59,45.8,19,42,45.2,8,17,47.1,18,24,75,12,34,46,14,19,16,4,2,80
375040,422_14_03,KOREA,18641,4,taejong moon,21,3,7,42.9,1,2,50,2,5,40,0,0,0,2,2,4,4,4,1,1,0,8
375041,422_14_03,KOREA,18640,5,chan hee park,5,0,0,0,0,0,0,0,0,0,0,0,0,0,0,0,0,1,2,0,0,0
375042,422_14_03,KOREA,9631,6,donggeun yang,22,4,13,30.8,1,5,20,3,8,37.5,0,0,0,1,1,2,2,3,2,0,0,11
375043,422_14_03,KOREA,11667,7,taesul kim,8,0,2,0,0,2,0,0,0,0,0,0,0,0,0,0,0,2,1,0,0,0
375044,422_14_03,KOREA,14338,8,jonghyun lee,19,1,1,100,1,1,100,0,0,0,2,6,33.3,1,2,3,0,0,0,0,2,4
375045,422_14_03,KOREA,9054,9,sunhyung kim,25,7,13,53.8,6,9,66.7,1,4,25,0,1,0,0,4,4,5,0,1,1,0,15
375046,422_14_03,KOREA,18643,10,sungmin cho,30,4,13,30.8,2,4,50,2,9,22.2,0,0,0,0,4,4,2,2,0,1,0,10
375047,422_14_03,KOREA,9635,11,heejong yang,9,1,2,50,0,1,0,1,1,100,0,0,0,4,1,5,0,2,0,0,0,3
375048,422_14_03,KOREA,3914,12,joo sung kim,19,2,6,33.3,2,5,40,0,1,0,2,2,100,1,3,4,2,3,0,1,1,6
375049,422_14_03,KOREA,25437,13,ilyoung heo,5,0,3,0,0,0,0,0,3,0,0,0,0,0,0,0,0,0,0,0,0,0
375050,422_14_03,KOREA,11670,14,sekeun oh,17,2,5,40,2,5,40,0,0,0,0,0,0,1,2,3,0,4,1,0,0,4
375051,422_14_03,KOREA,18644,15,jongkyu kim,21,3,8,37.5,3,7,42.9,0,1,0,2,2,100,1,0,1,2,1,1,0,3,8
375052,422_14_03,KOREA,0,TOTALS,KOREA,200,27,73,37,18,41,43.9,9,32,28.1,6,11,54.5,15,21,36,17,22,9,4,6,69
375053,422_14_04,EGYPT,18379,4,seif samir,4,1,2,50,1,2,50,0,0,0,0,0,0,1,0,1,0,0,1,0,0,2
375054,422_14_04,EGYPT,25438,5,amr gendy,18,3,10,30,2,6,33.3,1,4,25,4,7,57.1,1,3,4,0,1,0,0,0,11
375055,422_14_04,EGYPT,13947,6,haytham kamal,30,3,7,42.9,3,6,50,0,1,0,2,2,100,2,2,4,2,1,0,1,2,8
375056,422_14_04,EGYPT,9153,7,wael badr,14,0,1,0,0,1,0,0,0,0,0,0,0,0,1,1,1,0,0,1,0,0
375057,422_14_04,EGYPT,9156,8,moamen abouelanin,9,0,1,0,0,0,0,0,1,0,0,0,0,0,0,0,0,0,0,0,0,0
375058,422_14_04,EGYPT,9154,9,ibrahim elgammal,30,5,14,35.7,3,7,42.9,2,7,28.6,0,0,0,2,1,3,3,2,3,2,0,12
375059,422_14_04,EGYPT,18516,10,mouhanad elsabagh,14,1,4,25,0,1,0,1,3,33.3,0,0,0,0,1,1,5,1,2,0,0,3
375060,422_14_04,EGYPT,25439,11,sherif genedy,15,4,7,57.1,3,4,75,1,3,33.3,0,0,0,0,1,1,0,0,0,0,0,9
375061,422_14_04,EGYPT,16644,12,youssef shousha,20,1,4,25,0,3,0,1,1,100,3,4,75,0,2,2,1,3,0,2,0,6
375062,422_14_04,EGYPT,25440,13,moustafa elmekawi,19,3,6,50,3,5,60,0,1,0,1,3,33.3,2,3,5,0,4,0,1,0,7
375063,422_14_04,EGYPT,18519,14,ramy ibrahim,20,3,7,42.9,3,5,60,0,2,0,0,1,0,0,2,2,2,5,4,0,0,6
375064,422_14_04,EGYPT,9161,15,ashraf rabie,7,0,0,0,0,0,0,0,0,0,0,0,0,0,1,1,0,1,0,0,0,0
375065,422_14_04,EGYPT,0,TOTALS,EGYPT,200,24,63,38.1,18,40,45,6,23,26.1,10,17,58.8,8,22,30,14,18,12,7,2,64
375066,422_14_04,SERBIA,5751,4,milos teodosic,18,5,7,71.4,1,1,100,4,6,66.7,1,2,50,0,4,4,0,2,3,0,0,15
375067,422_14_04,SERBIA,2100,5,marko simonovic,15,2,5,40,2,3,66.7,0,2,0,0,2,0,0,1,1,1,1,0,0,0,4
375068,422_14_04,SERBIA,25441,6,stefan jovic,18,2,3,66.7,1,2,50,1,1,100,1,2,50,0,1,1,4,2,3,1,0,6
375069,422_14_04,SERBIA,17361,7,bogdan bogdanovic,22,1,3,33.3,0,0,0,1,3,33.3,0,0,0,1,2,3,4,1,0,1,1,3
375070,422_14_04,SERBIA,15386,8,nemanja bjelica,22,3,7,42.9,3,4,75,0,3,0,1,2,50,1,5,6,2,3,2,1,1,7
375071,422_14_04,SERBIA,2654,9,stefan markovic,19,0,3,0,0,1,0,0,2,0,2,2,100,0,3,3,4,2,1,1,0,2
375072,422_14_04,SERBIA,19860,10,nikola kalinic,26,4,7,57.1,3,5,60,1,2,50,2,2,100,1,1,2,2,1,1,0,0,11
375073,422_14_04,SERBIA,15504,11,stefan bircevic,19,5,10,50,4,8,50,1,2,50,0,0,0,2,7,9,1,1,1,1,1,11
375074,422_14_04,SERBIA,93,12,nenad krstic,7,1,4,25,1,4,25,0,0,0,3,4,75,0,0,0,0,2,1,0,0,5
375075,422_14_04,SERBIA,2656,13,miroslav raduljica,14,6,10,60,6,10,60,0,0,0,1,2,50,3,3,6,0,1,0,0,0,13
375076,422_14_04,SERBIA,24202,14,rasko katic,7,2,2,100,2,2,100,0,0,0,0,1,0,0,1,1,0,1,0,0,0,4
375077,422_14_04,SERBIA,5756,15,vladimir stimac,13,2,2,100,2,2,100,0,0,0,0,0,0,1,1,2,0,1,1,1,0,4
375078,422_14_04,SERBIA,0,TOTALS,SERBIA,200,33,63,52.4,25,42,59.5,8,21,38.1,11,19,57.9,11,32,43,18,18,13,6,3,85
375079,422_14_05,NEW ZEALAND,6772,4,lindsay tait,8,0,0,0,0,0,0,0,0,0,0,0,0,1,1,2,3,0,0,0,0,0
375080,422_14_05,NEW ZEALAND,21055,5,everard bartlett,11,0,1,0,0,1,0,0,0,0,0,0,0,0,0,0,0,1,0,1,0,0
375081,422_14_05,NEW ZEALAND,39,6,kirk penney,36,3,11,27.3,2,7,28.6,1,4,25,2,2,100,1,5,6,1,0,2,1,0,9
375082,422_14_05,NEW ZEALAND,6773,7,mika vukona,18,0,2,0,0,2,0,0,0,0,4,6,66.7,3,5,8,2,4,2,3,0,4
375083,422_14_05,NEW ZEALAND,16521,8,jarrod kenny,0,0,0,0,0,0,0,0,0,0,0,0,0,0,0,0,0,0,0,0,0,0
375084,422_14_05,NEW ZEALAND,11656,9,corey webster,26,10,22,45.5,8,12,66.7,2,10,20,0,0,0,0,1,1,2,3,2,0,0,22
375085,422_14_05,NEW ZEALAND,16523,10,thomas abercrombie,20,1,3,33.3,0,1,0,1,2,50,2,2,100,1,6,7,1,3,3,0,0,5
375086,422_14_05,NEW ZEALAND,16524,11,bj anthony,9,1,2,50,1,2,50,0,0,0,0,0,0,0,1,1,1,2,0,0,0,2
375087,422_14_05,NEW ZEALAND,25442,12,isaac fotu,16,3,7,42.9,3,5,60,0,2,0,2,2,100,3,1,4,0,1,1,0,0,8
375088,422_14_05,NEW ZEALAND,6846,13,casey frank,16,2,4,50,1,3,33.3,1,1,100,0,0,0,1,2,3,0,4,3,0,1,5
375089,422_14_05,NEW ZEALAND,13832,14,rob loe,19,4,7,57.1,1,3,33.3,3,4,75,0,2,0,6,0,6,0,2,2,1,0,11
375090,422_14_05,NEW ZEALAND,21056,15,tai webster,22,3,9,33.3,2,5,40,1,4,25,0,0,0,2,3,5,2,2,3,1,0,7
375091,422_14_05,NEW ZEALAND,0,TOTALS,NEW ZEALAND,200,27,68,39.7,18,41,43.9,9,27,33.3,10,14,71.4,21,26,47,12,23,18,7,1,73
375092,422_14_05,TURKEY,20219,4,cedi osman,5,0,1,0,0,0,0,0,1,0,0,0,0,0,1,1,0,2,0,0,0,0
375093,422_14_05,TURKEY,15304,5,sinan guler,33,4,7,57.1,4,4,100,0,3,0,0,0,0,0,2,2,0,2,3,2,0,8
375094,422_14_05,TURKEY,4571,6,baris ermis,0,0,0,0,0,0,0,0,0,0,0,0,0,0,0,0,0,0,0,0,0,0
375095,422_14_05,TURKEY,1798,7,cenk akyol,18,1,4,25,0,1,0,1,3,33.3,4,4,100,0,2,2,1,2,0,2,0,7
375096,422_14_05,TURKEY,2576,8,baris hersek,24,4,7,57.1,1,1,100,3,6,50,0,0,0,1,2,3,3,0,1,0,1,11
375097,422_14_05,TURKEY,7785,9,emir preldzic,34,5,9,55.6,3,5,60,2,4,50,2,2,100,2,4,6,3,1,3,1,1,14
375098,422_14_05,TURKEY,4569,10,kerem tunceri,19,2,4,50,2,2,100,0,2,0,2,2,100,0,3,3,2,2,2,2,0,6
375099,422_14_05,TURKEY,1796,11,oguz savas,12,5,8,62.5,5,8,62.5,0,0,0,6,7,85.7,2,0,2,1,0,0,0,0,16
375100,422_14_05,TURKEY,4576,12,kerem gonlum,10,0,3,0,0,3,0,0,0,0,0,0,0,2,0,2,0,3,1,0,0,0
375101,422_14_05,TURKEY,4572,13,ender arslan,22,3,11,27.3,2,7,28.6,1,4,25,0,0,0,0,0,0,2,3,0,0,0,7
375102,422_14_05,TURKEY,7790,14,omer asik,10,0,1,0,0,1,0,0,0,0,1,2,50,0,0,0,0,2,2,0,2,1
375103,422_14_05,TURKEY,10942,15,furkan aldemir,13,2,5,40,2,5,40,0,0,0,2,4,50,3,2,5,0,3,2,2,0,6
375104,422_14_05,TURKEY,0,TOTALS,TURKEY,200,26,60,43.3,19,37,51.4,7,23,30.4,17,21,81,10,21,31,12,20,14,9,4,76
375105,422_14_06,AUSTRALIA,9039,4,chris goulding,0,0,0,0,0,0,0,0,0,0,0,0,0,0,0,0,0,0,0,0,0,0
375106,422_14_06,AUSTRALIA,13813,5,ryan broekhoff,17,3,4,75,0,0,0,3,4,75,0,0,0,0,0,0,0,2,0,1,1,9
375107,422_14_06,AUSTRALIA,3458,6,adam gibson,6,0,0,0,0,0,0,0,0,0,0,0,0,1,0,1,1,0,1,0,0,0
375108,422_14_06,AUSTRALIA,11635,7,joe ingles,35,5,8,62.5,5,7,71.4,0,1,0,2,5,40,0,1,1,3,2,4,1,0,12
375109,422_14_06,AUSTRALIA,3466,8,brad newley,25,5,7,71.4,4,4,100,1,3,33.3,2,3,66.7,0,2,2,0,3,2,1,0,13
375110,422_14_06,AUSTRALIA,13811,9,matthew dellavedova,29,1,7,14.3,0,4,0,1,3,33.3,0,0,0,1,2,3,5,2,5,2,0,3
375111,422_14_06,AUSTRALIA,25376,10,cameron bairstow,4,0,0,0,0,0,0,0,0,0,0,0,0,1,0,1,0,1,2,0,1,0
375112,422_14_06,AUSTRALIA,20984,11,dante exum,11,0,2,0,0,1,0,0,1,0,0,0,0,1,1,2,1,0,1,0,0,0
375113,422_14_06,AUSTRALIA,16519,12,aron baynes,29,8,13,61.5,8,13,61.5,0,0,0,5,5,100,3,4,7,1,2,3,0,0,21
375114,422_14_06,AUSTRALIA,142,13,david andersen,27,4,11,36.4,3,10,30,1,1,100,5,5,100,1,3,4,1,2,0,0,0,14
375115,422_14_06,AUSTRALIA,13814,14,brock motum,18,3,5,60,3,5,60,0,0,0,2,3,66.7,1,2,3,0,4,1,1,0,8
375116,422_14_06,AUSTRALIA,3457,15,nate jawai,0,0,0,0,0,0,0,0,0,0,0,0,0,0,0,0,0,0,0,0,0,0
375117,422_14_06,AUSTRALIA,0,TOTALS,AUSTRALIA,200,29,57,50.9,23,44,52.3,6,13,46.2,16,21,76.2,10,15,25,12,18,19,6,2,80
375118,422_14_06,SLOVENIA,24203,4,jure balazic,15,2,3,66.7,1,1,100,1,2,50,5,6,83.3,0,1,1,0,3,0,0,0,10
375119,422_14_06,SLOVENIA,5023,5,uros slokar,15,2,2,100,2,2,100,0,0,0,0,0,0,1,2,3,1,3,0,0,1,4
375120,422_14_06,SLOVENIA,17812,6,aleksej nikolic,0,0,0,0,0,0,0,0,0,0,0,0,0,0,0,0,0,0,0,0,0,0
375121,422_14_06,SLOVENIA,17343,7,klemen prepelic,2,0,0,0,0,0,0,0,0,0,0,0,0,0,0,0,0,0,0,0,0,0
375122,422_14_06,SLOVENIA,10978,8,edo muric,20,2,6,33.3,2,5,40,0,1,0,1,2,50,0,1,1,0,3,3,3,1,5
375123,422_14_06,SLOVENIA,15479,9,jaka blazic,15,3,5,60,2,4,50,1,1,100,2,2,100,3,1,4,0,2,1,1,0,9
375124,422_14_06,SLOVENIA,4764,10,miha zupan,14,1,3,33.3,0,1,0,1,2,50,0,0,0,0,1,1,0,3,2,0,0,3
375125,422_14_06,SLOVENIA,1068,11,goran dragic,26,8,12,66.7,5,7,71.4,3,5,60,2,2,100,3,4,7,4,4,5,2,0,21
375126,422_14_06,SLOVENIA,6197,12,zoran dragic,20,4,7,57.1,2,4,50,2,3,66.7,0,0,0,0,1,1,0,4,1,1,0,10
375127,422_14_06,SLOVENIA,1064,13,domen lorbek,32,5,9,55.6,4,5,80,1,4,25,2,2,100,0,0,0,3,1,2,1,1,13
375128,422_14_06,SLOVENIA,5782,14,jaka klobucar,17,3,6,50,2,3,66.7,1,3,33.3,0,0,0,1,2,3,1,0,4,1,0,7
375129,422_14_06,SLOVENIA,17344,15,alen omic,24,4,7,57.1,4,7,57.1,0,0,0,0,0,0,3,4,7,1,4,1,1,0,8
375130,422_14_06,SLOVENIA,0,TOTALS,SLOVENIA,200,34,60,56.7,24,39,61.5,10,21,47.6,12,14,85.7,12,20,32,10,27,19,10,3,90
375131,422_14_07,PUERTO RICO,23748,4,ramon clemente,11,1,2,50,1,2,50,0,0,0,0,0,0,2,4,6,0,2,0,0,0,2
375132,422_14_07,PUERTO RICO,19036,5,jose barea,27,7,14,50,2,6,33.3,5,8,62.5,5,6,83.3,0,2,2,4,2,2,0,0,24
375133,422_14_07,PUERTO RICO,21059,6,alex franklin,10,1,2,50,1,2,50,0,0,0,0,0,0,0,2,2,0,3,0,0,0,2
375134,422_14_07,PUERTO RICO,100,7,carlos arroyo,20,2,8,25,2,5,40,0,3,0,2,4,50,0,0,0,0,4,2,0,0,6
375135,422_14_07,PUERTO RICO,3479,8,angel vassallo,19,4,10,40,3,7,42.9,1,3,33.3,0,0,0,1,3,4,0,3,2,0,0,9
375136,422_14_07,PUERTO RICO,25443,9,carlos rivera,10,2,4,50,1,3,33.3,1,1,100,0,0,0,1,0,1,0,1,0,0,0,5
375137,422_14_07,PUERTO RICO,8997,10,jorge bryan diaz,7,0,2,0,0,2,0,0,0,0,0,0,0,2,2,4,0,0,0,0,0,0
375138,422_14_07,PUERTO RICO,481,11,ricky sanchez,34,2,8,25,2,4,50,0,4,0,2,2,100,0,5,5,1,4,2,0,1,6
375139,422_14_07,PUERTO RICO,7435,12,david huertas,22,1,4,25,1,3,33.3,0,1,0,3,4,75,0,3,3,0,2,2,0,0,5
375140,422_14_07,PUERTO RICO,16592,13,renaldo balkman,26,4,8,50,4,8,50,0,0,0,2,2,100,0,4,4,0,4,1,3,0,10
375141,422_14_07,PUERTO RICO,3478,14,alexander galindo,11,2,4,50,1,1,100,1,3,33.3,1,2,50,0,1,1,0,1,1,0,0,6
375142,422_14_07,PUERTO RICO,108,15,daniel santiago,3,0,0,0,0,0,0,0,0,0,0,0,0,0,0,0,0,0,0,0,0,0
375143,422_14_07,PUERTO RICO,0,TOTALS,PUERTO RICO,200,26,66,39.4,18,43,41.9,8,23,34.8,15,20,75,6,29,35,5,26,12,3,1,75
375144,422_14_07,ARGENTINA,80,4,luis scola,32,7,10,70,7,10,70,0,0,0,6,10,60,2,7,9,2,1,1,0,0,20
375145,422_14_07,ARGENTINA,16652,5,tayavek gallizzi,0,0,0,0,0,0,0,0,0,0,0,0,0,0,0,0,0,0,0,0,0,0
375146,422_14_07,ARGENTINA,12069,6,marcos mata,16,1,2,50,1,2,50,0,0,0,0,0,0,0,0,0,1,5,2,0,0,2
375147,422_14_07,ARGENTINA,21037,7,facundo campazzo,28,2,7,28.6,1,4,25,1,3,33.3,3,4,75,1,1,2,8,2,3,1,0,8
375148,422_14_07,ARGENTINA,357,8,pablo prigioni,23,2,3,66.7,1,2,50,1,1,100,4,4,100,0,0,0,10,4,1,1,0,9
375149,422_14_07,ARGENTINA,12228,9,nicolas laprovittola,0,0,0,0,0,0,0,0,0,0,0,0,0,0,0,0,0,0,0,0,0,0
375150,422_14_07,ARGENTINA,81,10,leo gutierrez,17,1,7,14.3,0,1,0,1,6,16.7,0,0,0,0,0,0,1,3,1,0,0,3
375151,422_14_07,ARGENTINA,14903,11,marcos delia,8,3,4,75,3,4,75,0,0,0,2,4,50,1,1,2,0,3,1,0,0,8
375152,422_14_07,ARGENTINA,77,12,walter herrmann,24,5,9,55.6,5,8,62.5,0,1,0,2,3,66.7,1,9,10,0,0,0,0,0,12
375153,422_14_07,ARGENTINA,82,13,andres nocioni,23,7,13,53.8,4,5,80,3,8,37.5,1,2,50,0,11,11,0,3,0,0,1,18
375154,422_14_07,ARGENTINA,12297,14,matias bortolin,0,0,0,0,0,0,0,0,0,0,0,0,0,0,0,0,0,0,0,0,0,0
375155,422_14_07,ARGENTINA,21197,15,selem safar,29,6,11,54.5,2,3,66.7,4,8,50,2,2,100,0,4,4,0,4,1,0,0,18
375156,422_14_07,ARGENTINA,0,TOTALS,ARGENTINA,200,34,66,51.5,24,39,61.5,10,27,37,20,29,69,7,34,41,22,25,10,2,1,98
375157,422_14_08,FRANCE,12495,4,thomas heurtel,21,3,8,37.5,1,5,20,2,3,66.7,0,0,0,0,1,1,1,4,2,2,0,8
375158,422_14_08,FRANCE,2588,5,nicolas batum,35,4,10,40,2,3,66.7,2,7,28.6,3,4,75,1,4,5,1,3,4,0,1,13
375159,422_14_08,FRANCE,2589,6,antoine diot,19,2,5,40,1,2,50,1,3,33.3,2,2,100,0,3,3,0,0,1,2,0,7
375160,422_14_08,FRANCE,11076,7,joffrey lauvergne,11,1,4,25,1,3,33.3,0,1,0,1,2,50,0,2,2,0,3,1,0,0,3
375161,422_14_08,FRANCE,1864,8,charles kahudi,5,0,1,0,0,1,0,0,0,0,0,0,0,0,1,1,0,0,0,0,0,0
375162,422_14_08,FRANCE,6249,9,edwin jackson,4,0,0,0,0,0,0,0,0,0,0,0,0,0,1,1,0,0,0,0,0,0
375163,422_14_08,FRANCE,12971,10,evan fournier,8,0,1,0,0,0,0,0,1,0,0,0,0,0,0,0,0,1,2,0,0,0
375164,422_14_08,FRANCE,4663,11,florent pietrus,20,0,0,0,0,0,0,0,0,0,2,2,100,2,2,4,1,3,1,0,0,2
375165,422_14_08,FRANCE,17374,12,rudy gobert,19,3,5,60,3,5,60,0,0,0,0,1,0,0,3,3,0,4,0,0,2,6
375166,422_14_08,FRANCE,4665,13,boris diaw,30,6,13,46.2,6,10,60,0,3,0,3,3,100,0,6,6,5,2,3,1,1,15
375167,422_14_08,FRANCE,7987,14,kim tillie,0,0,0,0,0,0,0,0,0,0,0,0,0,0,0,0,0,0,0,0,0,0
375168,422_14_08,FRANCE,5044,15,mickael gelabale,28,3,5,60,2,4,50,1,1,100,2,2,100,1,3,4,1,3,2,0,0,9
375169,422_14_08,FRANCE,0,TOTALS,FRANCE,200,22,52,42.3,16,33,48.5,6,19,31.6,13,16,81.2,4,26,30,9,23,16,5,4,63
375170,422_14_08,BRAZIL,332,4,marcelo machado,3,0,1,0,0,1,0,0,0,0,0,0,0,0,0,0,0,1,0,1,0,0
375171,422_14_08,BRAZIL,14848,5,raulzinho neto,17,3,4,75,3,3,100,0,1,0,0,0,0,1,2,3,0,1,0,1,0,6
375172,422_14_08,BRAZIL,23752,6,rafael hettsheimeir,6,0,0,0,0,0,0,0,0,0,0,0,0,0,0,0,0,1,0,0,0,0
375173,422_14_08,BRAZIL,21034,7,larry taylor,4,0,2,0,0,1,0,0,1,0,0,0,0,0,0,0,0,0,0,0,0,0
375174,422_14_08,BRAZIL,4102,8,alex garcia,25,3,9,33.3,3,5,60,0,4,0,0,0,0,0,2,2,0,2,0,1,0,6
375175,422_14_08,BRAZIL,4098,9,marcelinho huertas,22,5,8,62.5,3,5,60,2,3,66.7,4,6,66.7,0,2,2,5,2,1,1,0,16
375176,422_14_08,BRAZIL,4100,10,leandrinho barbosa,22,2,9,22.2,0,4,0,2,5,40,2,2,100,1,1,2,0,2,1,1,0,8
375177,422_14_08,BRAZIL,4103,11,anderson varejao,21,2,8,25,2,8,25,0,0,0,4,6,66.7,5,4,9,0,3,1,1,1,8
375178,422_14_08,BRAZIL,4104,12,guilherme giovannoni,2,0,0,0,0,0,0,0,0,0,0,0,0,0,0,0,0,1,0,0,0,0
375179,422_14_08,BRAZIL,9844,13,nene hilario,25,2,6,33.3,2,6,33.3,0,0,0,1,4,25,4,4,8,2,3,4,1,0,5
375180,422_14_08,BRAZIL,19020,14,marquinhos vieira,27,4,9,44.4,3,7,42.9,1,2,50,1,2,50,0,6,6,1,1,1,0,0,10
375181,422_14_08,BRAZIL,4106,15,tiago splitter,27,2,5,40,2,5,40,0,0,0,2,4,50,1,2,3,1,4,2,1,1,6
375182,422_14_08,BRAZIL,0,TOTALS,BRAZIL,200,23,61,37.7,18,45,40,5,16,31.2,14,24,58.3,16,26,42,9,21,11,8,2,65
375183,422_14_09,MEXICO,16880,4,paul stoll,16,3,7,42.9,2,2,100,1,5,20,0,0,0,1,4,5,3,1,3,2,0,7
375184,422_14_09,MEXICO,23812,5,marco ramos,18,2,3,66.7,2,3,66.7,0,0,0,0,0,0,1,2,3,0,1,2,0,0,4
375185,422_14_09,MEXICO,23755,6,roman martinez,7,1,3,33.3,1,1,100,0,2,0,0,0,0,1,0,1,2,2,0,0,0,2
375186,422_14_09,MEXICO,23756,7,jorge gutierrez,34,6,9,66.7,5,7,71.4,1,2,50,0,0,0,0,0,0,1,2,5,2,0,13
375187,422_14_09,MEXICO,9836,8,gustavo ayon,26,6,10,60,6,10,60,0,0,0,0,0,0,2,4,6,2,4,1,1,0,12
375188,422_14_09,MEXICO,23813,9,francisco cruz,34,9,17,52.9,6,11,54.5,3,6,50,0,0,0,1,3,4,4,4,2,0,0,21
375189,422_14_09,MEXICO,25444,10,israel gutierrez,0,0,0,0,0,0,0,0,0,0,0,0,0,0,0,0,0,0,0,0,0,0
375190,422_14_09,MEXICO,25445,11,david meza,2,0,0,0,0,0,0,0,0,0,0,0,0,0,0,0,0,1,0,0,0,0
375191,422_14_09,MEXICO,9835,12,hector hernandez,30,2,7,28.6,1,1,100,1,6,16.7,0,0,0,1,3,4,0,1,3,0,1,5
375192,422_14_09,MEXICO,21215,13,orlando mendez,10,0,0,0,0,0,0,0,0,0,2,2,100,0,0,0,0,1,0,0,0,2
375193,422_14_09,MEXICO,25446,14,adrian zamora,15,2,2,100,2,2,100,0,0,0,0,0,0,0,0,0,0,2,1,0,0,4
375194,422_14_09,MEXICO,25447,15,adam parada,8,2,3,66.7,2,3,66.7,0,0,0,0,0,0,0,0,0,0,1,0,0,0,4
375195,422_14_09,MEXICO,0,TOTALS,MEXICO,200,33,61,54.1,27,40,67.5,6,21,28.6,2,2,100,8,18,26,12,20,17,5,1,74
375196,422_14_09,LITHUANIA,1728,4,martynas pocius,11,0,2,0,0,2,0,0,0,0,0,0,0,0,0,0,2,1,0,0,0,0
375197,422_14_09,LITHUANIA,6225,5,adas juskevicius,20,3,4,75,1,1,100,2,3,66.7,0,0,0,1,1,2,3,1,3,0,0,8
375198,422_14_09,LITHUANIA,10639,6,mindaugas kuzminskas,3,0,0,0,0,0,0,0,0,0,0,0,0,0,0,0,0,1,2,0,0,0
375199,422_14_09,LITHUANIA,5073,7,darjus lavrinovic,13,3,3,100,1,1,100,2,2,100,1,3,33.3,0,2,2,2,0,0,0,0,9
375200,422_14_09,LITHUANIA,980,8,jonas maciulis,26,7,11,63.6,3,7,42.9,4,4,100,1,2,50,1,1,2,0,3,4,1,0,19
375201,422_14_09,LITHUANIA,3474,9,renaldas seibutis,31,2,5,40,2,4,50,0,1,0,0,0,0,0,2,2,5,0,1,2,0,4
375202,422_14_09,LITHUANIA,292,10,simas jasaitis,19,3,6,50,1,3,33.3,2,3,66.7,1,2,50,0,1,1,3,1,0,0,0,9
375203,422_14_09,LITHUANIA,8177,11,donatas motiejunas,21,7,12,58.3,6,9,66.7,1,3,33.3,0,0,0,1,3,4,0,0,1,0,1,15
375204,422_14_09,LITHUANIA,21,12,ksistof lavrinovic,0,0,0,0,0,0,0,0,0,0,0,0,0,0,0,0,0,0,0,0,0,0
375205,422_14_09,LITHUANIA,987,13,paulius jankunas,24,1,4,25,1,2,50,0,2,0,2,2,100,0,2,2,1,1,0,0,1,4
375206,422_14_09,LITHUANIA,10916,14,jonas valanciunas,22,8,8,100,8,8,100,0,0,0,1,2,50,3,2,5,1,2,2,0,1,17
375207,422_14_09,LITHUANIA,6221,15,sarunas vasiliauskas,10,1,3,33.3,1,1,100,0,2,0,0,0,0,0,0,0,0,2,1,0,0,2
375208,422_14_09,LITHUANIA,0,TOTALS,LITHUANIA,200,35,58,60.3,24,38,63.2,11,20,55,6,11,54.5,7,18,25,17,12,14,3,3,87
375209,422_14_10,GREECE,8303,4,vaggelis mantzaris,9,2,4,50,0,1,0,2,3,66.7,2,2,100,0,0,0,0,0,0,0,0,8
375210,422_14_10,GREECE,5050,5,giannis bourousis,18,3,7,42.9,3,6,50,0,1,0,1,1,100,2,5,7,2,3,1,0,0,7
375211,422_14_10,GREECE,123,6,nikos zisis,11,0,3,0,0,2,0,0,1,0,0,0,0,0,0,0,3,2,2,0,0,0
375212,422_14_10,GREECE,1053,7,kostas vasileiadis,21,5,8,62.5,2,2,100,3,6,50,0,0,0,0,2,2,0,2,1,1,0,13
375213,422_14_10,GREECE,12472,8,nick calathes,22,2,5,40,2,3,66.7,0,2,0,0,0,0,1,4,5,1,0,4,0,0,4
375214,422_14_10,GREECE,11632,9,andreas glyniadakis,6,2,3,66.7,2,3,66.7,0,0,0,0,0,0,1,2,3,0,4,2,0,0,4
375215,422_14_10,GREECE,10606,10,kostas papanikolaou,21,2,5,40,1,4,25,1,1,100,0,0,0,0,3,3,3,1,1,0,0,5
375216,422_14_10,GREECE,8304,11,kostas sloukas,17,4,6,66.7,2,4,50,2,2,100,0,0,0,0,1,1,4,1,2,0,0,10
375217,422_14_10,GREECE,15374,12,kostas kaimakoglou,22,6,10,60,1,3,33.3,5,7,71.4,0,0,0,3,5,8,2,2,0,1,0,17
375218,422_14_10,GREECE,24314,13,giannis antetokounmpo,19,2,2,100,2,2,100,0,0,0,7,8,87.5,2,3,5,1,2,1,3,0,11
375219,422_14_10,GREECE,1061,14,ian vougioukas,16,0,0,0,0,0,0,0,0,0,3,4,75,0,2,2,2,5,2,0,0,3
375220,422_14_10,GREECE,1056,15,georgios printezis,18,2,6,33.3,2,5,40,0,1,0,1,1,100,0,3,3,1,3,0,0,0,5
375221,422_14_10,GREECE,0,TOTALS,GREECE,200,30,59,50.8,17,35,48.6,13,24,54.2,14,16,87.5,10,33,43,19,25,16,5,0,87
375222,422_14_10,SENEGAL,11764,4,thierno niang,7,0,1,0,0,0,0,0,1,0,0,0,0,0,0,0,1,0,1,0,0,0
375223,422_14_10,SENEGAL,18541,5,xane dalmeida,13,0,3,0,0,2,0,0,1,0,0,0,0,0,0,0,2,1,1,0,0,0
375224,422_14_10,SENEGAL,23085,6,ibrahima thomas,2,0,1,0,0,1,0,0,0,0,0,0,0,0,0,0,0,0,0,0,0,0
375225,422_14_10,SENEGAL,18542,7,mamadou ndoye,21,0,5,0,0,4,0,0,1,0,0,0,0,0,0,0,2,3,3,0,0,0
375226,422_14_10,SENEGAL,18543,8,mohamet diop,4,2,4,50,1,2,50,1,2,50,1,2,50,0,0,0,0,0,0,0,0,6
375227,422_14_10,SENEGAL,3592,9,maleye ndoye,31,3,5,60,1,2,50,2,3,66.7,3,4,75,0,0,0,1,4,0,2,1,11
375228,422_14_10,SENEGAL,25448,10,djibril thiam,0,0,0,0,0,0,0,0,0,0,0,0,0,0,0,0,0,0,0,0,0,0
375229,422_14_10,SENEGAL,9148,11,mouhammad faye,22,1,10,10,1,6,16.7,0,4,0,0,0,0,0,3,3,0,1,1,1,1,2
375230,422_14_10,SENEGAL,25449,12,maurice ndour,22,1,3,33.3,0,2,0,1,1,100,1,2,50,0,3,3,2,4,1,2,1,4
375231,422_14_10,SENEGAL,23089,13,hamady ndiaye,16,3,6,50,3,6,50,0,0,0,0,0,0,3,1,4,1,3,0,1,2,6
375232,422_14_10,SENEGAL,25450,14,gorgui dieng,38,6,13,46.2,6,12,50,0,1,0,9,12,75,4,10,14,0,0,3,3,1,21
375233,422_14_10,SENEGAL,23091,15,abdou badji,24,3,7,42.9,3,7,42.9,0,0,0,8,10,80,2,2,4,0,3,0,1,1,14
375234,422_14_10,SENEGAL,0,TOTALS,SENEGAL,200,19,58,32.8,15,44,34.1,4,14,28.6,22,30,73.3,10,21,31,9,19,11,10,7,64
375235,422_14_11,USA,9010,4,stephen curry,18,1,6,16.7,1,1,100,0,5,0,2,2,100,0,3,3,5,2,1,1,0,4
375236,422_14_11,USA,13751,5,klay thompson,22,7,10,70,3,3,100,4,7,57.1,0,0,0,0,1,1,0,2,2,1,0,18
375237,422_14_11,USA,16600,6,derrick rose,23,3,8,37.5,2,6,33.3,1,2,50,5,5,100,2,0,2,3,2,5,1,2,12
375238,422_14_11,USA,25451,7,kenneth faried,15,3,3,100,3,3,100,0,0,0,0,0,0,3,3,6,0,1,1,0,0,6
375239,422_14_11,USA,3452,8,rudy gay,17,5,9,55.6,5,9,55.6,0,0,0,0,1,0,0,5,5,0,3,2,2,1,10
375240,422_14_11,USA,25452,9,demar derozan,17,1,5,20,1,3,33.3,0,2,0,3,4,75,0,0,0,4,2,1,3,0,5
375241,422_14_11,USA,16977,10,kyrie irving,20,4,7,57.1,3,6,50,1,1,100,0,0,0,0,2,2,4,0,1,2,0,9
375242,422_14_11,USA,12194,11,mason plumlee,12,3,4,75,3,4,75,0,0,0,0,0,0,0,1,1,0,1,1,3,0,6
375243,422_14_11,USA,25453,12,demarcus cousins,16,3,4,75,3,4,75,0,0,0,3,4,75,2,8,10,0,3,2,0,0,9
375244,422_14_11,USA,21035,13,james harden,17,3,5,60,3,4,75,0,1,0,3,3,100,0,3,3,3,0,3,4,1,9
375245,422_14_11,USA,21036,14,anthony davis,14,6,8,75,6,8,75,0,0,0,5,5,100,1,3,4,1,3,0,0,0,17
375246,422_14_11,USA,14750,15,andre drummond,10,4,4,100,4,4,100,0,0,0,1,1,100,2,2,4,0,0,0,1,0,9
375247,422_14_11,USA,0,TOTALS,USA,200,43,73,58.9,37,55,67.3,6,18,33.3,22,25,88,11,35,46,20,19,19,18,4,114
375248,422_14_11,FINLAND,1834,4,mikko koivisto,17,0,4,0,0,2,0,0,2,0,0,0,0,0,0,0,0,1,0,1,0,0
375249,422_14_11,FINLAND,25454,5,erik murphy,27,3,9,33.3,3,6,50,0,3,0,4,4,100,2,5,7,0,1,2,0,0,10
375250,422_14_11,FINLAND,4930,6,kimmo muurinen,13,0,5,0,0,5,0,0,0,0,2,2,100,1,1,2,0,3,4,1,0,2
375251,422_14_11,FINLAND,1314,7,shawn huff,21,3,4,75,1,1,100,2,3,66.7,4,4,100,1,2,3,0,2,1,1,0,12
375252,422_14_11,FINLAND,1836,8,gerald lee,7,2,5,40,2,5,40,0,0,0,0,0,0,1,0,1,0,5,6,0,0,4
375253,422_14_11,FINLAND,11129,9,sasu salin,18,0,8,0,0,6,0,0,2,0,0,0,0,0,0,0,0,1,2,2,0,0
375254,422_14_11,FINLAND,4932,10,tuukka kotti,21,3,6,50,3,6,50,0,0,0,0,2,0,4,1,5,0,3,4,3,1,6
375255,422_14_11,FINLAND,2802,11,petteri koponen,27,5,10,50,3,6,50,2,4,50,0,0,0,1,2,3,4,1,4,2,0,12
375256,422_14_11,FINLAND,8436,12,matti nuutinen,11,1,3,33.3,1,2,50,0,1,0,0,0,0,1,0,1,0,0,2,0,0,2
375257,422_14_11,FINLAND,4935,13,hanno mottola,11,1,6,16.7,1,3,33.3,0,3,0,0,0,0,0,2,2,0,1,0,0,0,2
375258,422_14_11,FINLAND,25455,14,antero lehto,10,0,2,0,0,1,0,0,1,0,0,0,0,0,0,0,0,3,4,0,0,0
375259,422_14_11,FINLAND,4937,15,teemu rannikko,17,0,3,0,0,1,0,0,2,0,5,5,100,0,2,2,1,3,2,0,0,5
375260,422_14_11,FINLAND,0,TOTALS,FINLAND,200,18,65,27.7,14,44,31.8,4,21,19,15,17,88.2,13,18,31,5,24,31,10,1,55
375261,422_14_12,IRAN,23303,4,rouzbeh arghavan,10,0,0,0,0,0,0,0,0,0,0,0,0,0,0,0,0,5,1,0,0,0
375262,422_14_12,IRAN,22993,5,sajjad mashayekhi,0,0,0,0,0,0,0,0,0,0,0,0,0,0,0,0,0,0,0,0,0,0
375263,422_14_12,IRAN,22994,6,behnam yakhchali,20,2,5,40,2,3,66.7,0,2,0,0,0,0,1,1,2,1,3,0,1,0,4
375264,422_14_12,IRAN,9685,7,mahdi kamrani,26,7,11,63.6,4,5,80,3,6,50,1,2,50,0,3,3,2,2,4,3,0,18
375265,422_14_12,IRAN,13745,8,arsalan kazemi,5,0,0,0,0,0,0,0,0,0,0,0,0,0,2,2,0,0,0,1,0,0
375266,422_14_12,IRAN,14408,9,arman zangeneh,6,0,1,0,0,1,0,0,0,0,0,0,0,0,0,0,0,0,0,0,0,0
375267,422_14_12,IRAN,9688,10,hamed afagh,21,1,2,50,1,2,50,0,0,0,0,0,0,1,0,1,2,2,0,1,0,2
375268,422_14_12,IRAN,9690,11,oshin sahakian,21,1,1,100,0,0,0,1,1,100,0,0,0,1,1,2,1,2,0,0,0,3
375269,422_14_12,IRAN,16613,12,asghar kardoust,5,0,0,0,0,0,0,0,0,0,0,2,0,0,0,0,1,4,0,0,0,0
375270,422_14_12,IRAN,13739,13,mohammad jamshidi,25,2,6,33.3,1,4,25,1,2,50,3,4,75,0,0,0,0,1,1,1,0,8
375271,422_14_12,IRAN,11627,14,samad nikkhah bahrami,31,3,16,18.8,2,13,15.4,1,3,33.3,2,2,100,0,4,4,4,2,6,1,0,9
375272,422_14_12,IRAN,9693,15,hamed haddadi,31,7,17,41.2,7,16,43.8,0,1,0,2,3,66.7,6,9,15,0,3,7,0,1,16
375273,422_14_12,IRAN,0,TOTALS,IRAN,200,23,59,39,17,44,38.6,6,15,40,8,13,61.5,11,20,31,11,24,20,8,1,60
375274,422_14_12,SPAIN,61,4,pau gasol,29,12,20,60,12,19,63.2,0,1,0,9,10,90,3,5,8,2,1,3,0,3,33
375275,422_14_12,SPAIN,70,5,rudy fernandez,22,4,7,57.1,1,1,100,3,6,50,1,2,50,0,2,2,4,0,1,1,0,12
375276,422_14_12,SPAIN,1877,6,sergio rodriguez,15,3,5,60,3,4,75,0,1,0,0,0,0,1,3,4,4,0,2,1,0,6
375277,422_14_12,SPAIN,64,7,juan c. navarro,19,3,6,50,1,1,100,2,5,40,2,2,100,0,1,1,2,0,0,0,0,10
375278,422_14_12,SPAIN,65,8,jose calderon,14,1,1,100,0,0,0,1,1,100,0,0,0,0,0,0,1,1,1,2,0,3
375279,422_14_12,SPAIN,66,9,felipe reyes,0,0,0,0,0,0,0,0,0,0,0,0,0,0,0,0,0,0,0,0,0,0
375280,422_14_12,SPAIN,2628,10,victor claver,20,1,4,25,0,3,0,1,1,100,3,4,75,2,3,5,0,2,2,2,1,6
375281,422_14_12,SPAIN,6259,11,ricky rubio,19,1,4,25,1,3,33.3,0,1,0,1,6,16.7,5,4,9,5,2,1,5,0,3
375282,422_14_12,SPAIN,1871,12,sergio llull,26,0,4,0,0,3,0,0,1,0,0,0,0,0,1,1,0,3,0,0,0,0
375283,422_14_12,SPAIN,1108,13,marc gasol,31,4,7,57.1,4,6,66.7,0,1,0,7,8,87.5,1,9,10,4,3,2,2,0,15
375284,422_14_12,SPAIN,7001,14,serge ibaka,0,0,0,0,0,0,0,0,0,0,0,0,0,0,0,0,0,0,0,0,0,0
375285,422_14_12,SPAIN,19988,15,alex abrines,5,1,2,50,1,1,100,0,1,0,0,0,0,0,0,0,0,0,0,0,0,2
375286,422_14_12,SPAIN,0,TOTALS,SPAIN,200,30,60,50,23,41,56.1,7,19,36.8,23,32,71.9,13,29,42,22,12,12,13,4,90
375287,422_14_13,DOMINICAN REPUBLIC,19011,4,edgar sosa,23,1,5,20,1,4,25,0,1,0,0,0,0,0,0,0,0,1,1,0,0,2
375288,422_14_13,DOMINICAN REPUBLIC,461,5,manuel fortuna,0,0,0,0,0,0,0,0,0,0,0,0,0,0,0,0,0,0,0,0,0,0
375289,422_14_13,DOMINICAN REPUBLIC,14632,6,juan coronado,19,2,5,40,1,2,50,1,3,33.3,0,0,0,1,3,4,4,2,2,1,0,5
375290,422_14_13,DOMINICAN REPUBLIC,25436,7,victor liz,14,3,6,50,2,4,50,1,2,50,0,0,0,1,0,1,1,0,0,0,0,7
375291,422_14_13,DOMINICAN REPUBLIC,23761,8,edward santana,0,0,0,0,0,0,0,0,0,0,0,0,0,0,0,0,0,0,0,0,0,0
375292,422_14_13,DOMINICAN REPUBLIC,4116,9,francisco garcia,30,11,15,73.3,6,8,75,5,7,71.4,2,2,100,0,6,6,2,3,1,1,2,29
375293,422_14_13,DOMINICAN REPUBLIC,23762,10,james feldeine,31,4,11,36.4,3,7,42.9,1,4,25,0,0,0,1,2,3,4,1,1,0,0,9
375294,422_14_13,DOMINICAN REPUBLIC,19070,11,eloy vargas,18,1,6,16.7,1,5,20,0,1,0,0,2,0,2,3,5,0,4,0,0,2,2
375295,422_14_13,DOMINICAN REPUBLIC,19016,12,orlando sanchez,14,1,1,100,1,1,100,0,0,0,0,1,0,1,2,3,0,2,0,1,0,2
375296,422_14_13,DOMINICAN REPUBLIC,9947,13,eulis baez,28,4,9,44.4,4,8,50,0,1,0,0,0,0,5,4,9,0,2,1,0,0,8
375297,422_14_13,DOMINICAN REPUBLIC,16889,14,ronald ramon,0,0,0,0,0,0,0,0,0,0,0,0,0,0,0,0,0,0,0,0,0,0
375298,422_14_13,DOMINICAN REPUBLIC,430,15,jack martinez,23,5,9,55.6,5,7,71.4,0,2,0,2,2,100,0,6,6,2,2,3,0,0,12
375299,422_14_13,DOMINICAN REPUBLIC,0,TOTALS,DOMINICAN REPUBLIC,200,32,67,47.8,24,46,52.2,8,21,38.1,4,7,57.1,14,29,43,13,17,13,3,4,76
375300,422_14_13,NEW ZEALAND,6772,4,lindsay tait,6,0,0,0,0,0,0,0,0,0,0,0,0,0,1,1,0,0,0,0,0,0
375301,422_14_13,NEW ZEALAND,21055,5,everard bartlett,7,0,2,0,0,0,0,0,2,0,0,0,0,1,0,1,1,1,0,0,0,0
375302,422_14_13,NEW ZEALAND,39,6,kirk penney,34,5,15,33.3,2,5,40,3,10,30,3,4,75,1,4,5,3,1,3,0,0,16
375303,422_14_13,NEW ZEALAND,6773,7,mika vukona,26,5,9,55.6,5,9,55.6,0,0,0,1,1,100,1,2,3,3,4,1,1,0,11
375304,422_14_13,NEW ZEALAND,16521,8,jarrod kenny,0,0,0,0,0,0,0,0,0,0,0,0,0,0,0,0,0,0,0,0,0,0
375305,422_14_13,NEW ZEALAND,11656,9,corey webster,18,3,11,27.3,2,5,40,1,6,16.7,0,0,0,2,1,3,0,0,1,0,0,7
375306,422_14_13,NEW ZEALAND,16523,10,thomas abercrombie,30,7,11,63.6,4,5,80,3,6,50,5,6,83.3,1,3,4,1,3,1,0,1,22
375307,422_14_13,NEW ZEALAND,16524,11,bj anthony,4,0,1,0,0,0,0,0,1,0,0,0,0,0,0,0,0,1,0,0,0,0
375308,422_14_13,NEW ZEALAND,25442,12,isaac fotu,10,1,3,33.3,1,2,50,0,1,0,0,1,0,2,0,2,0,0,1,0,0,2
375309,422_14_13,NEW ZEALAND,6846,13,casey frank,7,0,1,0,0,1,0,0,0,0,0,2,0,2,0,2,1,0,3,0,0,0
375310,422_14_13,NEW ZEALAND,13832,14,rob loe,32,0,6,0,0,3,0,0,3,0,3,4,75,1,0,1,3,2,0,0,0,3
375311,422_14_13,NEW ZEALAND,21056,15,tai webster,26,1,5,20,1,2,50,0,3,0,0,0,0,1,3,4,3,2,1,2,0,2
375312,422_14_13,NEW ZEALAND,0,TOTALS,NEW ZEALAND,200,22,64,34.4,15,32,46.9,7,32,21.9,12,18,66.7,16,18,34,15,14,11,3,1,63
375313,422_14_14,KOREA,18641,4,taejong moon,13,1,3,33.3,0,0,0,1,3,33.3,0,0,0,0,0,0,1,3,1,1,1,3
375314,422_14_14,KOREA,18640,5,chan hee park,20,1,6,16.7,1,2,50,0,4,0,0,2,0,0,1,1,4,3,2,2,0,2
375315,422_14_14,KOREA,9631,6,donggeun yang,12,1,4,25,1,1,100,0,3,0,0,0,0,0,1,1,0,1,0,0,0,2
375316,422_14_14,KOREA,11667,7,taesul kim,7,0,0,0,0,0,0,0,0,0,0,0,0,0,0,0,1,1,0,1,0,0
375317,422_14_14,KOREA,14338,8,jonghyun lee,17,1,1,100,1,1,100,0,0,0,2,2,100,0,2,2,0,1,1,0,3,4
375318,422_14_14,KOREA,9054,9,sunhyung kim,17,6,10,60,5,8,62.5,1,2,50,0,0,0,0,1,1,3,0,3,0,0,13
375319,422_14_14,KOREA,18643,10,sungmin cho,25,3,8,37.5,1,2,50,2,6,33.3,2,3,66.7,2,1,3,1,1,4,1,0,10
375320,422_14_14,KOREA,9635,11,heejong yang,12,0,3,0,0,1,0,0,2,0,0,0,0,0,3,3,2,0,0,1,0,0
375321,422_14_14,KOREA,3914,12,joo sung kim,18,4,6,66.7,4,5,80,0,1,0,0,0,0,0,0,0,0,4,3,1,0,8
375322,422_14_14,KOREA,25437,13,ilyoung heo,15,1,7,14.3,0,3,0,1,4,25,0,0,0,0,2,2,2,2,0,1,0,3
375323,422_14_14,KOREA,11670,14,sekeun oh,16,0,1,0,0,1,0,0,0,0,0,0,0,3,1,4,1,2,3,1,1,0
375324,422_14_14,KOREA,18644,15,jongkyu kim,30,4,7,57.1,4,7,57.1,0,0,0,2,2,100,0,1,1,0,3,1,0,3,10
375325,422_14_14,KOREA,0,TOTALS,KOREA,200,22,56,39.3,17,31,54.8,5,25,20,6,9,66.7,5,13,18,15,21,19,9,8,55
375326,422_14_14,AUSTRALIA,9039,4,chris goulding,10,1,2,50,0,0,0,1,2,50,0,0,0,1,2,3,0,2,2,0,0,3
375327,422_14_14,AUSTRALIA,13813,5,ryan broekhoff,22,3,5,60,0,0,0,3,5,60,0,0,0,1,3,4,2,1,0,1,0,9
375328,422_14_14,AUSTRALIA,3458,6,adam gibson,15,2,2,100,2,2,100,0,0,0,0,0,0,0,0,0,2,1,0,1,0,4
375329,422_14_14,AUSTRALIA,11635,7,joe ingles,18,7,8,87.5,4,5,80,3,3,100,0,0,0,1,2,3,2,1,2,3,0,17
375330,422_14_14,AUSTRALIA,3466,8,brad newley,19,0,3,0,0,2,0,0,1,0,2,2,100,0,3,3,1,1,2,0,0,2
375331,422_14_14,AUSTRALIA,13811,9,matthew dellavedova,23,2,5,40,1,3,33.3,1,2,50,2,2,100,2,2,4,8,1,2,1,0,7
375332,422_14_14,AUSTRALIA,25376,10,cameron bairstow,15,6,7,85.7,6,7,85.7,0,0,0,1,2,50,1,2,3,1,2,2,1,0,13
375333,422_14_14,AUSTRALIA,20984,11,dante exum,13,2,6,33.3,2,5,40,0,1,0,0,0,0,0,0,0,3,2,1,1,0,4
375334,422_14_14,AUSTRALIA,16519,12,aron baynes,22,6,13,46.2,6,13,46.2,0,0,0,1,4,25,6,4,10,1,1,2,1,0,13
375335,422_14_14,AUSTRALIA,142,13,david andersen,19,1,8,12.5,1,8,12.5,0,0,0,3,4,75,4,4,8,1,0,2,0,0,5
375336,422_14_14,AUSTRALIA,13814,14,brock motum,14,3,7,42.9,3,7,42.9,0,0,0,2,2,100,1,1,2,0,3,0,1,0,8
375337,422_14_14,AUSTRALIA,3457,15,nate jawai,10,2,2,100,2,2,100,0,0,0,0,0,0,0,0,0,2,0,0,0,0,4
375338,422_14_14,AUSTRALIA,0,TOTALS,AUSTRALIA,200,35,68,51.5,27,54,50,8,14,57.1,11,16,68.8,21,26,47,23,15,17,10,0,89
375339,422_14_15,ARGENTINA,80,4,luis scola,37,11,19,57.9,10,18,55.6,1,1,100,7,11,63.6,0,9,9,1,4,1,0,1,30
375340,422_14_15,ARGENTINA,16652,5,tayavek gallizzi,0,0,0,0,0,0,0,0,0,0,0,0,0,0,0,0,0,0,0,0,0,0
375341,422_14_15,ARGENTINA,12069,6,marcos mata,17,1,4,25,1,2,50,0,2,0,0,0,0,1,1,2,0,2,0,0,0,2
375342,422_14_15,ARGENTINA,21037,7,facundo campazzo,32,5,12,41.7,3,6,50,2,6,33.3,1,2,50,0,3,3,6,4,2,1,1,13
375343,422_14_15,ARGENTINA,357,8,pablo prigioni,28,2,4,50,2,2,100,0,2,0,4,4,100,0,4,4,5,3,0,2,0,8
375344,422_14_15,ARGENTINA,12228,9,nicolas laprovittola,0,0,0,0,0,0,0,0,0,0,0,0,0,0,0,0,0,0,0,0,0,0
375345,422_14_15,ARGENTINA,81,10,leo gutierrez,16,3,6,50,0,1,0,3,5,60,0,0,0,0,1,1,0,2,0,0,0,9
375346,422_14_15,ARGENTINA,14903,11,marcos delia,3,0,0,0,0,0,0,0,0,0,0,0,0,0,0,0,0,2,0,0,0,0
375347,422_14_15,ARGENTINA,77,12,walter herrmann,27,4,8,50,3,6,50,1,2,50,0,0,0,2,4,6,2,1,2,0,0,9
375348,422_14_15,ARGENTINA,82,13,andres nocioni,28,4,9,44.4,3,6,50,1,3,33.3,2,3,66.7,1,3,4,3,3,1,0,1,11
375349,422_14_15,ARGENTINA,12297,14,matias bortolin,0,0,0,0,0,0,0,0,0,0,0,0,0,0,0,0,0,0,0,0,0,0
375350,422_14_15,ARGENTINA,21197,15,selem safar,12,1,3,33.3,0,0,0,1,3,33.3,0,0,0,0,0,0,0,2,0,1,0,3
375351,422_14_15,ARGENTINA,0,TOTALS,ARGENTINA,200,31,65,47.7,22,41,53.7,9,24,37.5,14,20,70,6,25,31,17,23,6,4,3,85
375352,422_14_15,CROATIA,1844,4,ante tomic,21,0,3,0,0,3,0,0,0,0,5,6,83.3,1,5,6,4,2,1,0,0,5
375353,422_14_15,CROATIA,1121,5,luksa andric,0,0,0,0,0,0,0,0,0,0,0,0,0,0,0,0,0,0,0,0,0,0
375354,422_14_15,CROATIA,25431,6,oliver lafayette,30,5,9,55.6,4,5,80,1,4,25,0,0,0,0,1,1,9,3,1,1,0,11
375355,422_14_15,CROATIA,6280,7,bojan bogdanovic,37,6,11,54.5,3,5,60,3,6,50,1,2,50,2,5,7,2,4,1,1,0,16
375356,422_14_15,CROATIA,15894,8,dario saric,25,5,12,41.7,3,6,50,2,6,33.3,4,5,80,3,6,9,1,4,1,0,0,16
375357,422_14_15,CROATIA,1846,9,damjan rudez,18,2,7,28.6,0,1,0,2,6,33.3,0,0,0,0,1,1,0,1,0,0,0,6
375358,422_14_15,CROATIA,4585,10,roko ukic,21,3,5,60,1,1,100,2,4,50,0,0,0,0,1,1,2,2,1,0,0,8
375359,422_14_15,CROATIA,1249,11,krunoslav simon,30,5,10,50,2,3,66.7,3,7,42.9,5,6,83.3,0,4,4,1,3,2,2,0,18
375360,422_14_15,CROATIA,1250,12,damir markota,0,0,0,0,0,0,0,0,0,0,0,0,0,0,0,0,0,0,0,0,0,0
375361,422_14_15,CROATIA,18415,13,mario hezonja,0,0,0,0,0,0,0,0,0,0,0,0,0,0,0,0,0,0,0,0,0,0
375362,422_14_15,CROATIA,16607,14,luka zoric,18,4,6,66.7,4,6,66.7,0,0,0,2,3,66.7,1,4,5,0,4,0,0,0,10
375363,422_14_15,CROATIA,13759,15,luka babic,0,0,0,0,0,0,0,0,0,0,0,0,0,0,0,0,0,0,0,0,0,0
375364,422_14_15,CROATIA,0,TOTALS,CROATIA,200,30,63,47.6,17,30,56.7,13,33,39.4,17,22,77.3,8,28,36,19,23,9,4,0,90
375365,422_14_16,SERBIA,5751,4,milos teodosic,22,2,7,28.6,1,2,50,1,5,20,0,0,0,0,1,1,5,2,1,1,0,5
375366,422_14_16,SERBIA,2100,5,marko simonovic,17,1,1,100,1,1,100,0,0,0,3,4,75,0,0,0,1,1,0,2,0,5
375367,422_14_16,SERBIA,25441,6,stefan jovic,17,3,4,75,3,4,75,0,0,0,3,3,100,0,2,2,0,2,2,4,0,9
375368,422_14_16,SERBIA,17361,7,bogdan bogdanovic,24,5,13,38.5,3,7,42.9,2,6,33.3,0,0,0,1,2,3,1,3,3,1,0,12
375369,422_14_16,SERBIA,15386,8,nemanja bjelica,28,3,7,42.9,2,2,100,1,5,20,4,4,100,0,3,3,1,2,1,0,0,11
375370,422_14_16,SERBIA,2654,9,stefan markovic,18,0,2,0,0,0,0,0,2,0,0,0,0,0,0,0,2,1,1,0,0,0
375371,422_14_16,SERBIA,19860,10,nikola kalinic,17,2,2,100,2,2,100,0,0,0,3,3,100,0,0,0,0,2,0,0,0,7
375372,422_14_16,SERBIA,15504,11,stefan bircevic,7,0,1,0,0,1,0,0,0,0,0,0,0,0,3,3,0,1,1,1,0,0
375373,422_14_16,SERBIA,93,12,nenad krstic,0,0,0,0,0,0,0,0,0,0,0,0,0,0,0,0,0,0,0,0,0,0
375374,422_14_16,SERBIA,2656,13,miroslav raduljica,29,8,13,61.5,8,13,61.5,0,0,0,5,5,100,4,3,7,0,4,3,1,0,21
375375,422_14_16,SERBIA,24202,14,rasko katic,10,1,1,100,1,1,100,0,0,0,0,0,0,1,0,1,0,2,1,0,0,2
375376,422_14_16,SERBIA,5756,15,vladimir stimac,11,0,2,0,0,2,0,0,0,0,1,2,50,1,1,2,0,0,0,0,0,1
375377,422_14_16,SERBIA,0,TOTALS,SERBIA,200,25,53,47.2,21,35,60,4,18,22.2,19,21,90.5,8,18,26,10,20,14,10,0,73
375378,422_14_16,FRANCE,12495,4,thomas heurtel,19,2,3,66.7,2,3,66.7,0,0,0,0,0,0,1,0,1,6,1,1,0,0,4
375379,422_14_16,FRANCE,2588,5,nicolas batum,34,5,10,50,4,5,80,1,5,20,0,0,0,1,5,6,1,2,3,2,0,11
375380,422_14_16,FRANCE,2589,6,antoine diot,21,6,9,66.7,5,6,83.3,1,3,33.3,2,2,100,0,3,3,2,1,3,2,0,15
375381,422_14_16,FRANCE,11076,7,joffrey lauvergne,28,7,10,70,7,9,77.8,0,1,0,5,7,71.4,2,4,6,1,4,2,1,1,19
375382,422_14_16,FRANCE,1864,8,charles kahudi,5,1,2,50,0,1,0,1,1,100,0,0,0,0,0,0,0,0,0,0,0,3
375383,422_14_16,FRANCE,6249,9,edwin jackson,17,4,6,66.7,1,1,100,3,5,60,1,1,100,0,0,0,2,1,0,0,0,12
375384,422_14_16,FRANCE,12971,10,evan fournier,10,0,4,0,0,2,0,0,2,0,0,0,0,0,0,0,1,0,0,0,0,0
375385,422_14_16,FRANCE,4663,11,florent pietrus,10,0,0,0,0,0,0,0,0,0,0,0,0,0,2,2,1,2,2,1,0,0
375386,422_14_16,FRANCE,17374,12,rudy gobert,12,1,2,50,1,2,50,0,0,0,1,3,33.3,2,3,5,0,3,0,0,0,3
375387,422_14_16,FRANCE,4665,13,boris diaw,19,2,4,50,2,2,100,0,2,0,0,0,0,3,2,5,5,3,4,0,0,4
375388,422_14_16,FRANCE,7987,14,kim tillie,3,0,0,0,0,0,0,0,0,0,0,0,0,0,0,0,0,1,1,0,0,0
375389,422_14_16,FRANCE,5044,15,mickael gelabale,22,1,5,20,0,1,0,1,4,25,0,0,0,0,1,1,2,3,0,1,0,3
375390,422_14_16,FRANCE,0,TOTALS,FRANCE,200,29,55,52.7,22,32,68.8,7,23,30.4,9,13,69.2,9,20,29,21,21,16,7,1,74
375391,422_14_17,FINLAND,1834,4,mikko koivisto,16,2,5,40,0,1,0,2,4,50,0,0,0,0,1,1,1,4,0,3,0,6
375392,422_14_17,FINLAND,25454,5,erik murphy,33,5,10,50,5,8,62.5,0,2,0,2,5,40,5,3,8,1,2,0,1,1,12
375393,422_14_17,FINLAND,4930,6,kimmo muurinen,6,0,0,0,0,0,0,0,0,0,0,0,0,0,1,1,0,2,2,0,0,0
375394,422_14_17,FINLAND,1314,7,shawn huff,31,9,15,60,4,7,57.1,5,8,62.5,0,0,0,2,6,8,0,1,1,0,0,23
375395,422_14_17,FINLAND,1836,8,gerald lee,24,3,6,50,3,6,50,0,0,0,1,4,25,1,2,3,0,2,3,0,0,7
375396,422_14_17,FINLAND,11129,9,sasu salin,27,3,6,50,2,2,100,1,4,25,2,2,100,2,3,5,4,2,1,2,0,9
375397,422_14_17,FINLAND,4932,10,tuukka kotti,11,0,1,0,0,1,0,0,0,0,0,0,0,0,1,1,0,3,1,0,0,0
375398,422_14_17,FINLAND,2802,11,petteri koponen,30,4,12,33.3,2,7,28.6,2,5,40,4,8,50,0,2,2,9,4,1,1,0,14
375399,422_14_17,FINLAND,8436,12,matti nuutinen,0,0,0,0,0,0,0,0,0,0,0,0,0,0,0,0,0,0,0,0,0,0
375400,422_14_17,FINLAND,4935,13,hanno mottola,4,2,2,100,2,2,100,0,0,0,0,0,0,0,0,0,0,0,0,0,0,4
375401,422_14_17,FINLAND,25455,14,antero lehto,2,0,0,0,0,0,0,0,0,0,0,0,0,0,0,0,0,0,0,0,0,0
375402,422_14_17,FINLAND,4937,15,teemu rannikko,16,1,5,20,0,0,0,1,5,20,3,4,75,0,1,1,4,2,1,0,0,6
375403,422_14_17,FINLAND,0,TOTALS,FINLAND,200,29,62,46.8,18,34,52.9,11,28,39.3,12,23,52.2,10,22,32,19,22,11,7,1,81
375404,422_14_17,UKRAINE,5790,4,maksym pustozvonov,22,6,10,60,3,4,75,3,6,50,0,0,0,1,1,2,2,4,1,1,0,15
375405,422_14_17,UKRAINE,25435,5,"eugene ""pooh"" jeter",33,7,14,50,5,6,83.3,2,8,25,8,10,80,0,5,5,9,1,1,0,0,24
375406,422_14_17,UKRAINE,12946,6,olexandr mishula,10,2,5,40,0,1,0,2,4,50,2,2,100,0,1,1,1,5,2,1,0,8
375407,422_14_17,UKRAINE,22292,7,sviatoslav mykhailiuk,10,1,4,25,1,2,50,0,2,0,2,5,40,2,0,2,1,4,2,1,0,4
375408,422_14_17,UKRAINE,7931,8,sergii gladyr,8,2,3,66.7,0,0,0,2,3,66.7,0,0,0,0,0,0,0,0,1,0,0,6
375409,422_14_17,UKRAINE,10926,9,oleksandr lypovyy,30,1,4,25,0,1,0,1,3,33.3,0,0,0,2,2,4,2,1,2,0,0,3
375410,422_14_17,UKRAINE,8223,10,kyryl natyazhko,10,2,2,100,2,2,100,0,0,0,2,2,100,1,0,1,0,2,1,0,0,6
375411,422_14_17,UKRAINE,1026,11,dmytro zabirchenko,12,0,2,0,0,0,0,0,2,0,2,2,100,0,0,0,1,2,0,0,0,2
375412,422_14_17,UKRAINE,5791,12,maxym kornienko,19,1,4,25,1,3,33.3,0,1,0,0,0,0,0,6,6,0,1,1,0,0,2
375413,422_14_17,UKRAINE,10713,13,ihor zaytsev,19,2,5,40,2,4,50,0,1,0,2,2,100,1,5,6,0,1,0,0,1,6
375414,422_14_17,UKRAINE,19863,14,artem pustovyi,0,0,0,0,0,0,0,0,0,0,0,0,0,0,0,0,0,0,0,0,0,0
375415,422_14_17,UKRAINE,5792,15,slava kravtsov,27,0,1,0,0,1,0,0,0,0,0,0,0,1,7,8,3,2,5,0,1,0
375416,422_14_17,UKRAINE,0,TOTALS,UKRAINE,200,24,54,44.4,14,24,58.3,10,30,33.3,18,23,78.3,9,27,36,19,23,18,3,2,76
375417,422_14_18,SLOVENIA,24203,4,jure balazic,17,3,5,60,0,1,0,3,4,75,0,0,0,0,3,3,1,4,0,0,1,9
375418,422_14_18,SLOVENIA,5023,5,uros slokar,13,2,3,66.7,2,3,66.7,0,0,0,0,2,0,0,1,1,1,5,1,0,0,4
375419,422_14_18,SLOVENIA,17812,6,aleksej nikolic,3,0,0,0,0,0,0,0,0,0,0,0,0,0,0,0,0,0,2,0,0,0
375420,422_14_18,SLOVENIA,17343,7,klemen prepelic,9,0,3,0,0,1,0,0,2,0,0,0,0,0,0,0,1,0,1,0,0,0
375421,422_14_18,SLOVENIA,10978,8,edo muric,21,1,4,25,0,1,0,1,3,33.3,0,0,0,2,2,4,0,0,0,2,0,3
375422,422_14_18,SLOVENIA,15479,9,jaka blazic,10,1,3,33.3,1,2,50,0,1,0,0,0,0,0,1,1,0,1,0,0,0,2
375423,422_14_18,SLOVENIA,4764,10,miha zupan,17,1,3,33.3,1,1,100,0,2,0,4,4,100,1,1,2,0,2,1,0,0,6
375424,422_14_18,SLOVENIA,1068,11,goran dragic,26,6,8,75,5,6,83.3,1,2,50,5,7,71.4,0,1,1,6,0,4,1,0,18
375425,422_14_18,SLOVENIA,6197,12,zoran dragic,22,8,8,100,4,4,100,4,4,100,2,2,100,1,2,3,2,2,0,3,0,22
375426,422_14_18,SLOVENIA,1064,13,domen lorbek,23,1,3,33.3,1,2,50,0,1,0,1,2,50,0,0,0,4,2,0,1,0,3
375427,422_14_18,SLOVENIA,5782,14,jaka klobucar,18,3,5,60,2,3,66.7,1,2,50,3,3,100,1,0,1,4,3,1,1,0,10
375428,422_14_18,SLOVENIA,17344,15,alen omic,21,6,8,75,6,8,75,0,0,0,0,0,0,1,2,3,0,2,1,2,0,12
375429,422_14_18,SLOVENIA,0,TOTALS,SLOVENIA,200,32,53,60.4,22,32,68.8,10,21,47.6,15,20,75,6,14,20,19,21,11,10,1,89
375430,422_14_18,MEXICO,16880,4,paul stoll,25,0,4,0,0,3,0,0,1,0,2,2,100,0,1,1,3,4,3,1,0,2
375431,422_14_18,MEXICO,23812,5,marco ramos,12,3,3,100,3,3,100,0,0,0,0,0,0,2,2,4,0,1,1,0,0,6
375432,422_14_18,MEXICO,23755,6,roman martinez,9,0,1,0,0,1,0,0,0,0,0,0,0,0,0,0,1,1,0,0,1,0
375433,422_14_18,MEXICO,23756,7,jorge gutierrez,16,3,8,37.5,3,7,42.9,0,1,0,2,2,100,0,0,0,2,4,3,0,0,8
375434,422_14_18,MEXICO,9836,8,gustavo ayon,32,9,9,100,9,9,100,0,0,0,5,9,55.6,1,2,3,1,4,4,1,1,23
375435,422_14_18,MEXICO,23813,9,francisco cruz,33,5,10,50,4,6,66.7,1,4,25,2,2,100,1,2,3,4,1,3,1,0,13
375436,422_14_18,MEXICO,25444,10,israel gutierrez,0,0,0,0,0,0,0,0,0,0,0,0,0,0,0,0,0,0,0,0,0,0
375437,422_14_18,MEXICO,25445,11,david meza,20,1,3,33.3,1,3,33.3,0,0,0,0,0,0,0,2,2,1,3,0,0,0,2
375438,422_14_18,MEXICO,9835,12,hector hernandez,28,2,3,66.7,0,0,0,2,3,66.7,0,0,0,0,5,5,0,2,1,0,0,6
375439,422_14_18,MEXICO,21215,13,orlando mendez,17,2,5,40,0,1,0,2,4,50,0,0,0,0,0,0,0,2,3,2,1,6
375440,422_14_18,MEXICO,25446,14,adrian zamora,5,0,0,0,0,0,0,0,0,0,0,0,0,0,1,1,0,1,0,0,0,0
375441,422_14_18,MEXICO,25447,15,adam parada,3,1,1,100,1,1,100,0,0,0,0,0,0,0,1,1,0,0,1,0,0,2
375442,422_14_18,MEXICO,0,TOTALS,MEXICO,200,26,47,55.3,21,34,61.8,5,13,38.5,11,15,73.3,8,17,25,12,23,20,5,3,68
375443,422_14_19,SENEGAL,11764,4,thierno niang,15,0,2,0,0,2,0,0,0,0,0,0,0,0,1,1,2,2,3,1,0,0
375444,422_14_19,SENEGAL,18541,5,xane dalmeida,22,2,5,40,1,2,50,1,3,33.3,4,6,66.7,0,3,3,3,4,1,2,0,9
375445,422_14_19,SENEGAL,23085,6,ibrahima thomas,3,1,3,33.3,1,2,50,0,1,0,0,0,0,1,0,1,0,1,0,0,0,2
375446,422_14_19,SENEGAL,18542,7,mamadou ndoye,3,0,0,0,0,0,0,0,0,0,0,0,0,0,1,1,1,0,0,0,0,0
375447,422_14_19,SENEGAL,18543,8,mohamet diop,22,3,6,50,3,4,75,0,2,0,4,4,100,2,2,4,3,3,2,2,0,10
375448,422_14_19,SENEGAL,3592,9,maleye ndoye,24,3,7,42.9,1,2,50,2,5,40,0,1,0,1,2,3,1,4,0,1,0,8
375449,422_14_19,SENEGAL,25448,10,djibril thiam,0,0,0,0,0,0,0,0,0,0,0,0,0,0,0,0,0,0,0,0,0,0
375450,422_14_19,SENEGAL,9148,11,mouhammad faye,33,7,9,77.8,3,4,75,4,5,80,2,2,100,2,2,4,0,3,4,3,0,20
375451,422_14_19,SENEGAL,25449,12,maurice ndour,30,4,10,40,4,6,66.7,0,4,0,0,0,0,1,1,2,0,1,2,2,1,8
375452,422_14_19,SENEGAL,23089,13,hamady ndiaye,10,3,4,75,3,4,75,0,0,0,0,2,0,1,3,4,0,0,0,0,3,6
375453,422_14_19,SENEGAL,25450,14,gorgui dieng,34,7,12,58.3,7,12,58.3,0,0,0,4,8,50,1,12,13,2,2,3,1,2,18
375454,422_14_19,SENEGAL,23091,15,abdou badji,4,0,0,0,0,0,0,0,0,0,1,4,25,0,0,0,0,1,0,0,0,1
375455,422_14_19,SENEGAL,0,TOTALS,SENEGAL,200,30,58,51.7,23,38,60.5,7,20,35,15,27,55.6,10,28,38,12,21,16,12,6,82
375456,422_14_19,PUERTO RICO,23748,4,ramon clemente,1,1,1,100,1,1,100,0,0,0,0,0,0,0,0,0,0,0,0,0,0,2
375457,422_14_19,PUERTO RICO,19036,5,jose barea,28,4,12,33.3,1,7,14.3,3,5,60,4,4,100,1,4,5,4,1,4,1,0,15
375458,422_14_19,PUERTO RICO,21059,6,alex franklin,12,1,2,50,0,0,0,1,2,50,1,2,50,0,2,2,0,1,1,0,0,4
375459,422_14_19,PUERTO RICO,100,7,carlos arroyo,11,4,6,66.7,1,1,100,3,5,60,0,0,0,0,1,1,1,1,1,1,0,11
375460,422_14_19,PUERTO RICO,3479,8,angel vassallo,20,2,7,28.6,0,1,0,2,6,33.3,0,0,0,0,4,4,3,0,2,0,0,6
375461,422_14_19,PUERTO RICO,25443,9,carlos rivera,12,2,4,50,1,2,50,1,2,50,1,2,50,0,1,1,5,3,1,2,0,6
375462,422_14_19,PUERTO RICO,8997,10,jorge bryan diaz,0,0,0,0,0,0,0,0,0,0,0,0,0,0,0,0,0,0,0,0,0,0
375463,422_14_19,PUERTO RICO,481,11,ricky sanchez,22,0,3,0,0,0,0,0,3,0,2,2,100,0,3,3,1,2,0,0,0,2
375464,422_14_19,PUERTO RICO,7435,12,david huertas,13,0,3,0,0,1,0,0,2,0,0,0,0,0,1,1,1,3,1,0,0,0
375465,422_14_19,PUERTO RICO,16592,13,renaldo balkman,35,9,13,69.2,9,13,69.2,0,0,0,3,5,60,4,3,7,1,4,4,0,0,21
375466,422_14_19,PUERTO RICO,3478,14,alexander galindo,25,2,5,40,0,1,0,2,4,50,0,0,0,0,0,0,2,4,1,0,0,6
375467,422_14_19,PUERTO RICO,108,15,daniel santiago,22,1,5,20,1,5,20,0,0,0,0,2,0,3,4,7,1,4,3,0,1,2
375468,422_14_19,PUERTO RICO,0,TOTALS,PUERTO RICO,200,26,61,42.6,14,32,43.8,12,29,41.4,11,17,64.7,9,24,33,19,23,18,4,1,75
375469,422_14_20,BRAZIL,332,4,marcelo machado,17,3,7,42.9,1,2,50,2,5,40,0,0,0,0,2,2,3,3,2,1,0,8
375470,422_14_20,BRAZIL,14848,5,raulzinho neto,15,1,3,33.3,1,3,33.3,0,0,0,0,0,0,1,1,2,2,0,1,2,1,2
375471,422_14_20,BRAZIL,23752,6,rafael hettsheimeir,17,3,6,50,3,5,60,0,1,0,0,0,0,1,0,1,0,2,3,2,0,6
375472,422_14_20,BRAZIL,21034,7,larry taylor,14,3,5,60,2,3,66.7,1,2,50,0,0,0,0,0,0,1,0,1,1,0,7
375473,422_14_20,BRAZIL,4102,8,alex garcia,24,4,6,66.7,4,6,66.7,0,0,0,4,4,100,0,3,3,0,1,0,3,0,12
375474,422_14_20,BRAZIL,4098,9,marcelinho huertas,18,1,3,33.3,1,2,50,0,1,0,0,0,0,0,2,2,6,0,0,1,0,2
375475,422_14_20,BRAZIL,4100,10,leandrinho barbosa,19,5,6,83.3,4,5,80,1,1,100,0,0,0,0,1,1,1,3,1,4,0,11
375476,422_14_20,BRAZIL,4103,11,anderson varejao,17,2,3,66.7,2,3,66.7,0,0,0,0,0,0,0,6,6,0,2,3,0,1,4
375477,422_14_20,BRAZIL,4104,12,guilherme giovannoni,14,2,5,40,1,2,50,1,3,33.3,0,1,0,0,1,1,0,1,0,0,0,5
375478,422_14_20,BRAZIL,9844,13,nene hilario,16,4,6,66.7,4,6,66.7,0,0,0,0,0,0,2,2,4,0,0,0,2,0,8
375479,422_14_20,BRAZIL,19020,14,marquinhos vieira,15,1,4,25,1,2,50,0,2,0,2,2,100,0,3,3,0,1,3,0,0,4
375480,422_14_20,BRAZIL,4106,15,tiago splitter,16,3,5,60,3,5,60,0,0,0,4,8,50,2,4,6,1,3,4,1,1,10
375481,422_14_20,BRAZIL,0,TOTALS,BRAZIL,200,32,59,54.2,27,44,61.4,5,15,33.3,10,15,66.7,6,29,35,14,16,19,17,3,79
375482,422_14_20,IRAN,23303,4,rouzbeh arghavan,5,1,1,100,1,1,100,0,0,0,2,4,50,0,0,0,1,1,0,1,0,4
375483,422_14_20,IRAN,22993,5,sajjad mashayekhi,0,0,0,0,0,0,0,0,0,0,0,0,0,0,0,0,0,0,0,0,0,0
375484,422_14_20,IRAN,22994,6,behnam yakhchali,23,3,5,60,3,4,75,0,1,0,0,1,0,2,1,3,1,2,0,1,0,6
375485,422_14_20,IRAN,9685,7,mahdi kamrani,25,4,10,40,2,5,40,2,5,40,1,2,50,0,1,1,0,2,3,3,0,11
375486,422_14_20,IRAN,13745,8,arsalan kazemi,21,1,2,50,1,2,50,0,0,0,0,0,0,0,3,3,1,3,1,4,1,2
375487,422_14_20,IRAN,14408,9,arman zangeneh,2,0,0,0,0,0,0,0,0,0,0,0,0,0,0,0,0,0,0,0,0,0
375488,422_14_20,IRAN,9688,10,hamed afagh,16,2,4,50,2,2,100,0,2,0,0,0,0,0,3,3,2,0,2,0,0,4
375489,422_14_20,IRAN,9690,11,oshin sahakian,24,1,2,50,1,2,50,0,0,0,0,0,0,1,2,3,0,2,1,0,0,2
375490,422_14_20,IRAN,16613,12,asghar kardoust,8,0,1,0,0,1,0,0,0,0,0,0,0,0,1,1,0,2,0,0,0,0
375491,422_14_20,IRAN,13739,13,mohammad jamshidi,31,6,14,42.9,5,9,55.6,1,5,20,0,0,0,0,2,2,2,2,6,0,0,13
375492,422_14_20,IRAN,11627,14,samad nikkhah bahrami,24,1,10,10,1,9,11.1,0,1,0,2,2,100,0,0,0,1,3,5,2,0,4
375493,422_14_20,IRAN,9693,15,hamed haddadi,21,2,7,28.6,2,7,28.6,0,0,0,0,0,0,1,6,7,1,2,6,0,1,4
375494,422_14_20,IRAN,0,TOTALS,IRAN,200,21,56,37.5,18,42,42.9,3,14,21.4,5,9,55.6,7,23,30,9,19,24,11,2,50
375495,422_14_21,LITHUANIA,1728,4,martynas pocius,19,4,6,66.7,3,4,75,1,2,50,0,0,0,0,0,0,3,1,3,0,0,9
375496,422_14_21,LITHUANIA,6225,5,adas juskevicius,19,3,4,75,0,1,0,3,3,100,0,0,0,1,1,2,0,3,2,0,0,9
375497,422_14_21,LITHUANIA,10639,6,mindaugas kuzminskas,4,1,2,50,1,1,100,0,1,0,0,0,0,0,0,0,0,0,0,0,0,2
375498,422_14_21,LITHUANIA,5073,7,darjus lavrinovic,11,2,5,40,1,2,50,1,3,33.3,2,3,66.7,0,1,1,0,1,0,0,1,7
375499,422_14_21,LITHUANIA,980,8,jonas maciulis,21,3,7,42.9,2,4,50,1,3,33.3,1,2,50,0,1,1,0,2,1,0,0,8
375500,422_14_21,LITHUANIA,3474,9,renaldas seibutis,31,2,7,28.6,2,5,40,0,2,0,4,4,100,1,3,4,4,0,2,1,0,8
375501,422_14_21,LITHUANIA,292,10,simas jasaitis,20,0,2,0,0,0,0,0,2,0,0,0,0,2,1,3,0,3,0,0,0,0
375502,422_14_21,LITHUANIA,8177,11,donatas motiejunas,21,3,6,50,2,3,66.7,1,3,33.3,5,7,71.4,1,4,5,0,1,0,0,0,12
375503,422_14_21,LITHUANIA,21,12,ksistof lavrinovic,0,0,0,0,0,0,0,0,0,0,0,0,0,0,0,0,0,0,0,0,0,0
375504,422_14_21,LITHUANIA,987,13,paulius jankunas,20,2,3,66.7,2,2,100,0,1,0,5,5,100,0,2,2,3,2,2,1,0,9
375505,422_14_21,LITHUANIA,10916,14,jonas valanciunas,28,4,7,57.1,4,7,57.1,0,0,0,3,7,42.9,2,11,13,3,2,3,0,1,11
375506,422_14_21,LITHUANIA,6221,15,sarunas vasiliauskas,6,0,0,0,0,0,0,0,0,0,0,0,0,0,0,0,1,1,2,0,0,0
375507,422_14_21,LITHUANIA,0,TOTALS,LITHUANIA,200,24,49,49,17,29,58.6,7,20,35,20,28,71.4,8,29,37,14,16,16,2,2,75
375508,422_14_21,ANGOLA,1,4,olimpio cipriano,31,5,12,41.7,3,6,50,2,6,33.3,1,2,50,0,1,1,3,3,3,4,0,13
375509,422_14_21,ANGOLA,3574,5,armando costa,27,2,5,40,1,2,50,1,3,33.3,0,0,0,0,2,2,2,1,1,3,0,5
375510,422_14_21,ANGOLA,16597,6,roberto fortes,19,2,5,40,1,1,100,1,4,25,0,0,0,0,2,2,0,2,0,1,0,5
375511,422_14_21,ANGOLA,13818,7,edson ndoniema,8,0,2,0,0,0,0,0,2,0,0,0,0,1,0,1,0,1,0,0,0,0
375512,422_14_21,ANGOLA,11834,8,gildo santos,0,0,0,0,0,0,0,0,0,0,0,0,0,0,0,0,0,0,0,0,0,0
375513,422_14_21,ANGOLA,7039,9,valdelicio joaquim,13,1,5,20,1,4,25,0,1,0,0,2,0,1,0,1,1,3,0,0,0,2
375514,422_14_21,ANGOLA,7,10,joaquim gomes,20,2,6,33.3,2,5,40,0,1,0,0,0,0,2,4,6,0,3,1,0,0,4
375515,422_14_21,ANGOLA,23104,11,reggie moore,26,4,11,36.4,3,7,42.9,1,4,25,2,2,100,1,2,3,1,2,0,1,0,11
375516,422_14_21,ANGOLA,11831,12,yanick moreira,5,1,3,33.3,1,3,33.3,0,0,0,0,0,0,2,0,2,0,2,2,0,0,2
375517,422_14_21,ANGOLA,13822,13,islando manuel,0,0,0,0,0,0,0,0,0,0,0,0,0,0,0,0,0,0,0,0,0,0
375518,422_14_21,ANGOLA,21052,14,milton barros,15,1,2,50,1,2,50,0,0,0,4,4,100,0,1,1,2,5,3,0,0,6
375519,422_14_21,ANGOLA,12,15,eduardo mingas,36,5,12,41.7,3,8,37.5,2,4,50,2,2,100,0,9,9,1,2,1,2,0,14
375520,422_14_21,ANGOLA,0,TOTALS,ANGOLA,200,23,63,36.5,16,38,42.1,7,25,28,9,12,75,11,23,34,10,24,14,11,0,62
375521,422_14_22,PHILIPPINES,9696,4,jim alapag,15,1,4,25,0,1,0,1,3,33.3,0,0,0,0,0,0,3,1,2,0,0,3
375522,422_14_22,PHILIPPINES,23359,5,lewis tenorio,13,1,2,50,0,1,0,1,1,100,0,0,0,0,2,2,2,3,1,2,0,3
375523,422_14_22,PHILIPPINES,25432,6,jeff chan,21,1,7,14.3,0,2,0,1,5,20,0,0,0,0,1,1,0,2,0,0,0,3
375524,422_14_22,PHILIPPINES,23361,7,jayson william,9,1,6,16.7,0,4,0,1,2,50,2,2,100,0,0,0,1,2,0,0,0,5
375525,422_14_22,PHILIPPINES,23362,8,gary david,7,1,1,100,1,1,100,0,0,0,0,0,0,0,0,0,0,1,1,0,0,2
375526,422_14_22,PHILIPPINES,18657,9,ranidel de ocampo,21,2,6,33.3,2,4,50,0,2,0,0,0,0,0,4,4,0,3,1,0,0,4
375527,422_14_22,PHILIPPINES,9700,10,gabe norwood,25,2,5,40,1,2,50,1,3,33.3,0,0,0,0,2,2,2,3,0,0,0,5
375528,422_14_22,PHILIPPINES,25433,11,andray blatche,33,6,18,33.3,6,15,40,0,3,0,9,11,81.8,0,14,14,1,2,3,3,0,21
375529,422_14_22,PHILIPPINES,23364,12,june mar fajardo,10,3,5,60,3,5,60,0,0,0,4,4,100,4,3,7,0,0,1,1,2,10
375530,422_14_22,PHILIPPINES,25434,13,paul dalistan,15,2,7,28.6,1,4,25,1,3,33.3,0,0,0,0,1,1,0,5,1,1,0,5
375531,422_14_22,PHILIPPINES,14184,14,japeth aguilar,5,1,2,50,1,2,50,0,0,0,0,0,0,1,1,2,0,0,0,0,0,2
375532,422_14_22,PHILIPPINES,23365,15,marc pingris,26,3,5,60,3,5,60,0,0,0,1,3,33.3,1,5,6,1,3,1,1,0,7
375533,422_14_22,PHILIPPINES,0,TOTALS,PHILIPPINES,200,24,68,35.3,18,46,39.1,6,22,27.3,16,20,80,8,33,41,10,25,12,8,2,70
375534,422_14_22,GREECE,8303,4,vaggelis mantzaris,7,0,1,0,0,0,0,0,1,0,0,0,0,0,0,0,2,1,0,1,0,0
375535,422_14_22,GREECE,5050,5,giannis bourousis,27,5,10,50,5,9,55.6,0,1,0,2,2,100,3,7,10,1,3,2,3,3,12
375536,422_14_22,GREECE,123,6,nikos zisis,26,3,6,50,3,5,60,0,1,0,2,3,66.7,0,2,2,2,2,1,1,0,8
375537,422_14_22,GREECE,1053,7,kostas vasileiadis,22,2,6,33.3,0,0,0,2,6,33.3,0,0,0,1,2,3,1,0,0,0,0,6
375538,422_14_22,GREECE,12472,8,nick calathes,23,3,9,33.3,2,7,28.6,1,2,50,2,3,66.7,0,2,2,2,2,3,0,1,9
375539,422_14_22,GREECE,11632,9,andreas glyniadakis,0,0,0,0,0,0,0,0,0,0,0,0,0,0,0,0,0,0,0,0,0,0
375540,422_14_22,GREECE,10606,10,kostas papanikolaou,21,2,5,40,2,3,66.7,0,2,0,5,9,55.6,1,5,6,4,3,3,0,3,9
375541,422_14_22,GREECE,8304,11,kostas sloukas,9,1,1,100,1,1,100,0,0,0,1,1,100,0,0,0,2,2,0,0,0,3
375542,422_14_22,GREECE,15374,12,kostas kaimakoglou,20,1,3,33.3,0,1,0,1,2,50,2,2,100,2,3,5,0,1,0,0,0,5
375543,422_14_22,GREECE,24314,13,giannis antetokounmpo,14,0,3,0,0,0,0,0,3,0,3,4,75,0,6,6,0,0,0,0,0,3
375544,422_14_22,GREECE,1061,14,ian vougioukas,5,0,2,0,0,2,0,0,0,0,2,2,100,1,0,1,0,2,0,0,0,2
375545,422_14_22,GREECE,1056,15,georgios printezis,26,11,19,57.9,10,15,66.7,1,4,25,2,4,50,1,7,8,0,3,2,1,1,25
375546,422_14_22,GREECE,0,TOTALS,GREECE,200,28,65,43.1,23,43,53.5,5,22,22.7,21,30,70,10,35,45,14,19,12,6,8,82
375547,422_14_23,TURKEY,20219,4,cedi osman,14,0,2,0,0,1,0,0,1,0,0,0,0,0,2,2,0,2,1,1,0,0
375548,422_14_23,TURKEY,15304,5,sinan guler,26,3,6,50,1,2,50,2,4,50,1,2,50,1,2,3,3,2,5,0,1,9
375549,422_14_23,TURKEY,4571,6,baris ermis,4,2,2,100,1,1,100,1,1,100,0,0,0,0,1,1,0,1,1,0,0,5
375550,422_14_23,TURKEY,1798,7,cenk akyol,24,4,9,44.4,2,4,50,2,5,40,2,4,50,1,3,4,1,3,0,1,0,12
375551,422_14_23,TURKEY,2576,8,baris hersek,16,2,4,50,1,2,50,1,2,50,3,3,100,0,1,1,1,1,1,0,0,8
375552,422_14_23,TURKEY,7785,9,emir preldzic,22,2,4,50,1,2,50,1,2,50,4,6,66.7,0,2,2,5,2,3,0,0,9
375553,422_14_23,TURKEY,4569,10,kerem tunceri,18,1,3,33.3,0,1,0,1,2,50,0,0,0,0,1,1,2,2,2,0,0,3
375554,422_14_23,TURKEY,1796,11,oguz savas,15,4,10,40,4,9,44.4,0,1,0,1,2,50,1,3,4,1,2,2,0,1,9
375555,422_14_23,TURKEY,4576,12,kerem gonlum,14,2,5,40,2,4,50,0,1,0,0,0,0,1,1,2,0,2,2,0,0,4
375556,422_14_23,TURKEY,4572,13,ender arslan,21,2,7,28.6,1,2,50,1,5,20,3,3,100,0,2,2,4,2,4,0,0,8
375557,422_14_23,TURKEY,7790,14,omer asik,21,2,2,100,2,2,100,0,0,0,2,5,40,2,6,8,0,3,6,0,3,6
375558,422_14_23,TURKEY,10942,15,furkan aldemir,5,2,2,100,2,2,100,0,0,0,0,0,0,1,0,1,0,0,0,0,0,4
375559,422_14_23,TURKEY,0,TOTALS,TURKEY,200,26,56,46.4,17,32,53.1,9,24,37.5,16,25,64,9,25,34,17,22,28,2,5,77
375560,422_14_23,USA,9010,4,stephen curry,24,3,11,27.3,0,5,0,3,6,50,0,0,0,1,1,2,3,2,2,5,0,9
375561,422_14_23,USA,13751,5,klay thompson,25,2,7,28.6,0,0,0,2,7,28.6,0,0,0,0,1,1,2,2,1,2,0,6
375562,422_14_23,USA,16600,6,derrick rose,17,0,4,0,0,1,0,0,3,0,2,4,50,0,2,2,0,2,2,0,0,2
375563,422_14_23,USA,25451,7,kenneth faried,28,11,14,78.6,11,14,78.6,0,0,0,0,0,0,3,5,8,1,2,0,3,2,22
375564,422_14_23,USA,3452,8,rudy gay,9,0,0,0,0,0,0,0,0,0,0,0,0,0,2,2,2,4,2,0,0,0
375565,422_14_23,USA,25452,9,demar derozan,5,1,3,33.3,1,3,33.3,0,0,0,0,0,0,2,0,2,0,0,1,0,0,2
375566,422_14_23,USA,16977,10,kyrie irving,24,5,9,55.6,3,6,50,2,3,66.7,1,2,50,0,3,3,5,3,2,1,0,13
375567,422_14_23,USA,12194,11,mason plumlee,4,0,0,0,0,0,0,0,0,0,0,0,0,0,0,0,0,0,0,0,0,0
375568,422_14_23,USA,25453,12,demarcus cousins,13,5,8,62.5,5,8,62.5,0,0,0,1,2,50,1,2,3,1,2,1,1,0,11
375569,422_14_23,USA,21035,13,james harden,25,4,7,57.1,3,4,75,1,3,33.3,5,6,83.3,0,0,0,7,3,0,3,0,14
375570,422_14_23,USA,21036,14,anthony davis,26,8,11,72.7,8,11,72.7,0,0,0,3,5,60,2,4,6,0,3,0,2,2,19
375571,422_14_23,USA,14750,15,andre drummond,0,0,0,0,0,0,0,0,0,0,0,0,0,0,0,0,0,0,0,0,0,0
375572,422_14_23,USA,0,TOTALS,USA,200,39,74,52.7,31,52,59.6,8,22,36.4,12,19,63.2,10,22,32,21,23,12,17,4,98
375573,422_14_24,SPAIN,61,4,pau gasol,19,5,8,62.5,5,8,62.5,0,0,0,2,4,50,2,1,3,1,1,3,1,1,12
375574,422_14_24,SPAIN,70,5,rudy fernandez,17,5,8,62.5,3,6,50,2,2,100,2,2,100,1,2,3,2,0,0,2,1,14
375575,422_14_24,SPAIN,1877,6,sergio rodriguez,16,2,5,40,2,3,66.7,0,2,0,0,0,0,0,1,1,2,2,1,0,0,4
375576,422_14_24,SPAIN,64,7,juan c. navarro,19,3,5,60,2,2,100,1,3,33.3,0,0,0,0,2,2,4,0,0,0,0,7
375577,422_14_24,SPAIN,65,8,jose calderon,15,0,4,0,0,0,0,0,4,0,0,0,0,0,3,3,2,3,1,0,0,0
375578,422_14_24,SPAIN,66,9,felipe reyes,21,1,7,14.3,1,6,16.7,0,1,0,0,0,0,2,5,7,2,1,1,3,0,2
375579,422_14_24,SPAIN,2628,10,victor claver,8,3,4,75,3,3,100,0,1,0,0,0,0,1,1,2,0,1,1,1,0,6
375580,422_14_24,SPAIN,6259,11,ricky rubio,19,1,4,25,1,3,33.3,0,1,0,4,4,100,1,4,5,7,1,2,1,1,6
375581,422_14_24,SPAIN,1871,12,sergio llull,20,2,6,33.3,1,2,50,1,4,25,0,0,0,0,2,2,1,2,1,0,1,5
375582,422_14_24,SPAIN,1108,13,marc gasol,15,2,3,66.7,2,3,66.7,0,0,0,4,4,100,1,4,5,0,2,3,1,2,8
375583,422_14_24,SPAIN,7001,14,serge ibaka,21,8,12,66.7,7,9,77.8,1,3,33.3,1,1,100,2,6,8,1,0,1,0,1,18
375584,422_14_24,SPAIN,19988,15,alex abrines,10,3,5,60,1,1,100,2,4,50,1,1,100,1,0,1,0,0,0,0,0,9
375585,422_14_24,SPAIN,0,TOTALS,SPAIN,200,35,71,49.3,28,46,60.9,7,25,28,14,16,87.5,12,35,47,22,13,14,9,7,91
375586,422_14_24,EGYPT,18379,4,seif samir,14,0,1,0,0,0,0,0,1,0,0,0,0,0,3,3,0,1,1,1,1,0
375587,422_14_24,EGYPT,25438,5,amr gendy,20,3,9,33.3,3,7,42.9,0,2,0,0,0,0,1,2,3,0,0,0,0,0,6
375588,422_14_24,EGYPT,13947,6,haytham kamal,29,3,9,33.3,3,6,50,0,3,0,2,4,50,1,4,5,0,3,3,1,0,8
375589,422_14_24,EGYPT,9153,7,wael badr,18,2,3,66.7,2,2,100,0,1,0,0,0,0,0,0,0,1,3,1,0,0,4
375590,422_14_24,EGYPT,9156,8,moamen abouelanin,5,0,1,0,0,0,0,0,1,0,0,0,0,0,1,1,0,1,0,0,0,0
375591,422_14_24,EGYPT,9154,9,ibrahim elgammal,29,5,13,38.5,3,7,42.9,2,6,33.3,4,6,66.7,0,4,4,3,3,6,1,0,16
375592,422_14_24,EGYPT,18516,10,mouhanad elsabagh,6,0,1,0,0,0,0,0,1,0,0,0,0,1,0,1,0,0,2,0,0,0
375593,422_14_24,EGYPT,25439,11,sherif genedy,24,3,10,30,1,5,20,2,5,40,0,0,0,2,0,2,0,3,2,0,0,8
375594,422_14_24,EGYPT,16644,12,youssef shousha,19,3,4,75,3,4,75,0,0,0,0,0,0,0,1,1,0,3,1,2,0,6
375595,422_14_24,EGYPT,25440,13,moustafa elmekawi,17,3,7,42.9,3,5,60,0,2,0,0,0,0,1,1,2,1,2,2,2,0,6
375596,422_14_24,EGYPT,18519,14,ramy ibrahim,19,0,7,0,0,4,0,0,3,0,0,0,0,1,6,7,0,2,2,0,0,0
375597,422_14_24,EGYPT,9161,15,ashraf rabie,0,0,0,0,0,0,0,0,0,0,0,0,0,0,0,0,0,0,0,0,0,0
375598,422_14_24,EGYPT,0,TOTALS,EGYPT,200,22,65,33.8,18,40,45,4,25,16,6,10,60,8,24,32,5,21,20,7,1,54
375599,422_14_25,CROATIA,1844,4,ante tomic,25,1,3,33.3,1,3,33.3,0,0,0,12,14,85.7,3,6,9,2,2,1,0,0,14
375600,422_14_25,CROATIA,1121,5,luksa andric,4,1,1,100,1,1,100,0,0,0,1,3,33.3,0,0,0,0,1,0,0,0,3
375601,422_14_25,CROATIA,25431,6,oliver lafayette,23,2,7,28.6,1,4,25,1,3,33.3,0,0,0,0,3,3,1,1,2,0,0,5
375602,422_14_25,CROATIA,6280,7,bojan bogdanovic,31,5,14,35.7,4,7,57.1,1,7,14.3,4,8,50,0,3,3,1,3,2,0,0,15
375603,422_14_25,CROATIA,15894,8,dario saric,28,6,9,66.7,6,7,85.7,0,2,0,3,3,100,2,4,6,4,3,1,3,0,15
375604,422_14_25,CROATIA,1846,9,damjan rudez,12,2,6,33.3,0,1,0,2,5,40,0,0,0,0,0,0,0,3,0,0,0,6
375605,422_14_25,CROATIA,4585,10,roko ukic,20,1,1,100,0,0,0,1,1,100,0,0,0,0,1,1,2,0,0,0,0,3
375606,422_14_25,CROATIA,1249,11,krunoslav simon,28,2,7,28.6,0,2,0,2,5,40,0,0,0,0,2,2,3,4,2,1,1,6
375607,422_14_25,CROATIA,1250,12,damir markota,11,1,5,20,1,2,50,0,3,0,0,0,0,2,0,2,2,0,0,0,0,2
375608,422_14_25,CROATIA,18415,13,mario hezonja,7,1,1,100,1,1,100,0,0,0,0,0,0,0,0,0,1,1,1,0,0,2
375609,422_14_25,CROATIA,16607,14,luka zoric,11,2,2,100,2,2,100,0,0,0,0,0,0,0,0,0,0,5,1,0,0,4
375610,422_14_25,CROATIA,13759,15,luka babic,0,0,0,0,0,0,0,0,0,0,0,0,0,0,0,0,0,0,0,0,0,0
375611,422_14_25,CROATIA,0,TOTALS,CROATIA,200,24,56,42.9,17,30,56.7,7,26,26.9,20,28,71.4,8,21,29,16,23,10,4,1,75
375612,422_14_25,SENEGAL,11764,4,thierno niang,2,0,0,0,0,0,0,0,0,0,0,0,0,0,0,0,0,0,1,0,0,0
375613,422_14_25,SENEGAL,18541,5,xane dalmeida,36,4,8,50,1,4,25,3,4,75,4,4,100,0,1,1,5,3,0,1,0,15
375614,422_14_25,SENEGAL,23085,6,ibrahima thomas,0,0,0,0,0,0,0,0,0,0,0,0,0,0,0,0,0,0,0,0,0,0
375615,422_14_25,SENEGAL,18542,7,mamadou ndoye,2,0,0,0,0,0,0,0,0,0,1,2,50,0,0,0,0,1,0,0,0,1
375616,422_14_25,SENEGAL,18543,8,mohamet diop,13,2,8,25,1,5,20,1,3,33.3,0,0,0,0,2,2,0,4,1,1,0,5
375617,422_14_25,SENEGAL,3592,9,maleye ndoye,34,2,6,33.3,0,1,0,2,5,40,3,4,75,0,1,1,2,2,1,2,0,9
375618,422_14_25,SENEGAL,25448,10,djibril thiam,0,0,0,0,0,0,0,0,0,0,0,0,0,0,0,0,0,0,0,0,0,0
375619,422_14_25,SENEGAL,9148,11,mouhammad faye,30,4,10,40,3,7,42.9,1,3,33.3,2,3,66.7,3,3,6,3,5,1,1,0,11
375620,422_14_25,SENEGAL,25449,12,maurice ndour,10,0,1,0,0,1,0,0,0,0,0,0,0,0,1,1,0,2,2,2,0,0
375621,422_14_25,SENEGAL,23089,13,hamady ndiaye,16,2,2,100,2,2,100,0,0,0,1,2,50,2,3,5,1,4,2,0,3,5
375622,422_14_25,SENEGAL,25450,14,gorgui dieng,40,8,14,57.1,8,14,57.1,0,0,0,11,12,91.7,2,6,8,3,4,4,1,2,27
375623,422_14_25,SENEGAL,23091,15,abdou badji,17,2,4,50,2,4,50,0,0,0,0,0,0,1,4,5,0,3,1,0,1,4
375624,422_14_25,SENEGAL,0,TOTALS,SENEGAL,200,24,53,45.3,17,38,44.7,7,15,46.7,22,27,81.5,10,23,33,14,28,15,8,6,77
375625,422_14_26,IRAN,23303,4,rouzbeh arghavan,1,0,0,0,0,0,0,0,0,0,0,0,0,0,0,0,0,3,0,0,0,0
375626,422_14_26,IRAN,22993,5,sajjad mashayekhi,0,0,0,0,0,0,0,0,0,0,0,0,0,0,0,0,0,0,0,0,0,0
375627,422_14_26,IRAN,22994,6,behnam yakhchali,19,1,5,20,0,0,0,1,5,20,0,0,0,2,0,2,1,3,1,1,0,3
375628,422_14_26,IRAN,9685,7,mahdi kamrani,32,0,4,0,0,1,0,0,3,0,2,2,100,0,2,2,0,3,4,1,0,2
375629,422_14_26,IRAN,13745,8,arsalan kazemi,21,2,4,50,2,4,50,0,0,0,2,2,100,1,3,4,1,3,1,1,0,6
375630,422_14_26,IRAN,14408,9,arman zangeneh,0,0,0,0,0,0,0,0,0,0,0,0,0,0,0,0,0,0,0,0,0,0
375631,422_14_26,IRAN,9688,10,hamed afagh,29,2,4,50,0,0,0,2,4,50,0,0,0,1,1,2,1,4,4,0,0,6
375632,422_14_26,IRAN,9690,11,oshin sahakian,26,0,1,0,0,0,0,0,1,0,2,2,100,1,1,2,1,3,1,2,0,2
375633,422_14_26,IRAN,16613,12,asghar kardoust,0,0,0,0,0,0,0,0,0,0,0,0,0,0,0,0,0,0,0,0,0,0
375634,422_14_26,IRAN,13739,13,mohammad jamshidi,11,1,2,50,1,1,100,0,1,0,0,0,0,0,1,1,0,1,2,1,0,2
375635,422_14_26,IRAN,11627,14,samad nikkhah bahrami,31,8,14,57.1,6,10,60,2,4,50,2,2,100,0,0,0,7,4,5,1,0,20
375636,422_14_26,IRAN,9693,15,hamed haddadi,30,10,12,83.3,10,10,100,0,2,0,9,12,75,1,4,5,0,4,4,4,1,29
375637,422_14_26,IRAN,0,TOTALS,IRAN,200,24,46,52.2,19,26,73.1,5,20,25,17,20,85,7,15,22,11,28,23,11,1,70
375638,422_14_26,SERBIA,5751,4,milos teodosic,31,3,6,50,1,1,100,2,5,40,0,0,0,1,0,1,9,2,5,1,0,8
375639,422_14_26,SERBIA,2100,5,marko simonovic,9,1,2,50,1,2,50,0,0,0,2,3,66.7,0,0,0,0,0,0,1,0,4
375640,422_14_26,SERBIA,25441,6,stefan jovic,19,1,1,100,1,1,100,0,0,0,0,0,0,1,3,4,3,2,1,2,0,2
375641,422_14_26,SERBIA,17361,7,bogdan bogdanovic,35,7,11,63.6,6,7,85.7,1,4,25,1,2,50,0,2,2,2,2,3,2,1,16
375642,422_14_26,SERBIA,15386,8,nemanja bjelica,35,6,11,54.5,5,9,55.6,1,2,50,5,7,71.4,3,7,10,2,3,3,1,0,18
375643,422_14_26,SERBIA,2654,9,stefan markovic,19,2,2,100,1,1,100,1,1,100,0,0,0,1,2,3,4,3,3,1,1,5
375644,422_14_26,SERBIA,19860,10,nikola kalinic,11,1,1,100,0,0,0,1,1,100,0,0,0,0,1,1,0,1,0,0,0,3
375645,422_14_26,SERBIA,15504,11,stefan bircevic,2,0,0,0,0,0,0,0,0,0,0,0,0,0,0,0,0,1,0,0,0,0
375646,422_14_26,SERBIA,93,12,nenad krstic,0,0,0,0,0,0,0,0,0,0,0,0,0,0,0,0,0,0,0,0,0,0
375647,422_14_26,SERBIA,2656,13,miroslav raduljica,17,5,9,55.6,5,9,55.6,0,0,0,3,5,60,2,0,2,0,4,1,1,0,13
375648,422_14_26,SERBIA,24202,14,rasko katic,16,2,7,28.6,2,7,28.6,0,0,0,4,10,40,2,1,3,0,4,1,0,0,8
375649,422_14_26,SERBIA,5756,15,vladimir stimac,7,3,3,100,3,3,100,0,0,0,0,2,0,0,1,1,0,1,0,0,0,6
375650,422_14_26,SERBIA,0,TOTALS,SERBIA,200,31,53,58.5,25,40,62.5,6,13,46.2,15,29,51.7,11,17,28,20,23,19,9,2,83
375651,422_14_27,ARGENTINA,80,4,luis scola,32,7,12,58.3,6,10,60,1,2,50,4,5,80,4,3,7,4,4,3,1,0,19
375652,422_14_27,ARGENTINA,16652,5,tayavek gallizzi,0,0,0,0,0,0,0,0,0,0,0,0,0,0,0,0,0,0,0,0,0,0
375653,422_14_27,ARGENTINA,12069,6,marcos mata,26,6,10,60,1,3,33.3,5,7,71.4,0,0,0,3,6,9,1,2,0,0,0,17
375654,422_14_27,ARGENTINA,21037,7,facundo campazzo,14,3,6,50,2,3,66.7,1,3,33.3,2,2,100,0,1,1,4,1,1,3,0,9
375655,422_14_27,ARGENTINA,357,8,pablo prigioni,36,2,9,22.2,0,4,0,2,5,40,2,2,100,3,1,4,3,2,2,3,0,8
375656,422_14_27,ARGENTINA,12228,9,nicolas laprovittola,30,4,10,40,2,2,100,2,8,25,0,1,0,0,3,3,4,4,1,2,0,10
375657,422_14_27,ARGENTINA,81,10,leo gutierrez,14,1,6,16.7,0,0,0,1,6,16.7,0,0,0,0,1,1,1,2,1,0,0,3
375658,422_14_27,ARGENTINA,14903,11,marcos delia,0,0,0,0,0,0,0,0,0,0,0,0,0,0,0,0,0,0,0,0,0,0
375659,422_14_27,ARGENTINA,77,12,walter herrmann,14,4,6,66.7,2,3,66.7,2,3,66.7,0,1,0,1,4,5,0,0,0,0,0,10
375660,422_14_27,ARGENTINA,82,13,andres nocioni,34,2,10,20,1,6,16.7,1,4,25,4,5,80,2,2,4,0,2,0,1,0,9
375661,422_14_27,ARGENTINA,12297,14,matias bortolin,0,0,0,0,0,0,0,0,0,0,0,0,0,0,0,0,0,0,0,0,0,0
375662,422_14_27,ARGENTINA,21197,15,selem safar,0,0,0,0,0,0,0,0,0,0,0,0,0,0,0,0,0,0,0,0,0,0
375663,422_14_27,ARGENTINA,0,TOTALS,ARGENTINA,200,29,69,42,14,31,45.2,15,38,39.5,12,16,75,13,22,35,17,17,8,10,0,85
375664,422_14_27,PHILIPPINES,9696,4,jim alapag,22,5,7,71.4,0,0,0,5,7,71.4,0,0,0,0,1,1,2,0,1,0,0,15
375665,422_14_27,PHILIPPINES,23359,5,lewis tenorio,15,0,3,0,0,2,0,0,1,0,3,3,100,0,0,0,1,1,0,0,0,3
375666,422_14_27,PHILIPPINES,25432,6,jeff chan,9,0,2,0,0,0,0,0,2,0,0,0,0,0,0,0,1,0,0,0,0,0
375667,422_14_27,PHILIPPINES,23361,7,jayson william,27,4,11,36.4,1,6,16.7,3,5,60,0,0,0,1,2,3,2,4,3,1,0,11
375668,422_14_27,PHILIPPINES,23362,8,gary david,0,0,0,0,0,0,0,0,0,0,0,0,0,0,0,0,0,0,0,0,0,0
375669,422_14_27,PHILIPPINES,18657,9,ranidel de ocampo,25,7,14,50,3,6,50,4,8,50,0,0,0,1,4,5,1,2,0,0,0,18
375670,422_14_27,PHILIPPINES,9700,10,gabe norwood,36,3,4,75,3,3,100,0,1,0,0,0,0,1,1,2,1,3,2,0,1,6
375671,422_14_27,PHILIPPINES,25433,11,andray blatche,24,6,9,66.7,6,7,85.7,0,2,0,2,2,100,2,13,15,0,4,4,2,2,14
375672,422_14_27,PHILIPPINES,23364,12,june mar fajardo,9,3,5,60,3,5,60,0,0,0,0,0,0,0,2,2,0,1,0,1,0,6
375673,422_14_27,PHILIPPINES,25434,13,paul dalistan,7,2,2,100,1,1,100,1,1,100,1,1,100,0,1,1,0,1,2,0,0,6
375674,422_14_27,PHILIPPINES,14184,14,japeth aguilar,7,1,2,50,1,2,50,0,0,0,0,2,0,0,0,0,0,1,1,0,0,2
375675,422_14_27,PHILIPPINES,23365,15,marc pingris,19,0,2,0,0,2,0,0,0,0,0,0,0,2,3,5,1,2,2,0,0,0
375676,422_14_27,PHILIPPINES,0,TOTALS,PHILIPPINES,200,31,61,50.8,18,34,52.9,13,27,48.1,6,8,75,8,31,39,9,19,16,4,3,81
375677,422_14_28,FRANCE,12495,4,thomas heurtel,20,3,5,60,3,5,60,0,0,0,0,0,0,0,2,2,8,0,3,1,0,6
375678,422_14_28,FRANCE,2588,5,nicolas batum,15,4,5,80,3,4,75,1,1,100,0,0,0,0,3,3,2,0,1,0,1,9
375679,422_14_28,FRANCE,2589,6,antoine diot,22,4,6,66.7,2,2,100,2,4,50,0,0,0,0,4,4,6,1,1,0,0,10
375680,422_14_28,FRANCE,11076,7,joffrey lauvergne,11,4,5,80,4,5,80,0,0,0,4,6,66.7,1,6,7,0,1,1,0,1,12
375681,422_14_28,FRANCE,1864,8,charles kahudi,19,2,5,40,1,2,50,1,3,33.3,1,1,100,2,2,4,4,0,1,0,0,6
375682,422_14_28,FRANCE,6249,9,edwin jackson,20,3,6,50,2,3,66.7,1,3,33.3,0,1,0,0,1,1,1,2,0,1,0,7
375683,422_14_28,FRANCE,12971,10,evan fournier,19,4,9,44.4,4,5,80,0,4,0,1,2,50,0,1,1,4,3,2,1,0,9
375684,422_14_28,FRANCE,4663,11,florent pietrus,20,4,4,100,3,3,100,1,1,100,2,4,50,0,4,4,2,1,0,0,0,11
375685,422_14_28,FRANCE,17374,12,rudy gobert,18,2,2,100,2,2,100,0,0,0,2,4,50,0,6,6,0,0,1,0,1,6
375686,422_14_28,FRANCE,4665,13,boris diaw,8,1,1,100,0,0,0,1,1,100,0,0,0,0,1,1,3,0,2,0,0,3
375687,422_14_28,FRANCE,7987,14,kim tillie,13,5,6,83.3,5,6,83.3,0,0,0,0,0,0,0,3,3,0,1,0,2,0,10
375688,422_14_28,FRANCE,5044,15,mickael gelabale,15,2,4,50,2,3,66.7,0,1,0,1,1,100,0,1,1,1,0,0,1,1,5
375689,422_14_28,FRANCE,0,TOTALS,FRANCE,200,38,58,65.5,31,40,77.5,7,18,38.9,11,19,57.9,5,36,41,31,9,13,6,4,94
375690,422_14_28,EGYPT,18379,4,seif samir,10,1,2,50,1,2,50,0,0,0,0,0,0,0,3,3,0,2,0,0,0,2
375691,422_14_28,EGYPT,25438,5,amr gendy,24,3,8,37.5,3,6,50,0,2,0,0,0,0,0,2,2,0,1,0,0,0,6
375692,422_14_28,EGYPT,13947,6,haytham kamal,23,2,8,25,2,8,25,0,0,0,0,0,0,1,1,2,2,2,1,1,0,4
375693,422_14_28,EGYPT,9153,7,wael badr,15,1,4,25,1,3,33.3,0,1,0,0,0,0,0,2,2,1,2,0,0,0,2
375694,422_14_28,EGYPT,9156,8,moamen abouelanin,0,0,0,0,0,0,0,0,0,0,0,0,0,0,0,0,0,0,0,0,0,0
375695,422_14_28,EGYPT,9154,9,ibrahim elgammal,31,4,15,26.7,2,8,25,2,7,28.6,2,2,100,2,2,4,3,2,3,1,0,12
375696,422_14_28,EGYPT,18516,10,mouhanad elsabagh,13,1,4,25,1,3,33.3,0,1,0,0,0,0,0,0,0,2,2,1,2,0,2
375697,422_14_28,EGYPT,25439,11,sherif genedy,15,4,7,57.1,1,3,33.3,3,4,75,0,0,0,0,0,0,0,1,2,0,0,11
375698,422_14_28,EGYPT,16644,12,youssef shousha,22,3,4,75,2,3,66.7,1,1,100,0,0,0,1,0,1,0,0,0,2,0,7
375699,422_14_28,EGYPT,25440,13,moustafa elmekawi,13,0,0,0,0,0,0,0,0,0,2,4,50,0,1,1,1,4,1,1,0,2
375700,422_14_28,EGYPT,18519,14,ramy ibrahim,16,1,6,16.7,1,4,25,0,2,0,0,0,0,0,3,3,0,1,1,0,0,2
375701,422_14_28,EGYPT,9161,15,ashraf rabie,18,2,9,22.2,1,6,16.7,1,3,33.3,0,0,0,1,1,2,1,3,0,0,0,5
375702,422_14_28,EGYPT,0,TOTALS,EGYPT,200,22,67,32.8,15,46,32.6,7,21,33.3,4,6,66.7,6,17,23,10,20,13,7,0,55
375703,422_14_29,PUERTO RICO,23748,4,ramon clemente,13,2,5,40,2,5,40,0,0,0,2,2,100,2,3,5,1,2,0,0,0,6
375704,422_14_29,PUERTO RICO,19036,5,jose barea,34,6,15,40,2,6,33.3,4,9,44.4,5,6,83.3,3,1,4,5,4,2,0,0,21
375705,422_14_29,PUERTO RICO,21059,6,alex franklin,20,0,1,0,0,0,0,0,1,0,1,2,50,4,2,6,2,0,0,0,0,1
375706,422_14_29,PUERTO RICO,100,7,carlos arroyo,0,0,0,0,0,0,0,0,0,0,0,0,0,0,0,0,0,0,0,0,0,0
375707,422_14_29,PUERTO RICO,3479,8,angel vassallo,0,0,0,0,0,0,0,0,0,0,0,0,0,0,0,0,0,0,0,0,0,0
375708,422_14_29,PUERTO RICO,25443,9,carlos rivera,24,3,5,60,1,2,50,2,3,66.7,2,2,100,1,2,3,2,4,2,0,0,10
375709,422_14_29,PUERTO RICO,8997,10,jorge bryan diaz,16,0,5,0,0,5,0,0,0,0,0,0,0,1,2,3,0,0,1,1,0,0
375710,422_14_29,PUERTO RICO,481,11,ricky sanchez,5,0,1,0,0,0,0,0,1,0,1,2,50,0,1,1,0,2,1,0,0,1
375711,422_14_29,PUERTO RICO,7435,12,david huertas,18,1,7,14.3,1,7,14.3,0,0,0,4,4,100,1,1,2,0,4,0,0,0,6
375712,422_14_29,PUERTO RICO,16592,13,renaldo balkman,35,7,11,63.6,7,11,63.6,0,0,0,9,11,81.8,1,4,5,0,4,2,4,1,23
375713,422_14_29,PUERTO RICO,3478,14,alexander galindo,20,2,7,28.6,2,3,66.7,0,4,0,1,2,50,1,3,4,0,3,1,0,0,5
375714,422_14_29,PUERTO RICO,108,15,daniel santiago,15,3,5,60,3,5,60,0,0,0,0,0,0,0,1,1,0,2,2,1,1,6
375715,422_14_29,PUERTO RICO,0,TOTALS,PUERTO RICO,200,24,62,38.7,18,44,40.9,6,18,33.3,25,31,80.6,14,21,35,10,25,11,6,2,79
375716,422_14_29,GREECE,8303,4,vaggelis mantzaris,8,0,1,0,0,0,0,0,1,0,0,0,0,0,0,0,0,3,1,0,0,0
375717,422_14_29,GREECE,5050,5,giannis bourousis,27,5,10,50,5,9,55.6,0,1,0,2,2,100,1,7,8,6,3,2,2,1,12
375718,422_14_29,GREECE,123,6,nikos zisis,25,7,9,77.8,3,4,75,4,5,80,1,2,50,0,2,2,3,1,1,1,0,19
375719,422_14_29,GREECE,1053,7,kostas vasileiadis,6,1,2,50,1,1,100,0,1,0,2,2,100,0,3,3,0,0,0,0,0,4
375720,422_14_29,GREECE,12472,8,nick calathes,29,5,8,62.5,5,8,62.5,0,0,0,4,8,50,1,1,2,1,1,2,1,1,14
375721,422_14_29,GREECE,11632,9,andreas glyniadakis,4,0,0,0,0,0,0,0,0,0,1,2,50,1,0,1,0,0,0,0,0,1
375722,422_14_29,GREECE,10606,10,kostas papanikolaou,19,2,6,33.3,2,4,50,0,2,0,0,0,0,0,2,2,3,2,2,0,1,4
375723,422_14_29,GREECE,8304,11,kostas sloukas,13,2,3,66.7,1,2,50,1,1,100,0,0,0,0,0,0,2,1,0,0,0,5
375724,422_14_29,GREECE,15374,12,kostas kaimakoglou,26,4,5,80,4,5,80,0,0,0,1,2,50,7,4,11,5,5,1,0,0,9
375725,422_14_29,GREECE,24314,13,giannis antetokounmpo,23,5,11,45.5,5,8,62.5,0,3,0,5,7,71.4,0,3,3,0,3,1,1,0,15
375726,422_14_29,GREECE,1061,14,ian vougioukas,8,1,4,25,1,4,25,0,0,0,0,0,0,2,2,4,1,1,1,0,0,2
375727,422_14_29,GREECE,1056,15,georgios printezis,12,2,5,40,2,4,50,0,1,0,1,1,100,0,1,1,0,4,0,0,0,5
375728,422_14_29,GREECE,0,TOTALS,GREECE,200,34,64,53.1,29,49,59.2,5,15,33.3,17,26,65.4,12,25,37,21,24,11,5,3,90
375729,422_14_30,BRAZIL,332,4,marcelo machado,7,2,3,66.7,0,1,0,2,2,100,0,0,0,0,1,1,0,0,0,0,0,6
375730,422_14_30,BRAZIL,14848,5,raulzinho neto,16,1,3,33.3,1,3,33.3,0,0,0,0,0,0,0,2,2,0,3,0,2,0,2
375731,422_14_30,BRAZIL,23752,6,rafael hettsheimeir,17,0,4,0,0,0,0,0,4,0,0,0,0,0,4,4,0,3,0,1,0,0
375732,422_14_30,BRAZIL,21034,7,larry taylor,16,2,5,40,2,5,40,0,0,0,0,0,0,1,0,1,2,1,2,0,0,4
375733,422_14_30,BRAZIL,4102,8,alex garcia,19,1,4,25,1,4,25,0,0,0,0,0,0,1,1,2,0,3,1,0,0,2
375734,422_14_30,BRAZIL,4098,9,marcelinho huertas,21,3,8,37.5,3,8,37.5,0,0,0,2,2,100,1,2,3,0,2,0,0,0,8
375735,422_14_30,BRAZIL,4100,10,leandrinho barbosa,24,5,7,71.4,4,6,66.7,1,1,100,0,0,0,0,0,0,2,1,0,1,0,11
375736,422_14_30,BRAZIL,4103,11,anderson varejao,23,5,8,62.5,5,8,62.5,0,0,0,0,2,0,0,4,4,1,1,0,1,0,10
375737,422_14_30,BRAZIL,4104,12,guilherme giovannoni,0,0,0,0,0,0,0,0,0,0,0,0,0,0,0,0,0,0,0,0,0,0
375738,422_14_30,BRAZIL,9844,13,nene hilario,20,2,7,28.6,2,7,28.6,0,0,0,3,5,60,1,4,5,0,2,0,0,1,7
375739,422_14_30,BRAZIL,19020,14,marquinhos vieira,17,3,8,37.5,3,5,60,0,3,0,1,2,50,0,5,5,1,1,1,0,0,7
375740,422_14_30,BRAZIL,4106,15,tiago splitter,21,2,7,28.6,2,7,28.6,0,0,0,2,4,50,1,3,4,1,3,2,1,0,6
375741,422_14_30,BRAZIL,0,TOTALS,BRAZIL,200,26,64,40.6,23,54,42.6,3,10,30,8,15,53.3,6,26,32,7,20,6,6,1,63
375742,422_14_30,SPAIN,61,4,pau gasol,29,11,15,73.3,8,10,80,3,5,60,1,2,50,2,7,9,2,2,3,0,3,26
375743,422_14_30,SPAIN,70,5,rudy fernandez,24,2,3,66.7,0,1,0,2,2,100,0,0,0,0,4,4,1,2,0,0,0,6
375744,422_14_30,SPAIN,1877,6,sergio rodriguez,18,4,6,66.7,2,3,66.7,2,3,66.7,2,4,50,1,2,3,1,3,2,0,0,12
375745,422_14_30,SPAIN,64,7,juan c. navarro,22,4,9,44.4,2,5,40,2,4,50,0,0,0,0,4,4,4,1,1,1,0,10
375746,422_14_30,SPAIN,65,8,jose calderon,12,1,3,33.3,0,0,0,1,3,33.3,2,2,100,1,1,2,0,0,1,0,0,5
375747,422_14_30,SPAIN,66,9,felipe reyes,2,0,2,0,0,2,0,0,0,0,1,2,50,1,0,1,0,1,0,0,0,1
375748,422_14_30,SPAIN,2628,10,victor claver,1,0,0,0,0,0,0,0,0,0,0,0,0,0,0,0,0,0,0,0,0,0
375749,422_14_30,SPAIN,6259,11,ricky rubio,22,0,3,0,0,3,0,0,0,0,2,2,100,0,2,2,6,3,1,1,0,2
375750,422_14_30,SPAIN,1871,12,sergio llull,21,3,7,42.9,2,2,100,1,5,20,0,0,0,0,3,3,0,3,0,0,0,7
375751,422_14_30,SPAIN,1108,13,marc gasol,30,3,5,60,3,5,60,0,0,0,2,2,100,0,5,5,3,4,2,1,1,8
375752,422_14_30,SPAIN,7001,14,serge ibaka,17,2,5,40,2,4,50,0,1,0,1,2,50,0,5,5,0,2,0,0,0,5
375753,422_14_30,SPAIN,19988,15,alex abrines,2,0,1,0,0,0,0,0,1,0,0,0,0,0,0,0,0,0,0,0,0,0
375754,422_14_30,SPAIN,0,TOTALS,SPAIN,200,30,59,50.8,19,35,54.3,11,24,45.8,11,16,68.8,6,35,41,17,21,10,3,4,82
375755,422_14_31,ANGOLA,1,4,olimpio cipriano,26,1,8,12.5,1,3,33.3,0,5,0,1,1,100,2,4,6,2,2,2,1,0,3
375756,422_14_31,ANGOLA,3574,5,armando costa,26,2,7,28.6,1,4,25,1,3,33.3,0,0,0,2,2,4,0,3,0,0,0,5
375757,422_14_31,ANGOLA,16597,6,roberto fortes,21,2,4,50,0,0,0,2,4,50,1,2,50,1,1,2,0,1,1,0,0,7
375758,422_14_31,ANGOLA,13818,7,edson ndoniema,9,2,3,66.7,2,3,66.7,0,0,0,1,2,50,1,1,2,0,1,1,0,0,5
375759,422_14_31,ANGOLA,11834,8,gildo santos,10,0,3,0,0,2,0,0,1,0,0,0,0,0,0,0,2,2,1,0,0,0
375760,422_14_31,ANGOLA,7039,9,valdelicio joaquim,22,5,17,29.4,4,14,28.6,1,3,33.3,2,2,100,3,2,5,0,2,0,0,1,13
375761,422_14_31,ANGOLA,7,10,joaquim gomes,10,0,2,0,0,1,0,0,1,0,0,0,0,2,0,2,0,1,2,1,0,0
375762,422_14_31,ANGOLA,23104,11,reggie moore,9,0,2,0,0,1,0,0,1,0,0,0,0,0,0,0,0,0,0,0,0,0
375763,422_14_31,ANGOLA,11831,12,yanick moreira,20,6,13,46.2,6,13,46.2,0,0,0,1,1,100,3,6,9,1,2,0,1,0,13
375764,422_14_31,ANGOLA,13822,13,islando manuel,4,0,2,0,0,1,0,0,1,0,2,2,100,2,1,3,0,0,0,0,0,2
375765,422_14_31,ANGOLA,21052,14,milton barros,23,1,8,12.5,1,3,33.3,0,5,0,0,0,0,1,0,1,3,3,1,1,0,2
375766,422_14_31,ANGOLA,12,15,eduardo mingas,22,2,9,22.2,2,6,33.3,0,3,0,1,1,100,2,1,3,2,2,1,2,0,5
375767,422_14_31,ANGOLA,0,TOTALS,ANGOLA,200,21,78,26.9,17,51,33.3,4,27,14.8,9,11,81.8,24,21,45,10,19,9,6,1,55
375768,422_14_31,MEXICO,16880,4,paul stoll,11,2,2,100,0,0,0,2,2,100,0,0,0,0,0,0,2,2,0,0,0,6
375769,422_14_31,MEXICO,23812,5,marco ramos,18,0,0,0,0,0,0,0,0,0,0,0,0,0,2,2,0,2,1,3,0,0
375770,422_14_31,MEXICO,23755,6,roman martinez,22,4,9,44.4,0,2,0,4,7,57.1,0,0,0,0,4,4,1,3,2,0,0,12
375771,422_14_31,MEXICO,23756,7,jorge gutierrez,30,3,7,42.9,3,6,50,0,1,0,0,0,0,0,6,6,3,3,2,1,0,6
375772,422_14_31,MEXICO,9836,8,gustavo ayon,38,6,11,54.5,6,11,54.5,0,0,0,5,6,83.3,5,7,12,3,2,3,2,2,17
375773,422_14_31,MEXICO,23813,9,francisco cruz,36,5,15,33.3,5,9,55.6,0,6,0,4,4,100,1,6,7,4,1,0,1,0,14
375774,422_14_31,MEXICO,25444,10,israel gutierrez,0,0,0,0,0,0,0,0,0,0,0,0,0,0,0,0,0,0,0,0,0,0
375775,422_14_31,MEXICO,25445,11,david meza,4,0,2,0,0,2,0,0,0,0,0,0,0,0,0,0,0,0,0,0,0,0
375776,422_14_31,MEXICO,9835,12,hector hernandez,27,7,12,58.3,1,2,50,6,10,60,4,4,100,1,4,5,0,2,2,0,0,24
375777,422_14_31,MEXICO,21215,13,orlando mendez,2,0,0,0,0,0,0,0,0,0,0,0,0,0,0,0,0,0,0,0,0,0
375778,422_14_31,MEXICO,25446,14,adrian zamora,0,0,0,0,0,0,0,0,0,0,0,0,0,0,0,0,0,0,0,0,0,0
375779,422_14_31,MEXICO,25447,15,adam parada,12,0,0,0,0,0,0,0,0,0,0,0,0,0,0,0,0,3,2,0,2,0
375780,422_14_31,MEXICO,0,TOTALS,MEXICO,200,27,58,46.6,15,32,46.9,12,26,46.2,13,14,92.9,10,33,43,13,18,13,7,4,79
375781,422_14_32,UKRAINE,5790,4,maksym pustozvonov,23,2,5,40,2,2,100,0,3,0,0,0,0,0,5,5,2,4,0,1,0,4
375782,422_14_32,UKRAINE,25435,5,"eugene ""pooh"" jeter",33,2,10,20,1,5,20,1,5,20,5,5,100,0,1,1,6,3,5,0,0,10
375783,422_14_32,UKRAINE,12946,6,olexandr mishula,27,7,14,50,2,6,33.3,5,8,62.5,0,0,0,1,1,2,2,0,0,2,0,19
375784,422_14_32,UKRAINE,22292,7,sviatoslav mykhailiuk,9,0,2,0,0,1,0,0,1,0,0,0,0,0,1,1,1,0,1,0,0,0
375785,422_14_32,UKRAINE,7931,8,sergii gladyr,0,0,0,0,0,0,0,0,0,0,0,0,0,0,0,0,0,0,0,0,0,0
375786,422_14_32,UKRAINE,10926,9,oleksandr lypovyy,22,3,10,30,2,5,40,1,5,20,0,0,0,1,1,2,0,2,1,0,0,7
375787,422_14_32,UKRAINE,8223,10,kyryl natyazhko,18,2,4,50,2,3,66.7,0,1,0,0,0,0,0,2,2,0,1,0,0,0,4
375788,422_14_32,UKRAINE,1026,11,dmytro zabirchenko,12,1,2,50,0,0,0,1,2,50,0,0,0,0,0,0,1,0,1,1,1,3
375789,422_14_32,UKRAINE,5791,12,maxym kornienko,13,0,4,0,0,3,0,0,1,0,0,0,0,2,4,6,0,0,0,1,1,0
375790,422_14_32,UKRAINE,10713,13,ihor zaytsev,22,5,10,50,3,5,60,2,5,40,0,0,0,3,2,5,0,2,0,0,0,12
375791,422_14_32,UKRAINE,19863,14,artem pustovyi,0,0,0,0,0,0,0,0,0,0,0,0,0,0,0,0,0,0,0,0,0,0
375792,422_14_32,UKRAINE,5792,15,slava kravtsov,22,2,3,66.7,2,3,66.7,0,0,0,1,2,50,0,7,7,0,3,1,0,0,5
375793,422_14_32,UKRAINE,0,TOTALS,UKRAINE,200,24,64,37.5,14,33,42.4,10,31,32.3,6,7,85.7,9,26,35,12,15,10,5,2,64
375794,422_14_32,TURKEY,20219,4,cedi osman,3,0,0,0,0,0,0,0,0,0,0,0,0,0,0,0,0,1,0,0,0,0
375795,422_14_32,TURKEY,15304,5,sinan guler,32,1,2,50,1,2,50,0,0,0,1,2,50,0,4,4,1,3,3,1,1,3
375796,422_14_32,TURKEY,4571,6,baris ermis,0,0,0,0,0,0,0,0,0,0,0,0,0,0,0,0,0,0,0,0,0,0
375797,422_14_32,TURKEY,1798,7,cenk akyol,18,1,5,20,0,2,0,1,3,33.3,0,0,0,0,2,2,0,3,2,0,0,3
375798,422_14_32,TURKEY,2576,8,baris hersek,15,0,1,0,0,1,0,0,0,0,0,0,0,0,1,1,3,4,1,0,0,0
375799,422_14_32,TURKEY,7785,9,emir preldzic,36,4,12,33.3,2,7,28.6,2,5,40,4,6,66.7,0,7,7,3,1,1,0,0,14
375800,422_14_32,TURKEY,4569,10,kerem tunceri,11,1,4,25,1,4,25,0,0,0,0,0,0,0,0,0,1,0,2,0,0,2
375801,422_14_32,TURKEY,1796,11,oguz savas,14,3,4,75,3,4,75,0,0,0,1,1,100,0,2,2,1,1,2,0,1,7
375802,422_14_32,TURKEY,4576,12,kerem gonlum,12,2,4,50,2,4,50,0,0,0,0,0,0,0,0,0,1,0,0,1,0,4
375803,422_14_32,TURKEY,4572,13,ender arslan,27,3,9,33.3,0,2,0,3,7,42.9,0,0,0,0,2,2,2,2,1,1,0,9
375804,422_14_32,TURKEY,7790,14,omer asik,32,4,11,36.4,4,11,36.4,0,0,0,8,10,80,8,12,20,0,0,1,0,1,16
375805,422_14_32,TURKEY,10942,15,furkan aldemir,0,0,0,0,0,0,0,0,0,0,0,0,0,0,0,0,0,0,0,0,0,0
375806,422_14_32,TURKEY,0,TOTALS,TURKEY,200,19,52,36.5,13,37,35.1,6,15,40,14,19,73.7,8,31,39,12,15,13,3,3,58
375807,422_14_33,AUSTRALIA,9039,4,chris goulding,0,0,0,0,0,0,0,0,0,0,0,0,0,0,0,0,0,0,0,0,0,0
375808,422_14_33,AUSTRALIA,13813,5,ryan broekhoff,24,2,5,40,0,1,0,2,4,50,2,2,100,1,2,3,0,2,1,2,0,8
375809,422_14_33,AUSTRALIA,3458,6,adam gibson,11,0,0,0,0,0,0,0,0,0,0,0,0,0,2,2,1,1,0,0,0,0
375810,422_14_33,AUSTRALIA,11635,7,joe ingles,35,7,11,63.6,5,7,71.4,2,4,50,2,4,50,0,1,1,4,1,1,3,0,18
375811,422_14_33,AUSTRALIA,3466,8,brad newley,19,3,6,50,2,5,40,1,1,100,3,5,60,3,1,4,2,3,0,1,0,10
375812,422_14_33,AUSTRALIA,13811,9,matthew dellavedova,27,4,9,44.4,2,6,33.3,2,3,66.7,3,4,75,0,2,2,2,2,3,1,0,13
375813,422_14_33,AUSTRALIA,25376,10,cameron bairstow,5,1,1,100,1,1,100,0,0,0,0,0,0,0,0,0,0,3,0,0,0,2
375814,422_14_33,AUSTRALIA,20984,11,dante exum,4,0,0,0,0,0,0,0,0,0,0,0,0,0,1,1,1,0,1,0,0,0
375815,422_14_33,AUSTRALIA,16519,12,aron baynes,22,5,12,41.7,5,12,41.7,0,0,0,4,4,100,3,3,6,0,4,2,1,0,14
375816,422_14_33,AUSTRALIA,142,13,david andersen,30,3,9,33.3,3,8,37.5,0,1,0,1,3,33.3,0,5,5,2,3,3,1,0,7
375817,422_14_33,AUSTRALIA,13814,14,brock motum,16,3,8,37.5,3,7,42.9,0,1,0,0,0,0,2,0,2,1,3,2,0,0,6
375818,422_14_33,AUSTRALIA,3457,15,nate jawai,7,2,3,66.7,2,3,66.7,0,0,0,0,0,0,2,3,5,0,1,0,0,0,4
375819,422_14_33,AUSTRALIA,0,TOTALS,AUSTRALIA,200,30,64,46.9,23,50,46,7,14,50,15,22,68.2,11,21,32,13,23,14,9,0,82
375820,422_14_33,LITHUANIA,1728,4,martynas pocius,26,3,7,42.9,3,6,50,0,1,0,0,1,0,0,1,1,1,4,2,0,0,6
375821,422_14_33,LITHUANIA,6225,5,adas juskevicius,8,0,2,0,0,1,0,0,1,0,0,0,0,0,1,1,0,0,3,0,0,0
375822,422_14_33,LITHUANIA,10639,6,mindaugas kuzminskas,13,1,3,33.3,0,2,0,1,1,100,0,0,0,1,0,1,1,3,0,1,0,3
375823,422_14_33,LITHUANIA,5073,7,darjus lavrinovic,22,4,5,80,3,3,100,1,2,50,5,5,100,0,2,2,1,1,0,1,2,14
375824,422_14_33,LITHUANIA,980,8,jonas maciulis,21,1,5,20,0,4,0,1,1,100,1,2,50,0,2,2,1,0,3,2,1,4
375825,422_14_33,LITHUANIA,3474,9,renaldas seibutis,31,7,11,63.6,6,7,85.7,1,4,25,6,6,100,0,3,3,3,1,2,0,0,21
375826,422_14_33,LITHUANIA,292,10,simas jasaitis,8,0,1,0,0,0,0,0,1,0,0,0,0,0,0,0,0,2,0,0,0,0
375827,422_14_33,LITHUANIA,8177,11,donatas motiejunas,8,1,2,50,1,1,100,0,1,0,0,0,0,0,1,1,0,0,2,0,0,2
375828,422_14_33,LITHUANIA,21,12,ksistof lavrinovic,15,2,2,100,1,1,100,1,1,100,3,3,100,0,4,4,1,3,3,0,0,8
375829,422_14_33,LITHUANIA,987,13,paulius jankunas,16,3,6,50,3,4,75,0,2,0,3,3,100,0,2,2,0,2,2,0,0,9
375830,422_14_33,LITHUANIA,10916,14,jonas valanciunas,18,2,3,66.7,2,3,66.7,0,0,0,0,0,0,1,5,6,0,3,5,0,0,4
375831,422_14_33,LITHUANIA,6221,15,sarunas vasiliauskas,14,1,2,50,1,1,100,0,1,0,2,2,100,0,2,2,0,2,0,0,0,4
375832,422_14_33,LITHUANIA,0,TOTALS,LITHUANIA,200,25,49,51,20,33,60.6,5,16,31.2,20,22,90.9,4,25,29,8,21,22,4,3,75
375833,422_14_34,USA,9010,4,stephen curry,24,4,7,57.1,2,3,66.7,2,4,50,2,2,100,1,4,5,3,3,5,2,1,12
375834,422_14_34,USA,13751,5,klay thompson,21,5,9,55.6,3,4,75,2,5,40,0,0,0,0,1,1,1,0,1,0,0,12
375835,422_14_34,USA,16600,6,derrick rose,17,1,6,16.7,1,4,25,0,2,0,1,2,50,0,1,1,2,1,0,1,1,3
375836,422_14_34,USA,25451,7,kenneth faried,25,7,9,77.8,7,9,77.8,0,0,0,1,1,100,7,4,11,0,1,0,1,1,15
375837,422_14_34,USA,3452,8,rudy gay,15,1,4,25,1,3,33.3,0,1,0,0,0,0,1,3,4,3,2,2,2,0,2
375838,422_14_34,USA,25452,9,demar derozan,9,1,1,100,1,1,100,0,0,0,2,4,50,0,0,0,1,1,1,0,0,4
375839,422_14_34,USA,16977,10,kyrie irving,23,4,9,44.4,3,6,50,1,3,33.3,1,1,100,0,4,4,2,2,1,4,0,10
375840,422_14_34,USA,12194,11,mason plumlee,5,0,2,0,0,2,0,0,0,0,1,4,25,2,1,3,1,0,0,0,0,1
375841,422_14_34,USA,25453,12,demarcus cousins,11,2,4,50,2,4,50,0,0,0,0,0,0,1,1,2,2,1,2,0,0,4
375842,422_14_34,USA,21035,13,james harden,24,3,5,60,2,3,66.7,1,2,50,6,8,75,0,2,2,4,1,4,2,0,13
375843,422_14_34,USA,21036,14,anthony davis,22,7,13,53.8,7,13,53.8,0,0,0,7,10,70,2,7,9,2,0,0,2,1,21
375844,422_14_34,USA,14750,15,andre drummond,4,0,0,0,0,0,0,0,0,0,1,2,50,1,1,2,0,1,0,0,0,1
375845,422_14_34,USA,0,TOTALS,USA,200,35,69,50.7,29,52,55.8,6,17,35.3,22,34,64.7,17,30,47,21,13,16,14,4,98
375846,422_14_34,NEW ZEALAND,6772,4,lindsay tait,10,2,3,66.7,2,3,66.7,0,0,0,1,3,33.3,1,0,1,3,0,1,0,0,5
375847,422_14_34,NEW ZEALAND,21055,5,everard bartlett,16,3,7,42.9,0,1,0,3,6,50,0,0,0,0,2,2,0,0,3,0,0,9
375848,422_14_34,NEW ZEALAND,39,6,kirk penney,20,3,9,33.3,3,6,50,0,3,0,0,0,0,1,3,4,0,2,1,0,0,6
375849,422_14_34,NEW ZEALAND,6773,7,mika vukona,19,3,5,60,3,5,60,0,0,0,1,2,50,3,2,5,0,3,3,0,0,7
375850,422_14_34,NEW ZEALAND,16521,8,jarrod kenny,13,0,0,0,0,0,0,0,0,0,0,0,0,0,0,0,2,3,0,1,0,0
375851,422_14_34,NEW ZEALAND,11656,9,corey webster,19,3,10,30,1,5,20,2,5,40,0,0,0,0,2,2,1,1,3,0,0,8
375852,422_14_34,NEW ZEALAND,16523,10,thomas abercrombie,18,2,7,28.6,2,5,40,0,2,0,0,0,0,3,2,5,1,4,1,0,0,4
375853,422_14_34,NEW ZEALAND,16524,11,bj anthony,16,5,6,83.3,4,5,80,1,1,100,0,0,0,1,2,3,0,2,0,1,1,11
375854,422_14_34,NEW ZEALAND,25442,12,isaac fotu,17,3,4,75,1,1,100,2,3,66.7,0,0,0,0,2,2,1,0,1,0,0,8
375855,422_14_34,NEW ZEALAND,6846,13,casey frank,20,3,9,33.3,3,7,42.9,0,2,0,0,0,0,0,1,1,2,3,1,1,0,6
375856,422_14_34,NEW ZEALAND,13832,14,rob loe,18,1,6,16.7,0,3,0,1,3,33.3,0,0,0,2,1,3,1,3,3,0,0,3
375857,422_14_34,NEW ZEALAND,21056,15,tai webster,15,1,5,20,1,4,25,0,1,0,2,2,100,0,0,0,0,1,4,0,2,4
375858,422_14_34,NEW ZEALAND,0,TOTALS,NEW ZEALAND,200,29,71,40.8,20,45,44.4,9,26,34.6,4,7,57.1,12,22,34,11,22,22,3,3,71
375859,422_14_35,KOREA,18641,4,taejong moon,17,3,7,42.9,1,2,50,2,5,40,0,0,0,0,0,0,3,2,0,0,0,8
375860,422_14_35,KOREA,18640,5,chan hee park,10,2,6,33.3,2,4,50,0,2,0,2,4,50,0,0,0,1,1,0,0,0,6
375861,422_14_35,KOREA,9631,6,donggeun yang,14,1,4,25,0,1,0,1,3,33.3,0,0,0,1,2,3,0,1,0,2,0,3
375862,422_14_35,KOREA,11667,7,taesul kim,18,2,5,40,2,4,50,0,1,0,1,1,100,2,2,4,2,2,1,0,0,5
375863,422_14_35,KOREA,14338,8,jonghyun lee,20,5,7,71.4,5,7,71.4,0,0,0,2,2,100,1,4,5,2,3,2,1,4,12
375864,422_14_35,KOREA,9054,9,sunhyung kim,16,1,4,25,1,4,25,0,0,0,0,0,0,0,1,1,2,1,3,0,0,2
375865,422_14_35,KOREA,18643,10,sungmin cho,22,2,7,28.6,0,2,0,2,5,40,2,3,66.7,0,1,1,0,1,1,0,0,8
375866,422_14_35,KOREA,9635,11,heejong yang,10,2,3,66.7,2,3,66.7,0,0,0,0,0,0,2,1,3,1,3,0,0,1,4
375867,422_14_35,KOREA,3914,12,joo sung kim,20,1,1,100,1,1,100,0,0,0,3,4,75,1,1,2,1,2,2,0,1,5
375868,422_14_35,KOREA,25437,13,ilyoung heo,13,2,6,33.3,1,3,33.3,1,3,33.3,2,2,100,0,1,1,0,0,0,0,0,7
375869,422_14_35,KOREA,11670,14,sekeun oh,19,3,6,50,3,5,60,0,1,0,2,4,50,2,3,5,2,2,1,0,1,8
375870,422_14_35,KOREA,18644,15,jongkyu kim,21,2,4,50,2,4,50,0,0,0,0,0,0,1,5,6,2,3,2,0,1,4
375871,422_14_35,KOREA,0,TOTALS,KOREA,200,26,60,43.3,20,40,50,6,20,30,14,20,70,11,23,34,16,21,12,3,8,72
375872,422_14_35,SLOVENIA,24203,4,jure balazic,28,4,7,57.1,1,2,50,3,5,60,0,0,0,2,4,6,1,3,0,0,0,11
375873,422_14_35,SLOVENIA,5023,5,uros slokar,5,0,2,0,0,2,0,0,0,0,1,4,25,0,0,0,0,0,0,1,0,1
375874,422_14_35,SLOVENIA,17812,6,aleksej nikolic,3,0,1,0,0,0,0,0,1,0,0,0,0,0,0,0,0,0,0,0,0,0
375875,422_14_35,SLOVENIA,17343,7,klemen prepelic,8,0,2,0,0,0,0,0,2,0,0,0,0,0,1,1,0,0,0,0,0,0
375876,422_14_35,SLOVENIA,10978,8,edo muric,13,1,3,33.3,0,0,0,1,3,33.3,0,0,0,0,1,1,1,2,0,0,1,3
375877,422_14_35,SLOVENIA,15479,9,jaka blazic,9,2,2,100,2,2,100,0,0,0,0,0,0,0,2,2,0,2,1,0,0,4
375878,422_14_35,SLOVENIA,4764,10,miha zupan,16,3,4,75,1,1,100,2,3,66.7,0,0,0,0,1,1,1,4,1,0,0,8
375879,422_14_35,SLOVENIA,1068,11,goran dragic,25,10,14,71.4,8,10,80,2,4,50,0,1,0,2,0,2,4,2,0,0,0,22
375880,422_14_35,SLOVENIA,6197,12,zoran dragic,27,4,13,30.8,3,7,42.9,1,6,16.7,4,5,80,0,3,3,2,2,1,0,1,13
375881,422_14_35,SLOVENIA,1064,13,domen lorbek,26,4,10,40,2,4,50,2,6,33.3,4,4,100,0,1,1,0,2,2,1,0,14
375882,422_14_35,SLOVENIA,5782,14,jaka klobucar,18,0,4,0,0,3,0,0,1,0,0,2,0,0,3,3,2,1,2,0,0,0
375883,422_14_35,SLOVENIA,17344,15,alen omic,22,6,7,85.7,6,7,85.7,0,0,0,1,2,50,6,5,11,0,2,1,1,0,13
375884,422_14_35,SLOVENIA,0,TOTALS,SLOVENIA,200,34,69,49.3,23,38,60.5,11,31,35.5,10,18,55.6,16,24,40,11,20,9,3,2,89
375885,422_14_36,FINLAND,1834,4,mikko koivisto,21,3,6,50,1,1,100,2,5,40,0,0,0,0,3,3,1,5,0,0,0,8
375886,422_14_36,FINLAND,25454,5,erik murphy,20,1,7,14.3,0,4,0,1,3,33.3,0,0,0,0,1,1,0,4,3,0,0,3
375887,422_14_36,FINLAND,4930,6,kimmo muurinen,11,2,6,33.3,2,6,33.3,0,0,0,0,0,0,0,1,1,0,3,1,0,0,4
375888,422_14_36,FINLAND,1314,7,shawn huff,21,3,10,30,2,6,33.3,1,4,25,0,0,0,2,2,4,0,5,0,2,0,7
375889,422_14_36,FINLAND,1836,8,gerald lee,21,3,7,42.9,3,7,42.9,0,0,0,2,2,100,4,2,6,1,2,1,0,0,8
375890,422_14_36,FINLAND,11129,9,sasu salin,27,1,7,14.3,0,0,0,1,7,14.3,0,0,0,0,1,1,0,1,0,1,0,3
375891,422_14_36,FINLAND,4932,10,tuukka kotti,24,1,5,20,1,5,20,0,0,0,0,0,0,1,2,3,0,0,0,2,1,2
375892,422_14_36,FINLAND,2802,11,petteri koponen,35,8,14,57.1,5,8,62.5,3,6,50,4,4,100,0,3,3,9,2,2,2,0,23
375893,422_14_36,FINLAND,8436,12,matti nuutinen,0,0,0,0,0,0,0,0,0,0,0,0,0,0,0,0,0,0,0,0,0,0
375894,422_14_36,FINLAND,4935,13,hanno mottola,4,1,2,50,0,0,0,1,2,50,0,0,0,0,0,0,0,1,1,0,0,3
375895,422_14_36,FINLAND,25455,14,antero lehto,0,0,0,0,0,0,0,0,0,0,0,0,0,0,0,0,0,0,0,0,0,0
375896,422_14_36,FINLAND,4937,15,teemu rannikko,16,2,6,33.3,0,1,0,2,5,40,1,2,50,0,0,0,3,3,1,2,0,7
375897,422_14_36,FINLAND,0,TOTALS,FINLAND,200,25,70,35.7,14,38,36.8,11,32,34.4,7,8,87.5,11,17,28,14,26,9,9,1,68
375898,422_14_36,DOMINICAN REPUBLIC,19011,4,edgar sosa,16,1,4,25,1,2,50,0,2,0,0,0,0,0,1,1,4,2,1,0,0,2
375899,422_14_36,DOMINICAN REPUBLIC,461,5,manuel fortuna,6,2,2,100,1,1,100,1,1,100,2,2,100,0,0,0,0,4,0,0,0,7
375900,422_14_36,DOMINICAN REPUBLIC,14632,6,juan coronado,11,0,0,0,0,0,0,0,0,0,1,4,25,3,0,3,0,3,0,0,0,1
375901,422_14_36,DOMINICAN REPUBLIC,25436,7,victor liz,6,0,2,0,0,1,0,0,1,0,3,4,75,1,1,2,0,1,1,0,0,3
375902,422_14_36,DOMINICAN REPUBLIC,23761,8,edward santana,0,0,0,0,0,0,0,0,0,0,0,0,0,0,0,0,0,0,0,0,0,0
375903,422_14_36,DOMINICAN REPUBLIC,4116,9,francisco garcia,32,6,9,66.7,2,4,50,4,5,80,0,0,0,1,3,4,2,0,7,0,1,16
375904,422_14_36,DOMINICAN REPUBLIC,23762,10,james feldeine,35,4,9,44.4,4,7,57.1,0,2,0,2,2,100,0,4,4,6,0,2,2,0,10
375905,422_14_36,DOMINICAN REPUBLIC,19070,11,eloy vargas,26,7,10,70,7,10,70,0,0,0,4,5,80,5,8,13,0,2,3,1,4,18
375906,422_14_36,DOMINICAN REPUBLIC,19016,12,orlando sanchez,5,1,2,50,1,1,100,0,1,0,0,0,0,0,1,1,1,0,0,1,0,2
375907,422_14_36,DOMINICAN REPUBLIC,9947,13,eulis baez,33,4,10,40,2,6,33.3,2,4,50,2,6,33.3,2,7,9,2,2,4,1,0,12
375908,422_14_36,DOMINICAN REPUBLIC,16889,14,ronald ramon,14,0,2,0,0,1,0,0,1,0,1,2,50,0,1,1,1,2,0,0,0,1
375909,422_14_36,DOMINICAN REPUBLIC,430,15,jack martinez,16,1,4,25,1,4,25,0,0,0,0,0,0,0,5,5,1,1,4,0,0,2
375910,422_14_36,DOMINICAN REPUBLIC,0,TOTALS,DOMINICAN REPUBLIC,200,26,54,48.1,19,37,51.4,7,17,41.2,15,25,60,15,34,49,17,17,23,5,5,74
375911,422_14_37,MEXICO,16880,4,paul stoll,27,3,9,33.3,2,4,50,1,5,20,0,0,0,0,4,4,4,4,3,0,0,7
375912,422_14_37,MEXICO,23812,5,marco ramos,17,3,3,100,1,1,100,2,2,100,0,0,0,2,0,2,1,2,0,3,0,8
375913,422_14_37,MEXICO,23755,6,roman martinez,3,0,0,0,0,0,0,0,0,0,0,0,0,0,0,0,0,1,0,0,0,0
375914,422_14_37,MEXICO,23756,7,jorge gutierrez,26,4,12,33.3,4,11,36.4,0,1,0,2,2,100,0,3,3,2,2,1,1,1,10
375915,422_14_37,MEXICO,9836,8,gustavo ayon,28,4,10,40,4,10,40,0,0,0,3,8,37.5,4,5,9,1,4,2,2,1,11
375916,422_14_37,MEXICO,23813,9,francisco cruz,20,2,7,28.6,1,4,25,1,3,33.3,1,2,50,1,0,1,0,2,2,1,0,6
375917,422_14_37,MEXICO,25444,10,israel gutierrez,0,0,0,0,0,0,0,0,0,0,0,0,0,0,0,0,0,0,0,0,0,0
375918,422_14_37,MEXICO,25445,11,david meza,0,0,0,0,0,0,0,0,0,0,0,0,0,0,0,0,0,0,0,0,0,0
375919,422_14_37,MEXICO,9835,12,hector hernandez,30,1,3,33.3,0,0,0,1,3,33.3,2,4,50,0,1,1,0,3,1,0,0,5
375920,422_14_37,MEXICO,21215,13,orlando mendez,26,4,9,44.4,2,6,33.3,2,3,66.7,0,0,0,0,2,2,5,2,1,0,0,10
375921,422_14_37,MEXICO,25446,14,adrian zamora,0,0,0,0,0,0,0,0,0,0,0,0,0,0,0,0,0,0,0,0,0,0
375922,422_14_37,MEXICO,25447,15,adam parada,23,2,4,50,2,4,50,0,0,0,1,2,50,2,2,4,0,1,1,0,2,5
375923,422_14_37,MEXICO,0,TOTALS,MEXICO,200,23,57,40.4,16,40,40,7,17,41.2,9,18,50,10,21,31,13,21,12,7,4,62
375924,422_14_37,AUSTRALIA,9039,4,chris goulding,0,0,0,0,0,0,0,0,0,0,0,0,0,0,0,0,0,0,0,0,0,0
375925,422_14_37,AUSTRALIA,13813,5,ryan broekhoff,25,4,9,44.4,0,2,0,4,7,57.1,0,0,0,1,3,4,3,1,1,0,0,12
375926,422_14_37,AUSTRALIA,3458,6,adam gibson,17,1,1,100,1,1,100,0,0,0,0,0,0,0,0,0,1,4,1,1,0,2
375927,422_14_37,AUSTRALIA,11635,7,joe ingles,32,0,1,0,0,1,0,0,0,0,0,0,0,0,5,5,5,3,2,1,0,0
375928,422_14_37,AUSTRALIA,3466,8,brad newley,18,4,6,66.7,3,5,60,1,1,100,1,4,25,0,0,0,0,0,1,1,0,10
375929,422_14_37,AUSTRALIA,13811,9,matthew dellavedova,23,2,5,40,1,2,50,1,3,33.3,2,3,66.7,0,3,3,2,2,0,1,1,7
375930,422_14_37,AUSTRALIA,25376,10,cameron bairstow,10,3,8,37.5,3,8,37.5,0,0,0,0,0,0,3,1,4,1,2,1,0,0,6
375931,422_14_37,AUSTRALIA,20984,11,dante exum,6,0,0,0,0,0,0,0,0,0,0,0,0,0,1,1,1,1,0,0,0,0
375932,422_14_37,AUSTRALIA,16519,12,aron baynes,30,6,15,40,6,15,40,0,0,0,9,10,90,2,3,5,1,3,2,0,3,21
375933,422_14_37,AUSTRALIA,142,13,david andersen,22,2,5,40,2,3,66.7,0,2,0,2,2,100,2,5,7,1,4,3,2,0,6
375934,422_14_37,AUSTRALIA,13814,14,brock motum,8,1,2,50,1,2,50,0,0,0,0,0,0,0,2,2,1,0,2,1,0,2
375935,422_14_37,AUSTRALIA,3457,15,nate jawai,9,2,4,50,2,4,50,0,0,0,0,0,0,2,2,4,2,3,1,0,0,4
375936,422_14_37,AUSTRALIA,0,TOTALS,AUSTRALIA,200,25,56,44.6,19,43,44.2,6,13,46.2,14,19,73.7,12,27,39,18,23,14,7,4,70
375937,422_14_38,PHILIPPINES,9696,4,jim alapag,14,1,3,33.3,0,1,0,1,2,50,3,3,100,0,0,0,1,2,2,1,0,6
375938,422_14_38,PHILIPPINES,23359,5,lewis tenorio,26,6,9,66.7,4,6,66.7,2,3,66.7,4,5,80,0,1,1,2,2,1,1,0,18
375939,422_14_38,PHILIPPINES,25432,6,jeff chan,6,0,1,0,0,0,0,0,1,0,0,0,0,0,0,0,1,0,0,0,0,0
375940,422_14_38,PHILIPPINES,23361,7,jayson william,19,1,5,20,1,2,50,0,3,0,2,2,100,0,1,1,0,3,0,1,0,4
375941,422_14_38,PHILIPPINES,23362,8,gary david,0,0,0,0,0,0,0,0,0,0,0,0,0,0,0,0,0,0,0,0,0,0
375942,422_14_38,PHILIPPINES,18657,9,ranidel de ocampo,25,1,5,20,1,2,50,0,3,0,0,0,0,2,3,5,3,3,3,0,1,2
375943,422_14_38,PHILIPPINES,9700,10,gabe norwood,32,3,9,33.3,3,3,100,0,6,0,0,0,0,0,3,3,0,2,2,1,0,6
375944,422_14_38,PHILIPPINES,25433,11,andray blatche,37,9,16,56.2,7,10,70,2,6,33.3,5,6,83.3,2,12,14,2,2,6,1,2,25
375945,422_14_38,PHILIPPINES,23364,12,june mar fajardo,4,0,0,0,0,0,0,0,0,0,0,0,0,0,0,0,0,0,1,0,0,0
375946,422_14_38,PHILIPPINES,25434,13,paul dalistan,16,2,5,40,1,1,100,1,4,25,5,6,83.3,1,2,3,1,5,2,2,0,10
375947,422_14_38,PHILIPPINES,14184,14,japeth aguilar,0,0,0,0,0,0,0,0,0,0,0,0,0,0,0,0,0,0,0,0,0,0
375948,422_14_38,PHILIPPINES,23365,15,marc pingris,21,1,4,25,1,4,25,0,0,0,0,0,0,4,1,5,1,4,1,1,0,2
375949,422_14_38,PHILIPPINES,0,TOTALS,PHILIPPINES,200,24,57,42.1,18,29,62.1,6,28,21.4,19,22,86.4,9,23,32,11,23,19,8,3,73
375950,422_14_38,PUERTO RICO,23748,4,ramon clemente,11,1,4,25,1,4,25,0,0,0,0,0,0,1,1,2,0,5,3,1,0,2
375951,422_14_38,PUERTO RICO,19036,5,jose barea,33,8,15,53.3,5,8,62.5,3,7,42.9,11,12,91.7,1,4,5,2,2,5,1,0,30
375952,422_14_38,PUERTO RICO,21059,6,alex franklin,28,1,3,33.3,1,2,50,0,1,0,1,2,50,4,5,9,0,1,1,2,0,3
375953,422_14_38,PUERTO RICO,100,7,carlos arroyo,0,0,0,0,0,0,0,0,0,0,0,0,0,0,0,0,0,0,0,0,0,0
375954,422_14_38,PUERTO RICO,3479,8,angel vassallo,0,0,0,0,0,0,0,0,0,0,0,0,0,0,0,0,0,0,0,0,0,0
375955,422_14_38,PUERTO RICO,25443,9,carlos rivera,22,2,8,25,1,4,25,1,4,25,0,0,0,1,2,3,3,3,1,1,0,5
375956,422_14_38,PUERTO RICO,8997,10,jorge bryan diaz,9,2,3,66.7,2,3,66.7,0,0,0,0,0,0,3,0,3,0,0,1,0,0,4
375957,422_14_38,PUERTO RICO,481,11,ricky sanchez,40,3,8,37.5,0,1,0,3,7,42.9,4,6,66.7,0,4,4,1,3,3,1,1,13
375958,422_14_38,PUERTO RICO,7435,12,david huertas,29,3,12,25,0,6,0,3,6,50,4,4,100,0,0,0,1,2,0,2,0,13
375959,422_14_38,PUERTO RICO,16592,13,renaldo balkman,20,1,3,33.3,1,3,33.3,0,0,0,0,0,0,1,1,2,2,3,1,1,0,2
375960,422_14_38,PUERTO RICO,3478,14,alexander galindo,9,2,2,100,1,1,100,1,1,100,0,0,0,1,1,2,0,2,1,1,0,5
375961,422_14_38,PUERTO RICO,108,15,daniel santiago,0,0,0,0,0,0,0,0,0,0,0,0,0,0,0,0,0,0,0,0,0,0
375962,422_14_38,PUERTO RICO,0,TOTALS,PUERTO RICO,200,23,58,39.7,12,32,37.5,11,26,42.3,20,24,83.3,12,20,32,9,21,16,10,1,77
375963,422_14_39,NEW ZEALAND,6772,4,lindsay tait,7,0,1,0,0,1,0,0,0,0,0,0,0,0,1,1,1,2,1,0,0,0
375964,422_14_39,NEW ZEALAND,21055,5,everard bartlett,21,4,5,80,0,0,0,4,5,80,2,2,100,1,3,4,2,0,1,1,0,14
375965,422_14_39,NEW ZEALAND,39,6,kirk penney,31,6,14,42.9,4,8,50,2,6,33.3,3,4,75,1,6,7,2,3,2,0,0,17
375966,422_14_39,NEW ZEALAND,6773,7,mika vukona,22,2,8,25,2,8,25,0,0,0,3,8,37.5,3,3,6,2,2,2,1,0,7
375967,422_14_39,NEW ZEALAND,16521,8,jarrod kenny,2,0,0,0,0,0,0,0,0,0,0,0,0,0,0,0,0,0,0,0,0,0
375968,422_14_39,NEW ZEALAND,11656,9,corey webster,20,4,7,57.1,2,3,66.7,2,4,50,1,1,100,1,0,1,1,0,5,0,0,11
375969,422_14_39,NEW ZEALAND,16523,10,thomas abercrombie,17,0,3,0,0,1,0,0,2,0,0,0,0,0,1,1,0,3,0,1,0,0
375970,422_14_39,NEW ZEALAND,16524,11,bj anthony,2,0,0,0,0,0,0,0,0,0,0,0,0,0,0,0,0,0,1,0,0,0
375971,422_14_39,NEW ZEALAND,25442,12,isaac fotu,25,5,8,62.5,5,6,83.3,0,2,0,0,2,0,3,7,10,1,1,1,0,0,10
375972,422_14_39,NEW ZEALAND,6846,13,casey frank,19,1,4,25,1,2,50,0,2,0,2,2,100,3,1,4,4,3,2,1,1,4
375973,422_14_39,NEW ZEALAND,13832,14,rob loe,11,1,3,33.3,1,2,50,0,1,0,0,0,0,1,0,1,0,2,1,0,0,2
375974,422_14_39,NEW ZEALAND,21056,15,tai webster,23,3,7,42.9,3,6,50,0,1,0,2,2,100,1,6,7,3,3,3,0,0,8
375975,422_14_39,NEW ZEALAND,0,TOTALS,NEW ZEALAND,200,26,60,43.3,18,37,48.6,8,23,34.8,13,21,61.9,18,30,48,16,19,19,4,1,73
375976,422_14_39,UKRAINE,5790,4,maksym pustozvonov,12,1,2,50,1,1,100,0,1,0,0,0,0,0,0,0,0,4,1,1,0,2
375977,422_14_39,UKRAINE,25435,5,"eugene ""pooh"" jeter",34,5,16,31.2,4,13,30.8,1,3,33.3,3,4,75,1,3,4,6,1,4,5,0,14
375978,422_14_39,UKRAINE,12946,6,olexandr mishula,19,2,7,28.6,1,3,33.3,1,4,25,0,0,0,0,1,1,2,2,0,0,0,5
375979,422_14_39,UKRAINE,22292,7,sviatoslav mykhailiuk,3,0,1,0,0,0,0,0,1,0,0,0,0,0,0,0,0,0,1,0,0,0
375980,422_14_39,UKRAINE,7931,8,sergii gladyr,0,0,0,0,0,0,0,0,0,0,0,0,0,0,0,0,0,0,0,0,0,0
375981,422_14_39,UKRAINE,10926,9,oleksandr lypovyy,25,2,5,40,2,5,40,0,0,0,0,0,0,1,0,1,0,2,2,0,0,4
375982,422_14_39,UKRAINE,8223,10,kyryl natyazhko,20,2,6,33.3,2,6,33.3,0,0,0,0,0,0,2,4,6,2,0,0,1,0,4
375983,422_14_39,UKRAINE,1026,11,dmytro zabirchenko,32,1,4,25,0,0,0,1,4,25,0,0,0,0,0,0,2,4,0,1,0,3
375984,422_14_39,UKRAINE,5791,12,maxym kornienko,22,6,10,60,4,7,57.1,2,3,66.7,1,2,50,0,4,4,0,2,0,2,0,15
375985,422_14_39,UKRAINE,10713,13,ihor zaytsev,21,3,6,50,2,5,40,1,1,100,3,3,100,0,3,3,0,3,3,0,0,10
375986,422_14_39,UKRAINE,19863,14,artem pustovyi,0,0,0,0,0,0,0,0,0,0,0,0,0,0,0,0,0,0,0,0,0,0
375987,422_14_39,UKRAINE,5792,15,slava kravtsov,12,2,5,40,2,5,40,0,0,0,0,0,0,1,1,2,0,2,3,0,0,4
375988,422_14_39,UKRAINE,0,TOTALS,UKRAINE,200,24,62,38.7,18,45,40,6,17,35.3,7,9,77.8,8,17,25,12,20,14,10,0,61
375989,422_14_40,EGYPT,18379,4,seif samir,5,0,1,0,0,1,0,0,0,0,0,0,0,1,0,1,1,1,0,0,0,0
375990,422_14_40,EGYPT,25438,5,amr gendy,18,1,7,14.3,1,4,25,0,3,0,0,0,0,2,1,3,0,1,1,1,0,2
375991,422_14_40,EGYPT,13947,6,haytham kamal,18,0,2,0,0,1,0,0,1,0,2,4,50,1,4,5,2,2,0,0,0,2
375992,422_14_40,EGYPT,9153,7,wael badr,10,1,2,50,1,1,100,0,1,0,0,0,0,0,0,0,1,2,1,0,0,2
375993,422_14_40,EGYPT,9156,8,moamen abouelanin,14,2,5,40,1,4,25,1,1,100,2,2,100,0,3,3,0,0,1,0,0,7
375994,422_14_40,EGYPT,9154,9,ibrahim elgammal,23,3,4,75,3,4,75,0,0,0,4,4,100,0,1,1,3,0,4,1,1,10
375995,422_14_40,EGYPT,18516,10,mouhanad elsabagh,26,4,10,40,3,6,50,1,4,25,4,6,66.7,2,1,3,3,1,2,2,0,13
375996,422_14_40,EGYPT,25439,11,sherif genedy,21,4,9,44.4,3,5,60,1,4,25,0,0,0,1,2,3,0,1,2,0,0,9
375997,422_14_40,EGYPT,16644,12,youssef shousha,26,5,7,71.4,3,4,75,2,3,66.7,3,4,75,2,1,3,1,2,0,0,2,15
375998,422_14_40,EGYPT,25440,13,moustafa elmekawi,15,2,8,25,2,7,28.6,0,1,0,1,2,50,1,2,3,0,4,1,0,0,5
375999,422_14_40,EGYPT,18519,14,ramy ibrahim,21,3,4,75,1,1,100,2,3,66.7,0,0,0,0,2,2,0,3,2,0,0,8
376000,422_14_40,EGYPT,9161,15,ashraf rabie,3,0,1,0,0,0,0,0,1,0,0,0,0,0,0,0,0,0,1,1,0,0
376001,422_14_40,EGYPT,0,TOTALS,EGYPT,200,25,60,41.7,18,38,47.4,7,22,31.8,16,22,72.7,13,19,32,11,17,17,5,3,73
376002,422_14_40,IRAN,23303,4,rouzbeh arghavan,0,0,0,0,0,0,0,0,0,0,0,0,0,0,0,0,0,0,0,0,0,0
376003,422_14_40,IRAN,22993,5,sajjad mashayekhi,0,0,0,0,0,0,0,0,0,0,0,0,0,0,0,0,0,0,0,0,0,0
376004,422_14_40,IRAN,22994,6,behnam yakhchali,11,0,2,0,0,0,0,0,2,0,0,2,0,0,1,1,0,1,0,1,0,0
376005,422_14_40,IRAN,9685,7,mahdi kamrani,32,2,9,22.2,2,6,33.3,0,3,0,0,0,0,0,3,3,2,5,3,2,0,4
376006,422_14_40,IRAN,13745,8,arsalan kazemi,7,1,2,50,1,2,50,0,0,0,0,0,0,1,0,1,2,1,0,1,0,2
376007,422_14_40,IRAN,14408,9,arman zangeneh,13,3,5,60,3,5,60,0,0,0,1,1,100,2,1,3,1,3,0,1,0,7
376008,422_14_40,IRAN,9688,10,hamed afagh,34,4,8,50,2,4,50,2,4,50,2,2,100,1,4,5,2,2,1,1,0,12
376009,422_14_40,IRAN,9690,11,oshin sahakian,27,6,11,54.5,4,6,66.7,2,5,40,0,0,0,3,3,6,1,4,3,0,0,14
376010,422_14_40,IRAN,16613,12,asghar kardoust,0,0,0,0,0,0,0,0,0,0,0,0,0,0,0,0,0,0,0,0,0,0
376011,422_14_40,IRAN,13739,13,mohammad jamshidi,5,1,2,50,1,2,50,0,0,0,0,0,0,0,1,1,1,0,0,0,0,2
376012,422_14_40,IRAN,11627,14,samad nikkhah bahrami,39,9,15,60,3,6,50,6,9,66.7,0,0,0,1,2,3,6,3,3,3,0,24
376013,422_14_40,IRAN,9693,15,hamed haddadi,33,9,16,56.2,9,16,56.2,0,0,0,5,6,83.3,8,7,15,4,3,2,1,2,23
376014,422_14_40,IRAN,0,TOTALS,IRAN,200,35,70,50,25,47,53.2,10,23,43.5,8,11,72.7,16,25,41,19,22,14,10,2,88
376015,422_14_41,SLOVENIA,24203,4,jure balazic,14,4,5,80,1,1,100,3,4,75,0,0,0,0,1,1,0,3,0,1,0,11
376016,422_14_41,SLOVENIA,5023,5,uros slokar,18,2,4,50,2,4,50,0,0,0,2,4,50,1,2,3,1,1,1,0,0,6
376017,422_14_41,SLOVENIA,17812,6,aleksej nikolic,0,0,0,0,0,0,0,0,0,0,0,0,0,0,0,0,0,0,0,0,0,0
376018,422_14_41,SLOVENIA,17343,7,klemen prepelic,11,1,4,25,0,0,0,1,4,25,2,2,100,0,0,0,1,0,0,0,0,5
376019,422_14_41,SLOVENIA,10978,8,edo muric,18,3,6,50,2,2,100,1,4,25,0,0,0,0,0,0,2,3,0,2,0,7
376020,422_14_41,SLOVENIA,15479,9,jaka blazic,14,3,6,50,2,4,50,1,2,50,0,1,0,3,1,4,2,1,2,0,0,7
376021,422_14_41,SLOVENIA,4764,10,miha zupan,20,0,3,0,0,2,0,0,1,0,0,0,0,1,2,3,2,4,1,1,0,0
376022,422_14_41,SLOVENIA,1068,11,goran dragic,17,5,8,62.5,1,2,50,4,6,66.7,0,0,0,0,3,3,2,3,3,1,0,14
376023,422_14_41,SLOVENIA,6197,12,zoran dragic,23,2,5,40,2,3,66.7,0,2,0,2,2,100,2,5,7,2,1,0,1,0,6
376024,422_14_41,SLOVENIA,1064,13,domen lorbek,25,4,9,44.4,1,2,50,3,7,42.9,6,6,100,1,0,1,4,3,3,0,0,17
376025,422_14_41,SLOVENIA,5782,14,jaka klobucar,23,3,7,42.9,2,4,50,1,3,33.3,5,6,83.3,0,2,2,3,2,3,3,0,12
376026,422_14_41,SLOVENIA,17344,15,alen omic,17,4,4,100,4,4,100,0,0,0,0,0,0,2,2,4,0,2,2,0,0,8
376027,422_14_41,SLOVENIA,0,TOTALS,SLOVENIA,200,31,61,50.8,17,28,60.7,14,33,42.4,17,21,81,11,19,30,19,24,15,9,0,93
376028,422_14_41,ANGOLA,1,4,olimpio cipriano,1,0,0,0,0,0,0,0,0,0,0,0,0,0,0,0,0,0,0,0,0,0
376029,422_14_41,ANGOLA,3574,5,armando costa,33,0,3,0,0,1,0,0,2,0,2,2,100,1,2,3,6,5,3,1,0,2
376030,422_14_41,ANGOLA,16597,6,roberto fortes,33,7,11,63.6,5,7,71.4,2,4,50,5,6,83.3,1,2,3,2,3,3,2,0,21
376031,422_14_41,ANGOLA,13818,7,edson ndoniema,30,5,10,50,3,6,50,2,4,50,2,2,100,1,2,3,3,3,1,1,1,14
376032,422_14_41,ANGOLA,11834,8,gildo santos,0,0,0,0,0,0,0,0,0,0,0,0,0,0,0,0,0,0,0,0,0,0
376033,422_14_41,ANGOLA,7039,9,valdelicio joaquim,16,2,6,33.3,2,6,33.3,0,0,0,2,2,100,2,1,3,0,0,3,1,0,6
376034,422_14_41,ANGOLA,7,10,joaquim gomes,1,0,0,0,0,0,0,0,0,0,0,0,0,0,0,0,0,0,0,0,0,0
376035,422_14_41,ANGOLA,23104,11,reggie moore,23,6,11,54.5,3,7,42.9,3,4,75,2,3,66.7,0,6,6,1,3,2,0,0,17
376036,422_14_41,ANGOLA,11831,12,yanick moreira,22,7,13,53.8,7,13,53.8,0,0,0,6,7,85.7,4,1,5,0,3,0,0,1,20
376037,422_14_41,ANGOLA,13822,13,islando manuel,0,0,0,0,0,0,0,0,0,0,0,0,0,0,0,0,0,0,0,0,0,0
376038,422_14_41,ANGOLA,21052,14,milton barros,18,0,3,0,0,1,0,0,2,0,0,0,0,0,2,2,4,3,3,0,0,0
376039,422_14_41,ANGOLA,12,15,eduardo mingas,24,3,7,42.9,3,7,42.9,0,0,0,1,2,50,4,1,5,1,0,2,0,0,7
376040,422_14_41,ANGOLA,0,TOTALS,ANGOLA,200,30,64,46.9,23,48,47.9,7,16,43.8,20,24,83.3,15,20,35,17,20,17,5,2,87
376041,422_14_42,SENEGAL,11764,4,thierno niang,6,1,2,50,1,1,100,0,1,0,0,0,0,0,0,0,0,1,1,0,0,2
376042,422_14_42,SENEGAL,18541,5,xane dalmeida,22,3,8,37.5,3,4,75,0,4,0,3,3,100,0,2,2,4,0,3,0,0,9
376043,422_14_42,SENEGAL,23085,6,ibrahima thomas,8,0,1,0,0,0,0,0,1,0,0,0,0,0,0,0,0,1,1,1,0,0
376044,422_14_42,SENEGAL,18542,7,mamadou ndoye,12,0,2,0,0,2,0,0,0,0,0,0,0,1,1,2,1,1,3,0,0,0
376045,422_14_42,SENEGAL,18543,8,mohamet diop,11,2,4,50,2,4,50,0,0,0,0,0,0,0,0,0,0,2,1,0,0,4
376046,422_14_42,SENEGAL,3592,9,maleye ndoye,26,1,5,20,1,2,50,0,3,0,0,0,0,0,2,2,1,3,2,3,1,2
376047,422_14_42,SENEGAL,25448,10,djibril thiam,0,0,0,0,0,0,0,0,0,0,0,0,0,0,0,0,0,0,0,0,0,0
376048,422_14_42,SENEGAL,9148,11,mouhammad faye,23,1,8,12.5,1,7,14.3,0,1,0,0,0,0,1,1,2,0,0,2,1,0,2
376049,422_14_42,SENEGAL,25449,12,maurice ndour,24,1,4,25,0,3,0,1,1,100,3,4,75,0,3,3,0,2,1,0,0,6
376050,422_14_42,SENEGAL,23089,13,hamady ndiaye,20,3,5,60,3,5,60,0,0,0,0,2,0,2,1,3,0,1,0,2,2,6
376051,422_14_42,SENEGAL,25450,14,gorgui dieng,35,4,12,33.3,4,11,36.4,0,1,0,3,3,100,1,7,8,0,3,5,1,1,11
376052,422_14_42,SENEGAL,23091,15,abdou badji,13,2,4,50,2,4,50,0,0,0,0,0,0,1,3,4,1,3,0,0,0,4
376053,422_14_42,SENEGAL,0,TOTALS,SENEGAL,200,18,55,32.7,17,43,39.5,1,12,8.3,9,12,75,9,20,29,7,17,21,8,4,46
376054,422_14_42,ARGENTINA,80,4,luis scola,29,8,17,47.1,8,17,47.1,0,0,0,6,6,100,5,9,14,1,2,2,0,0,22
376055,422_14_42,ARGENTINA,16652,5,tayavek gallizzi,2,0,0,0,0,0,0,0,0,0,2,2,100,0,0,0,0,0,0,0,0,2
376056,422_14_42,ARGENTINA,12069,6,marcos mata,16,3,4,75,1,1,100,2,3,66.7,0,0,0,0,1,1,1,1,0,0,0,8
376057,422_14_42,ARGENTINA,21037,7,facundo campazzo,25,2,4,50,2,3,66.7,0,1,0,0,0,0,1,0,1,2,3,3,3,0,4
376058,422_14_42,ARGENTINA,357,8,pablo prigioni,21,3,6,50,1,2,50,2,4,50,2,2,100,1,2,3,3,2,3,2,0,10
376059,422_14_42,ARGENTINA,12228,9,nicolas laprovittola,25,3,6,50,1,1,100,2,5,40,0,0,0,0,4,4,6,2,1,1,0,8
376060,422_14_42,ARGENTINA,81,10,leo gutierrez,16,3,5,60,1,1,100,2,4,50,0,0,0,1,3,4,2,3,0,0,1,8
376061,422_14_42,ARGENTINA,14903,11,marcos delia,11,1,3,33.3,1,3,33.3,0,0,0,1,2,50,2,0,2,2,1,0,0,1,3
376062,422_14_42,ARGENTINA,77,12,walter herrmann,23,4,7,57.1,1,2,50,3,5,60,0,0,0,0,1,1,0,2,0,1,0,11
376063,422_14_42,ARGENTINA,82,13,andres nocioni,20,1,8,12.5,0,3,0,1,5,20,0,0,0,1,2,3,1,1,4,2,1,3
376064,422_14_42,ARGENTINA,12297,14,matias bortolin,4,1,2,50,1,2,50,0,0,0,0,0,0,0,4,4,0,0,0,0,0,2
376065,422_14_42,ARGENTINA,21197,15,selem safar,9,0,2,0,0,1,0,0,1,0,0,0,0,1,0,1,2,0,0,1,0,0
376066,422_14_42,ARGENTINA,0,TOTALS,ARGENTINA,200,29,64,45.3,17,36,47.2,12,28,42.9,11,12,91.7,14,27,41,20,17,15,10,3,81
376067,422_14_43,TURKEY,20219,4,cedi osman,14,1,3,33.3,0,0,0,1,3,33.3,4,6,66.7,0,1,1,0,3,1,1,0,7
376068,422_14_43,TURKEY,15304,5,sinan guler,27,1,8,12.5,0,4,0,1,4,25,0,0,0,1,1,2,5,5,1,1,0,3
376069,422_14_43,TURKEY,4571,6,baris ermis,1,0,0,0,0,0,0,0,0,0,0,0,0,0,0,0,1,0,0,0,0,0
376070,422_14_43,TURKEY,1798,7,cenk akyol,6,1,3,33.3,0,0,0,1,3,33.3,0,0,0,0,0,0,1,2,1,1,0,3
376071,422_14_43,TURKEY,2576,8,baris hersek,13,0,3,0,0,1,0,0,2,0,1,2,50,1,2,3,0,0,2,0,0,1
376072,422_14_43,TURKEY,7785,9,emir preldzic,38,2,8,25,2,4,50,0,4,0,9,13,69.2,1,7,8,5,1,1,3,0,13
376073,422_14_43,TURKEY,4569,10,kerem tunceri,17,1,2,50,1,1,100,0,1,0,0,0,0,0,1,1,3,1,0,1,0,2
376074,422_14_43,TURKEY,1796,11,oguz savas,5,1,2,50,1,2,50,0,0,0,0,0,0,0,0,0,1,0,2,0,0,2
376075,422_14_43,TURKEY,4576,12,kerem gonlum,27,3,4,75,3,4,75,0,0,0,4,4,100,1,7,8,2,4,1,0,0,10
376076,422_14_43,TURKEY,4572,13,ender arslan,34,3,8,37.5,0,1,0,3,7,42.9,3,4,75,0,4,4,4,1,1,1,0,12
376077,422_14_43,TURKEY,7790,14,omer asik,37,7,12,58.3,7,12,58.3,0,0,0,8,16,50,3,5,8,1,2,1,2,1,22
376078,422_14_43,TURKEY,10942,15,furkan aldemir,6,1,1,100,1,1,100,0,0,0,0,0,0,0,0,0,0,0,0,0,1,2
376079,422_14_43,TURKEY,0,TOTALS,TURKEY,225,21,54,38.9,15,30,50,6,24,25,29,45,64.4,10,30,40,23,19,13,10,2,77
376080,422_14_43,FINLAND,1834,4,mikko koivisto,28,4,8,50,1,2,50,3,6,50,0,0,0,0,3,3,3,2,0,0,0,11
376081,422_14_43,FINLAND,25454,5,erik murphy,27,2,3,66.7,0,1,0,2,2,100,0,0,0,0,6,6,0,4,2,0,1,6
376082,422_14_43,FINLAND,4930,6,kimmo muurinen,14,1,2,50,1,2,50,0,0,0,0,0,0,0,3,3,2,2,1,0,0,2
376083,422_14_43,FINLAND,1314,7,shawn huff,12,1,2,50,1,2,50,0,0,0,0,0,0,0,0,0,0,5,2,0,1,2
376084,422_14_43,FINLAND,1836,8,gerald lee,10,0,3,0,0,3,0,0,0,0,0,0,0,0,1,1,1,1,1,0,0,0
376085,422_14_43,FINLAND,11129,9,sasu salin,33,5,11,45.5,0,1,0,5,10,50,0,0,0,0,2,2,0,2,0,0,1,15
376086,422_14_43,FINLAND,4932,10,tuukka kotti,33,4,7,57.1,4,7,57.1,0,0,0,1,2,50,2,1,3,2,4,3,2,0,9
376087,422_14_43,FINLAND,2802,11,petteri koponen,38,6,15,40,3,10,30,3,5,60,2,4,50,1,4,5,5,3,2,1,0,17
376088,422_14_43,FINLAND,8436,12,matti nuutinen,14,3,4,75,1,2,50,2,2,100,0,0,0,0,5,5,0,5,1,0,0,8
376089,422_14_43,FINLAND,4935,13,hanno mottola,6,0,0,0,0,0,0,0,0,0,2,2,100,0,0,0,0,0,1,0,1,2
376090,422_14_43,FINLAND,25455,14,antero lehto,0,0,0,0,0,0,0,0,0,0,0,0,0,0,0,0,0,0,0,0,0,0
376091,422_14_43,FINLAND,4937,15,teemu rannikko,10,0,3,0,0,0,0,0,3,0,1,2,50,0,0,0,1,3,6,0,0,1
376092,422_14_43,FINLAND,0,TOTALS,FINLAND,225,26,58,44.8,11,30,36.7,15,28,53.6,6,10,60,3,26,29,14,31,19,3,4,73
376093,422_14_44,SERBIA,5751,4,milos teodosic,26,5,8,62.5,2,2,100,3,6,50,1,2,50,0,2,2,5,1,0,1,0,14
376094,422_14_44,SERBIA,2100,5,marko simonovic,10,1,1,100,0,0,0,1,1,100,0,0,0,0,1,1,0,1,0,1,0,3
376095,422_14_44,SERBIA,25441,6,stefan jovic,16,0,0,0,0,0,0,0,0,0,2,2,100,0,1,1,0,4,1,1,0,2
376096,422_14_44,SERBIA,17361,7,bogdan bogdanovic,33,2,7,28.6,1,4,25,1,3,33.3,3,4,75,0,2,2,3,4,1,1,0,8
376097,422_14_44,SERBIA,15386,8,nemanja bjelica,27,2,7,28.6,2,6,33.3,0,1,0,4,4,100,3,2,5,1,2,1,0,0,8
376098,422_14_44,SERBIA,2654,9,stefan markovic,29,4,9,44.4,3,4,75,1,5,20,1,4,25,0,3,3,3,2,1,1,0,10
376099,422_14_44,SERBIA,19860,10,nikola kalinic,0,0,0,0,0,0,0,0,0,0,0,0,0,0,1,1,0,0,0,0,0,0
376100,422_14_44,SERBIA,15504,11,stefan bircevic,9,3,5,60,1,1,100,2,4,50,0,0,0,0,1,1,0,5,0,0,0,8
376101,422_14_44,SERBIA,93,12,nenad krstic,17,2,9,22.2,2,9,22.2,0,0,0,3,7,42.9,2,1,3,0,1,0,0,0,7
376102,422_14_44,SERBIA,2656,13,miroslav raduljica,25,4,8,50,4,8,50,0,0,0,3,6,50,1,4,5,1,4,4,0,0,11
376103,422_14_44,SERBIA,24202,14,rasko katic,0,0,0,0,0,0,0,0,0,0,0,0,0,0,0,0,0,0,0,0,0,0
376104,422_14_44,SERBIA,5756,15,vladimir stimac,8,1,3,33.3,1,3,33.3,0,0,0,0,0,0,1,0,1,0,0,0,0,0,2
376105,422_14_44,SERBIA,0,TOTALS,SERBIA,200,24,57,42.1,16,37,43.2,8,20,40,17,29,58.6,12,22,34,13,24,8,5,0,73
376106,422_14_44,BRAZIL,332,4,marcelo machado,0,0,0,0,0,0,0,0,0,0,0,0,0,0,0,0,0,0,0,0,0,0
376107,422_14_44,BRAZIL,14848,5,raulzinho neto,11,1,2,50,1,1,100,0,1,0,0,0,0,0,1,1,1,2,0,0,0,2
376108,422_14_44,BRAZIL,23752,6,rafael hettsheimeir,4,0,2,0,0,1,0,0,1,0,0,0,0,0,1,1,0,0,0,0,0,0
376109,422_14_44,BRAZIL,21034,7,larry taylor,15,1,4,25,1,3,33.3,0,1,0,0,0,0,1,1,2,0,3,0,1,0,2
376110,422_14_44,BRAZIL,4102,8,alex garcia,11,2,3,66.7,0,0,0,2,3,66.7,0,0,0,0,1,1,1,3,1,2,0,6
376111,422_14_44,BRAZIL,4098,9,marcelinho huertas,29,2,4,50,2,4,50,0,0,0,2,2,100,2,3,5,5,3,3,0,0,6
376112,422_14_44,BRAZIL,4100,10,leandrinho barbosa,28,6,16,37.5,4,10,40,2,6,33.3,2,4,50,0,1,1,0,1,0,0,1,16
376113,422_14_44,BRAZIL,4103,11,anderson varejao,27,2,4,50,2,3,66.7,0,1,0,0,0,0,1,8,9,0,4,1,1,0,4
376114,422_14_44,BRAZIL,4104,12,guilherme giovannoni,15,3,3,100,2,2,100,1,1,100,0,0,0,2,0,2,2,3,0,0,0,7
376115,422_14_44,BRAZIL,9844,13,nene hilario,14,2,3,66.7,2,3,66.7,0,0,0,3,5,60,1,1,2,1,4,0,0,2,7
376116,422_14_44,BRAZIL,19020,14,marquinhos vieira,25,7,13,53.8,1,4,25,6,9,66.7,1,4,25,0,5,5,0,1,3,0,0,21
376117,422_14_44,BRAZIL,4106,15,tiago splitter,21,5,8,62.5,5,8,62.5,0,0,0,0,0,0,4,3,7,6,3,1,0,0,10
376118,422_14_44,BRAZIL,0,TOTALS,BRAZIL,200,31,62,50,20,39,51.3,11,23,47.8,8,15,53.3,12,26,38,16,27,10,4,3,81
376119,422_14_45,LITHUANIA,1728,4,martynas pocius,23,3,8,37.5,3,7,42.9,0,1,0,0,0,0,0,3,3,1,3,0,0,1,6
376120,422_14_45,LITHUANIA,6225,5,adas juskevicius,21,7,8,87.5,1,1,100,6,7,85.7,0,0,0,0,3,3,2,2,0,0,0,20
376121,422_14_45,LITHUANIA,10639,6,mindaugas kuzminskas,15,2,8,25,1,6,16.7,1,2,50,0,0,0,1,0,1,1,0,1,1,0,5
376122,422_14_45,LITHUANIA,5073,7,darjus lavrinovic,7,0,2,0,0,1,0,0,1,0,0,0,0,1,1,2,0,2,1,0,0,0
376123,422_14_45,LITHUANIA,980,8,jonas maciulis,11,0,6,0,0,5,0,0,1,0,0,0,0,1,2,3,0,1,1,2,1,0
376124,422_14_45,LITHUANIA,3474,9,renaldas seibutis,14,2,4,50,1,3,33.3,1,1,100,0,0,0,1,1,2,1,0,0,2,0,5
376125,422_14_45,LITHUANIA,292,10,simas jasaitis,14,1,2,50,1,2,50,0,0,0,0,0,0,1,1,2,1,1,0,1,0,2
376126,422_14_45,LITHUANIA,8177,11,donatas motiejunas,29,9,13,69.2,9,10,90,0,3,0,0,0,0,1,6,7,5,2,2,0,0,18
376127,422_14_45,LITHUANIA,21,12,ksistof lavrinovic,9,0,3,0,0,2,0,0,1,0,0,0,0,0,2,2,1,2,1,0,0,0
376128,422_14_45,LITHUANIA,987,13,paulius jankunas,13,2,4,50,2,3,66.7,0,1,0,0,0,0,2,0,2,0,2,2,0,0,4
376129,422_14_45,LITHUANIA,10916,14,jonas valanciunas,22,6,7,85.7,6,7,85.7,0,0,0,0,0,0,3,5,8,0,1,2,0,1,12
376130,422_14_45,LITHUANIA,6221,15,sarunas vasiliauskas,23,3,7,42.9,2,4,50,1,3,33.3,0,0,0,0,1,1,3,1,1,0,0,7
376131,422_14_45,LITHUANIA,0,TOTALS,LITHUANIA,200,35,72,48.6,26,51,51,9,21,42.9,0,0,0,17,25,42,15,17,12,6,3,79
376132,422_14_45,KOREA,18641,4,taejong moon,31,6,8,75,3,4,75,3,4,75,0,0,0,0,0,0,1,2,4,0,0,15
376133,422_14_45,KOREA,18640,5,chan hee park,7,0,1,0,0,0,0,0,1,0,0,0,0,1,1,2,1,0,2,0,0,0
376134,422_14_45,KOREA,9631,6,donggeun yang,5,0,3,0,0,1,0,0,2,0,0,0,0,0,1,1,0,0,0,0,0,0
376135,422_14_45,KOREA,11667,7,taesul kim,27,1,4,25,1,3,33.3,0,1,0,2,2,100,0,2,2,4,0,2,0,0,4
376136,422_14_45,KOREA,14338,8,jonghyun lee,27,1,6,16.7,1,6,16.7,0,0,0,2,2,100,2,2,4,0,3,1,0,3,4
376137,422_14_45,KOREA,9054,9,sunhyung kim,16,0,1,0,0,1,0,0,0,0,0,0,0,0,2,2,3,0,2,0,0,0
376138,422_14_45,KOREA,18643,10,sungmin cho,23,1,6,16.7,0,0,0,1,6,16.7,0,0,0,0,1,1,3,2,3,0,0,3
376139,422_14_45,KOREA,9635,11,heejong yang,7,0,1,0,0,0,0,0,1,0,0,0,0,0,1,1,0,1,1,0,0,0
376140,422_14_45,KOREA,3914,12,joo sung kim,16,1,1,100,1,1,100,0,0,0,3,4,75,0,1,1,0,1,1,0,2,5
376141,422_14_45,KOREA,25437,13,ilyoung heo,5,0,1,0,0,0,0,0,1,0,0,0,0,0,0,0,0,0,0,0,0,0
376142,422_14_45,KOREA,11670,14,sekeun oh,17,3,6,50,3,5,60,0,1,0,0,0,0,0,4,4,0,1,0,1,0,6
376143,422_14_45,KOREA,18644,15,jongkyu kim,19,5,10,50,5,10,50,0,0,0,2,2,100,0,1,1,2,4,1,0,0,12
376144,422_14_45,KOREA,0,TOTALS,KOREA,200,18,48,37.5,14,31,45.2,4,17,23.5,9,10,90,4,18,22,14,14,18,1,5,49
376145,422_14_46,GREECE,8303,4,vaggelis mantzaris,2,0,0,0,0,0,0,0,0,0,0,0,0,0,1,1,0,0,0,0,0,0
376146,422_14_46,GREECE,5050,5,giannis bourousis,27,6,10,60,6,7,85.7,0,3,0,1,2,50,2,8,10,2,3,1,1,0,13
376147,422_14_46,GREECE,123,6,nikos zisis,28,1,7,14.3,0,3,0,1,4,25,0,0,0,1,0,1,10,2,0,1,0,3
376148,422_14_46,GREECE,1053,7,kostas vasileiadis,12,1,6,16.7,0,1,0,1,5,20,0,0,0,0,2,2,0,2,1,1,0,3
376149,422_14_46,GREECE,12472,8,nick calathes,26,4,8,50,3,4,75,1,4,25,0,2,0,1,2,3,4,2,0,2,1,9
376150,422_14_46,GREECE,11632,9,andreas glyniadakis,3,0,0,0,0,0,0,0,0,0,0,0,0,0,1,1,0,0,1,0,0,0
376151,422_14_46,GREECE,10606,10,kostas papanikolaou,28,7,10,70,7,8,87.5,0,2,0,0,0,0,0,2,2,0,3,1,3,1,14
376152,422_14_46,GREECE,8304,11,kostas sloukas,12,2,6,33.3,2,5,40,0,1,0,0,0,0,0,0,0,1,3,2,0,0,4
376153,422_14_46,GREECE,15374,12,kostas kaimakoglou,27,5,5,100,3,3,100,2,2,100,2,3,66.7,1,5,6,4,2,0,0,1,14
376154,422_14_46,GREECE,24314,13,giannis antetokounmpo,12,1,3,33.3,1,1,100,0,2,0,0,0,0,0,4,4,1,1,1,0,0,2
376155,422_14_46,GREECE,1061,14,ian vougioukas,10,3,3,100,3,3,100,0,0,0,0,0,0,1,1,2,0,3,2,0,1,6
376156,422_14_46,GREECE,1056,15,georgios printezis,13,3,8,37.5,3,8,37.5,0,0,0,2,2,100,0,2,2,1,1,0,0,0,8
376157,422_14_46,GREECE,0,TOTALS,GREECE,200,33,66,50,28,43,65.1,5,23,21.7,5,9,55.6,7,30,37,23,22,10,8,4,76
376158,422_14_46,CROATIA,1844,4,ante tomic,23,4,7,57.1,4,7,57.1,0,0,0,1,4,25,3,6,9,0,0,1,0,0,9
376159,422_14_46,CROATIA,1121,5,luksa andric,0,0,0,0,0,0,0,0,0,0,0,0,0,0,0,0,0,0,0,0,0,0
376160,422_14_46,CROATIA,25431,6,oliver lafayette,35,3,6,50,2,4,50,1,2,50,1,2,50,0,2,2,3,2,4,2,0,8
376161,422_14_46,CROATIA,6280,7,bojan bogdanovic,32,6,12,50,3,4,75,3,8,37.5,5,6,83.3,0,4,4,1,2,3,1,1,20
376162,422_14_46,CROATIA,15894,8,dario saric,34,4,12,33.3,3,10,30,1,2,50,1,1,100,0,5,5,2,2,3,3,0,10
376163,422_14_46,CROATIA,1846,9,damjan rudez,8,2,2,100,0,0,0,2,2,100,0,0,0,0,0,0,0,1,0,0,0,6
376164,422_14_46,CROATIA,4585,10,roko ukic,20,2,9,22.2,1,5,20,1,4,25,1,2,50,1,1,2,1,1,0,0,0,6
376165,422_14_46,CROATIA,1249,11,krunoslav simon,25,3,8,37.5,3,6,50,0,2,0,0,2,0,1,2,3,1,4,1,0,2,6
376166,422_14_46,CROATIA,1250,12,damir markota,13,0,1,0,0,1,0,0,0,0,0,0,0,1,3,4,1,2,0,0,0,0
376167,422_14_46,CROATIA,18415,13,mario hezonja,0,0,0,0,0,0,0,0,0,0,0,0,0,0,0,0,0,0,0,0,0,0
376168,422_14_46,CROATIA,16607,14,luka zoric,10,0,4,0,0,4,0,0,0,0,0,0,0,0,3,3,0,2,1,0,1,0
376169,422_14_46,CROATIA,13759,15,luka babic,0,0,0,0,0,0,0,0,0,0,0,0,0,0,0,0,0,0,0,0,0,0
376170,422_14_46,CROATIA,0,TOTALS,CROATIA,200,24,61,39.3,16,41,39,8,20,40,9,17,52.9,7,26,33,9,16,13,6,4,65
376171,422_14_47,DOMINICAN REPUBLIC,19011,4,edgar sosa,21,4,9,44.4,3,7,42.9,1,2,50,0,0,0,0,1,1,4,1,2,0,0,9
376172,422_14_47,DOMINICAN REPUBLIC,461,5,manuel fortuna,18,2,8,25,0,6,0,2,2,100,0,0,0,1,2,3,2,3,6,2,0,6
376173,422_14_47,DOMINICAN REPUBLIC,14632,6,juan coronado,19,0,5,0,0,2,0,0,3,0,0,0,0,0,2,2,3,2,4,1,0,0
376174,422_14_47,DOMINICAN REPUBLIC,25436,7,victor liz,24,6,11,54.5,4,7,57.1,2,4,50,1,3,33.3,0,3,3,1,1,2,0,0,15
376175,422_14_47,DOMINICAN REPUBLIC,23761,8,edward santana,17,3,8,37.5,3,8,37.5,0,0,0,5,5,100,1,1,2,1,2,1,1,0,11
376176,422_14_47,DOMINICAN REPUBLIC,4116,9,francisco garcia,0,0,0,0,0,0,0,0,0,0,0,0,0,0,0,0,0,0,0,0,0,0
376177,422_14_47,DOMINICAN REPUBLIC,23762,10,james feldeine,20,2,7,28.6,1,5,20,1,2,50,0,0,0,0,6,6,4,2,0,0,0,5
376178,422_14_47,DOMINICAN REPUBLIC,19070,11,eloy vargas,13,2,6,33.3,2,6,33.3,0,0,0,0,0,0,2,2,4,0,1,2,0,1,4
376179,422_14_47,DOMINICAN REPUBLIC,19016,12,orlando sanchez,18,2,3,66.7,2,3,66.7,0,0,0,0,0,0,1,1,2,0,4,2,0,0,4
376180,422_14_47,DOMINICAN REPUBLIC,9947,13,eulis baez,13,1,3,33.3,1,2,50,0,1,0,0,0,0,0,1,1,1,4,1,0,0,2
376181,422_14_47,DOMINICAN REPUBLIC,16889,14,ronald ramon,16,2,5,40,1,2,50,1,3,33.3,0,0,0,0,0,0,0,2,2,1,0,5
376182,422_14_47,DOMINICAN REPUBLIC,430,15,jack martinez,21,4,6,66.7,4,5,80,0,1,0,2,2,100,1,4,5,0,1,4,0,0,10
376183,422_14_47,DOMINICAN REPUBLIC,0,TOTALS,DOMINICAN REPUBLIC,200,28,71,39.4,21,53,39.6,7,18,38.9,8,10,80,12,28,40,16,23,26,5,1,71
376184,422_14_47,USA,9010,4,stephen curry,21,3,7,42.9,1,3,33.3,2,4,50,0,0,0,0,6,6,7,2,1,0,0,8
376185,422_14_47,USA,13751,5,klay thompson,22,3,7,42.9,1,2,50,2,5,40,0,0,0,0,1,1,3,2,1,3,0,8
376186,422_14_47,USA,16600,6,derrick rose,13,2,5,40,2,3,66.7,0,2,0,2,2,100,0,1,1,3,0,1,1,0,6
376187,422_14_47,USA,25451,7,kenneth faried,17,8,11,72.7,8,11,72.7,0,0,0,0,0,0,3,3,6,0,3,1,0,0,16
376188,422_14_47,USA,3452,8,rudy gay,17,3,5,60,3,4,75,0,1,0,3,5,60,1,3,4,5,2,1,2,2,9
376189,422_14_47,USA,25452,9,demar derozan,18,5,8,62.5,4,5,80,1,3,33.3,0,0,0,0,2,2,2,1,5,3,0,11
376190,422_14_47,USA,16977,10,kyrie irving,27,3,7,42.9,3,5,60,0,2,0,0,0,0,0,2,2,2,3,2,0,0,6
376191,422_14_47,USA,12194,11,mason plumlee,7,2,3,66.7,2,3,66.7,0,0,0,1,2,50,0,1,1,1,1,1,0,0,5
376192,422_14_47,USA,25453,12,demarcus cousins,12,5,5,100,5,5,100,0,0,0,3,5,60,3,2,5,2,2,1,6,0,13
376193,422_14_47,USA,21035,13,james harden,18,3,6,50,2,2,100,1,4,25,3,5,60,0,3,3,3,2,1,2,1,10
376194,422_14_47,USA,21036,14,anthony davis,20,5,10,50,5,10,50,0,0,0,0,0,0,3,4,7,0,0,1,0,5,10
376195,422_14_47,USA,14750,15,andre drummond,8,2,4,50,2,4,50,0,0,0,0,0,0,0,3,3,0,0,0,0,0,4
376196,422_14_47,USA,0,TOTALS,USA,200,44,78,56.4,38,57,66.7,6,21,28.6,12,19,63.2,11,32,43,28,18,16,17,8,106
376197,422_14_48,SPAIN,61,4,pau gasol,24,5,9,55.6,5,8,62.5,0,1,0,5,8,62.5,1,3,4,2,1,2,1,2,15
376198,422_14_48,SPAIN,70,5,rudy fernandez,25,2,5,40,0,1,0,2,4,50,2,2,100,2,3,5,2,2,0,2,0,8
376199,422_14_48,SPAIN,1877,6,sergio rodriguez,7,1,2,50,1,2,50,0,0,0,0,0,0,0,1,1,0,1,1,1,0,2
376200,422_14_48,SPAIN,64,7,juan c. navarro,25,4,10,40,2,5,40,2,5,40,4,4,100,0,2,2,3,1,1,0,0,14
376201,422_14_48,SPAIN,65,8,jose calderon,21,1,8,12.5,1,1,100,0,7,0,0,0,0,0,2,2,1,2,0,0,0,2
376202,422_14_48,SPAIN,66,9,felipe reyes,4,1,2,50,1,2,50,0,0,0,0,0,0,0,2,2,0,1,0,0,0,2
376203,422_14_48,SPAIN,2628,10,victor claver,3,1,1,100,1,1,100,0,0,0,0,0,0,0,0,0,0,0,1,0,0,2
376204,422_14_48,SPAIN,6259,11,ricky rubio,17,2,4,50,2,3,66.7,0,1,0,0,0,0,0,4,4,5,1,1,3,0,4
376205,422_14_48,SPAIN,1871,12,sergio llull,21,4,6,66.7,3,3,100,1,3,33.3,1,2,50,0,1,1,4,2,0,0,0,10
376206,422_14_48,SPAIN,1108,13,marc gasol,28,6,9,66.7,5,7,71.4,1,2,50,4,4,100,0,6,6,2,3,1,3,1,17
376207,422_14_48,SPAIN,7001,14,serge ibaka,22,5,7,71.4,5,7,71.4,0,0,0,0,0,0,4,4,8,0,1,0,0,2,10
376208,422_14_48,SPAIN,19988,15,alex abrines,3,0,0,0,0,0,0,0,0,0,2,2,100,0,0,0,0,1,0,1,0,2
376209,422_14_48,SPAIN,0,TOTALS,SPAIN,200,32,63,50.8,26,40,65,6,23,26.1,18,22,81.8,7,30,37,19,16,8,11,5,88
376210,422_14_48,FRANCE,12495,4,thomas heurtel,23,3,8,37.5,3,5,60,0,3,0,0,0,0,2,4,6,2,0,2,2,0,6
376211,422_14_48,FRANCE,2588,5,nicolas batum,29,5,15,33.3,4,10,40,1,5,20,0,0,0,1,1,2,0,0,0,1,0,11
376212,422_14_48,FRANCE,2589,6,antoine diot,20,4,8,50,3,4,75,1,4,25,2,2,100,1,2,3,2,2,4,0,0,11
376213,422_14_48,FRANCE,11076,7,joffrey lauvergne,19,3,9,33.3,3,7,42.9,0,2,0,2,3,66.7,2,3,5,1,3,0,1,0,8
376214,422_14_48,FRANCE,1864,8,charles kahudi,4,0,3,0,0,2,0,0,1,0,0,0,0,1,0,1,0,1,1,0,0,0
376215,422_14_48,FRANCE,6249,9,edwin jackson,10,2,4,50,1,3,33.3,1,1,100,0,0,0,0,1,1,0,2,1,0,0,5
376216,422_14_48,FRANCE,12971,10,evan fournier,12,4,7,57.1,3,4,75,1,3,33.3,0,2,0,0,0,0,0,2,0,0,0,9
376217,422_14_48,FRANCE,4663,11,florent pietrus,22,1,2,50,1,1,100,0,1,0,1,1,100,3,5,8,2,4,0,0,0,3
376218,422_14_48,FRANCE,17374,12,rudy gobert,11,2,3,66.7,2,3,66.7,0,0,0,0,0,0,0,2,2,0,3,1,0,0,4
376219,422_14_48,FRANCE,4665,13,boris diaw,23,1,6,16.7,0,2,0,1,4,25,0,0,0,0,2,2,3,2,3,0,0,3
376220,422_14_48,FRANCE,7987,14,kim tillie,3,0,1,0,0,1,0,0,0,0,0,0,0,1,0,1,0,1,0,0,0,0
376221,422_14_48,FRANCE,5044,15,mickael gelabale,24,2,3,66.7,2,2,100,0,1,0,0,0,0,0,1,1,0,2,1,0,0,4
376222,422_14_48,FRANCE,0,TOTALS,FRANCE,200,27,69,39.1,22,44,50,5,25,20,5,8,62.5,13,23,36,10,22,15,4,0,64
376223,422_14_49,AUSTRALIA,9039,4,chris goulding,30,8,17,47.1,2,5,40,6,12,50,0,0,0,0,6,6,0,4,5,1,0,22
376224,422_14_49,AUSTRALIA,13813,5,ryan broekhoff,12,1,2,50,0,1,0,1,1,100,0,0,0,0,0,0,1,1,0,0,0,3
376225,422_14_49,AUSTRALIA,3458,6,adam gibson,23,3,3,100,0,0,0,3,3,100,0,0,0,1,1,2,4,1,0,0,0,9
376226,422_14_49,AUSTRALIA,11635,7,joe ingles,0,0,0,0,0,0,0,0,0,0,0,0,0,0,0,0,0,0,0,0,0,0
376227,422_14_49,AUSTRALIA,3466,8,brad newley,20,0,2,0,0,1,0,0,1,0,1,2,50,0,3,3,3,4,2,0,1,1
376228,422_14_49,AUSTRALIA,13811,9,matthew dellavedova,4,1,2,50,1,1,100,0,1,0,0,0,0,0,0,0,0,0,0,0,0,2
376229,422_14_49,AUSTRALIA,25376,10,cameron bairstow,24,5,10,50,5,10,50,0,0,0,1,2,50,4,1,5,2,1,3,0,0,11
376230,422_14_49,AUSTRALIA,20984,11,dante exum,31,3,6,50,2,4,50,1,2,50,5,5,100,1,2,3,6,2,4,0,0,12
376231,422_14_49,AUSTRALIA,16519,12,aron baynes,0,0,0,0,0,0,0,0,0,0,0,0,0,0,0,0,0,0,0,0,0,0
376232,422_14_49,AUSTRALIA,142,13,david andersen,4,0,2,0,0,2,0,0,0,0,0,0,0,0,0,0,0,0,0,1,0,0
376233,422_14_49,AUSTRALIA,13814,14,brock motum,22,5,10,50,2,5,40,3,5,60,0,0,0,2,2,4,2,4,2,0,0,13
376234,422_14_49,AUSTRALIA,3457,15,nate jawai,30,5,7,71.4,5,7,71.4,0,0,0,0,0,0,1,4,5,3,2,2,1,0,10
376235,422_14_49,AUSTRALIA,0,TOTALS,AUSTRALIA,200,31,61,50.8,17,36,47.2,14,25,56,7,9,77.8,9,23,32,21,19,18,3,1,83
376236,422_14_49,ANGOLA,1,4,olimpio cipriano,0,0,0,0,0,0,0,0,0,0,0,0,0,0,0,0,0,0,0,0,0,0
376237,422_14_49,ANGOLA,3574,5,armando costa,38,3,7,42.9,1,3,33.3,2,4,50,0,2,0,0,5,5,6,4,2,3,0,8
376238,422_14_49,ANGOLA,16597,6,roberto fortes,37,5,12,41.7,3,6,50,2,6,33.3,0,0,0,2,2,4,4,3,1,4,1,12
376239,422_14_49,ANGOLA,13818,7,edson ndoniema,15,2,6,33.3,0,2,0,2,4,50,0,0,0,2,1,3,1,4,1,2,0,6
376240,422_14_49,ANGOLA,11834,8,gildo santos,0,0,0,0,0,0,0,0,0,0,0,0,0,0,0,0,0,0,0,0,0,0
376241,422_14_49,ANGOLA,7039,9,valdelicio joaquim,7,1,1,100,1,1,100,0,0,0,0,0,0,0,0,0,0,1,1,0,0,2
376242,422_14_49,ANGOLA,7,10,joaquim gomes,0,0,0,0,0,0,0,0,0,0,0,0,0,0,0,0,0,0,0,0,0,0
376243,422_14_49,ANGOLA,23104,11,reggie moore,15,0,2,0,0,1,0,0,1,0,0,2,0,0,2,2,0,0,0,0,0,0
376244,422_14_49,ANGOLA,11831,12,yanick moreira,32,17,24,70.8,17,24,70.8,0,0,0,4,7,57.1,10,5,15,1,0,1,1,1,38
376245,422_14_49,ANGOLA,13822,13,islando manuel,4,0,0,0,0,0,0,0,0,0,0,0,0,0,0,0,0,0,0,0,0,0
376246,422_14_49,ANGOLA,21052,14,milton barros,27,3,14,21.4,2,6,33.3,1,8,12.5,2,2,100,0,0,0,2,1,1,1,0,9
376247,422_14_49,ANGOLA,12,15,eduardo mingas,27,6,11,54.5,6,10,60,0,1,0,4,6,66.7,6,3,9,2,2,0,3,0,16
376248,422_14_49,ANGOLA,0,TOTALS,ANGOLA,200,37,77,48.1,30,53,56.6,7,24,29.2,10,19,52.6,21,21,42,16,15,9,14,2,91
376249,422_14_50,SENEGAL,11764,4,thierno niang,0,0,0,0,0,0,0,0,0,0,0,0,0,0,0,0,0,0,0,0,0,0
376250,422_14_50,SENEGAL,18541,5,xane dalmeida,41,3,8,37.5,2,3,66.7,1,5,20,2,2,100,2,4,6,14,1,3,2,0,9
376251,422_14_50,SENEGAL,23085,6,ibrahima thomas,5,1,1,100,1,1,100,0,0,0,0,0,0,0,0,0,0,1,2,0,0,2
376252,422_14_50,SENEGAL,18542,7,mamadou ndoye,4,0,0,0,0,0,0,0,0,0,0,0,0,0,1,1,0,2,0,0,0,0
376253,422_14_50,SENEGAL,18543,8,mohamet diop,5,0,2,0,0,0,0,0,2,0,2,2,100,0,0,0,0,1,0,0,0,2
376254,422_14_50,SENEGAL,3592,9,maleye ndoye,40,5,10,50,2,4,50,3,6,50,0,0,0,2,1,3,1,4,0,2,0,13
376255,422_14_50,SENEGAL,25448,10,djibril thiam,0,0,0,0,0,0,0,0,0,0,0,0,0,0,0,0,0,0,0,0,0,0
376256,422_14_50,SENEGAL,9148,11,mouhammad faye,41,8,23,34.8,5,11,45.5,3,12,25,1,2,50,2,3,5,0,4,2,2,1,20
376257,422_14_50,SENEGAL,25449,12,maurice ndour,22,6,14,42.9,5,7,71.4,1,7,14.3,0,0,0,0,4,4,1,3,1,1,0,13
376258,422_14_50,SENEGAL,23089,13,hamady ndiaye,19,2,3,66.7,2,3,66.7,0,0,0,1,2,50,0,4,4,0,2,1,0,1,5
376259,422_14_50,SENEGAL,25450,14,gorgui dieng,44,3,9,33.3,3,7,42.9,0,2,0,7,9,77.8,4,10,14,5,5,5,4,3,13
376260,422_14_50,SENEGAL,23091,15,abdou badji,5,1,1,100,1,1,100,0,0,0,0,0,0,0,0,0,0,0,1,0,0,2
376261,422_14_50,SENEGAL,0,TOTALS,SENEGAL,225,29,71,40.8,21,37,56.8,8,34,23.5,13,17,76.5,10,28,38,21,23,16,11,5,79
376262,422_14_50,PHILIPPINES,9696,4,jim alapag,31,3,8,37.5,0,0,0,3,8,37.5,9,11,81.8,0,4,4,4,1,2,1,0,18
376263,422_14_50,PHILIPPINES,23359,5,lewis tenorio,23,2,7,28.6,1,5,20,1,2,50,0,0,0,0,2,2,1,2,2,0,0,5
376264,422_14_50,PHILIPPINES,25432,6,jeff chan,14,2,3,66.7,2,2,100,0,1,0,0,0,0,0,2,2,0,0,3,0,0,4
376265,422_14_50,PHILIPPINES,23361,7,jayson william,0,0,0,0,0,0,0,0,0,0,0,0,0,0,0,0,0,0,0,0,0,0
376266,422_14_50,PHILIPPINES,23362,8,gary david,1,0,1,0,0,1,0,0,0,0,0,0,0,0,0,0,0,0,0,0,0,0
376267,422_14_50,PHILIPPINES,18657,9,ranidel de ocampo,13,0,2,0,0,1,0,0,1,0,2,2,100,0,0,0,1,0,1,1,0,2
376268,422_14_50,PHILIPPINES,9700,10,gabe norwood,35,2,8,25,1,6,16.7,1,2,50,2,4,50,2,3,5,0,3,1,3,0,7
376269,422_14_50,PHILIPPINES,25433,11,andray blatche,34,7,19,36.8,6,12,50,1,7,14.3,3,4,75,2,12,14,1,5,5,1,0,18
376270,422_14_50,PHILIPPINES,23364,12,june mar fajardo,32,5,10,50,5,10,50,0,0,0,5,7,71.4,4,5,9,2,2,1,2,0,15
376271,422_14_50,PHILIPPINES,25434,13,paul dalistan,22,2,6,33.3,0,0,0,2,6,33.3,0,0,0,1,1,2,2,1,2,0,0,6
376272,422_14_50,PHILIPPINES,14184,14,japeth aguilar,13,2,4,50,2,4,50,0,0,0,2,2,100,3,0,3,0,1,0,0,0,6
376273,422_14_50,PHILIPPINES,23365,15,marc pingris,8,0,0,0,0,0,0,0,0,0,0,0,0,0,0,0,0,2,0,1,0,0
376274,422_14_50,PHILIPPINES,0,TOTALS,PHILIPPINES,225,25,68,36.8,17,41,41.5,8,27,29.6,23,30,76.7,15,30,45,11,17,18,9,0,81
376275,422_14_51,FINLAND,1834,4,mikko koivisto,13,1,4,25,1,2,50,0,2,0,0,0,0,0,2,2,0,2,0,1,0,2
376276,422_14_51,FINLAND,25454,5,erik murphy,23,1,2,50,1,1,100,0,1,0,1,2,50,1,4,5,0,3,2,2,1,3
376277,422_14_51,FINLAND,4930,6,kimmo muurinen,9,1,2,50,1,2,50,0,0,0,0,0,0,1,0,1,0,2,0,0,1,2
376278,422_14_51,FINLAND,1314,7,shawn huff,27,2,2,100,0,0,0,2,2,100,4,4,100,0,2,2,0,0,0,2,0,10
376279,422_14_51,FINLAND,1836,8,gerald lee,23,7,10,70,7,10,70,0,0,0,3,4,75,2,3,5,1,2,2,0,1,17
376280,422_14_51,FINLAND,11129,9,sasu salin,24,2,7,28.6,2,3,66.7,0,4,0,2,2,100,1,4,5,1,1,2,1,0,6
376281,422_14_51,FINLAND,4932,10,tuukka kotti,25,3,9,33.3,3,9,33.3,0,0,0,0,0,0,0,3,3,2,3,1,1,0,6
376282,422_14_51,FINLAND,2802,11,petteri koponen,27,4,13,30.8,3,9,33.3,1,4,25,4,4,100,0,2,2,2,2,1,0,0,13
376283,422_14_51,FINLAND,8436,12,matti nuutinen,8,0,0,0,0,0,0,0,0,0,0,0,0,0,0,0,0,0,0,1,0,0
376284,422_14_51,FINLAND,4935,13,hanno mottola,0,0,0,0,0,0,0,0,0,0,0,0,0,0,0,0,0,0,0,0,0,0
376285,422_14_51,FINLAND,25455,14,antero lehto,6,0,0,0,0,0,0,0,0,0,0,0,0,0,0,0,0,1,0,0,0,0
376286,422_14_51,FINLAND,4937,15,teemu rannikko,15,1,6,16.7,1,4,25,0,2,0,4,4,100,1,1,2,7,4,1,0,0,6
376287,422_14_51,FINLAND,0,TOTALS,FINLAND,200,22,55,40,19,40,47.5,3,15,20,18,20,90,6,22,28,13,20,9,8,3,65
376288,422_14_51,NEW ZEALAND,6772,4,lindsay tait,15,3,5,60,3,3,100,0,2,0,0,0,0,0,0,0,5,3,1,0,0,6
376289,422_14_51,NEW ZEALAND,21055,5,everard bartlett,11,2,3,66.7,1,1,100,1,2,50,0,0,0,0,1,1,0,1,0,0,0,5
376290,422_14_51,NEW ZEALAND,39,6,kirk penney,26,4,17,23.5,1,7,14.3,3,10,30,0,0,0,1,2,3,3,0,3,0,1,11
376291,422_14_51,NEW ZEALAND,6773,7,mika vukona,24,2,4,50,2,4,50,0,0,0,1,2,50,1,11,12,3,3,4,0,0,5
376292,422_14_51,NEW ZEALAND,16521,8,jarrod kenny,9,0,0,0,0,0,0,0,0,0,0,0,0,0,1,1,0,1,0,0,0,0
376293,422_14_51,NEW ZEALAND,11656,9,corey webster,18,2,8,25,1,6,16.7,1,2,50,3,5,60,1,0,1,1,1,2,1,0,8
376294,422_14_51,NEW ZEALAND,16523,10,thomas abercrombie,24,3,7,42.9,2,6,33.3,1,1,100,0,0,0,1,1,2,1,0,2,0,0,7
376295,422_14_51,NEW ZEALAND,16524,11,bj anthony,0,0,0,0,0,0,0,0,0,0,0,0,0,0,0,0,0,0,0,0,0,0
376296,422_14_51,NEW ZEALAND,25442,12,isaac fotu,26,7,9,77.8,6,8,75,1,1,100,3,4,75,4,4,8,0,1,0,0,0,18
376297,422_14_51,NEW ZEALAND,6846,13,casey frank,14,0,1,0,0,1,0,0,0,0,0,0,0,0,1,1,2,2,0,0,0,0
376298,422_14_51,NEW ZEALAND,13832,14,rob loe,16,1,2,50,1,2,50,0,0,0,0,0,0,2,2,4,0,2,1,0,0,2
376299,422_14_51,NEW ZEALAND,21056,15,tai webster,17,2,4,50,2,3,66.7,0,1,0,1,1,100,0,0,0,0,5,1,0,0,5
376300,422_14_51,NEW ZEALAND,0,TOTALS,NEW ZEALAND,200,26,60,43.3,19,41,46.3,7,19,36.8,8,12,66.7,12,26,38,15,19,14,1,1,67
376301,422_14_52,BRAZIL,332,4,marcelo machado,20,6,10,60,3,3,100,3,7,42.9,1,2,50,0,3,3,5,2,0,1,0,16
376302,422_14_52,BRAZIL,14848,5,raulzinho neto,23,7,7,100,7,7,100,0,0,0,0,1,0,0,1,1,10,1,3,1,0,14
376303,422_14_52,BRAZIL,23752,6,rafael hettsheimeir,15,3,3,100,2,2,100,1,1,100,0,0,0,0,4,4,1,1,0,1,1,7
376304,422_14_52,BRAZIL,21034,7,larry taylor,12,2,4,50,2,3,66.7,0,1,0,0,0,0,0,2,2,2,1,1,1,0,4
376305,422_14_52,BRAZIL,4102,8,alex garcia,18,6,7,85.7,4,4,100,2,3,66.7,1,1,100,2,1,3,3,3,2,1,1,15
376306,422_14_52,BRAZIL,4098,9,marcelinho huertas,14,5,5,100,4,4,100,1,1,100,1,1,100,0,1,1,2,0,0,1,0,12
376307,422_14_52,BRAZIL,4100,10,leandrinho barbosa,23,8,9,88.9,5,6,83.3,3,3,100,3,4,75,2,0,2,5,0,1,4,0,22
376308,422_14_52,BRAZIL,4103,11,anderson varejao,19,6,8,75,6,8,75,0,0,0,3,5,60,3,7,10,2,2,1,0,0,15
376309,422_14_52,BRAZIL,4104,12,guilherme giovannoni,12,1,2,50,1,1,100,0,1,0,2,2,100,0,4,4,0,2,0,0,0,4
376310,422_14_52,BRAZIL,9844,13,nene hilario,17,1,3,33.3,1,3,33.3,0,0,0,5,6,83.3,1,1,2,2,1,0,1,0,7
376311,422_14_52,BRAZIL,19020,14,marquinhos vieira,10,1,4,25,1,1,100,0,3,0,2,2,100,0,2,2,1,0,0,0,0,4
376312,422_14_52,BRAZIL,4106,15,tiago splitter,17,4,5,80,4,5,80,0,0,0,0,2,0,1,8,9,2,0,2,0,1,8
376313,422_14_52,BRAZIL,0,TOTALS,BRAZIL,200,50,67,74.6,40,47,85.1,10,20,50,18,26,69.2,9,36,45,35,13,11,11,3,128
376314,422_14_52,EGYPT,18379,4,seif samir,3,1,3,33.3,1,2,50,0,1,0,0,0,0,0,1,1,0,2,0,1,0,2
376315,422_14_52,EGYPT,25438,5,amr gendy,24,6,12,50,4,6,66.7,2,6,33.3,0,4,0,3,2,5,1,0,0,0,0,14
376316,422_14_52,EGYPT,13947,6,haytham kamal,28,3,7,42.9,2,4,50,1,3,33.3,0,0,0,1,2,3,1,3,2,0,0,7
376317,422_14_52,EGYPT,9153,7,wael badr,2,0,0,0,0,0,0,0,0,0,0,0,0,0,0,0,0,0,0,0,0,0
376318,422_14_52,EGYPT,9156,8,moamen abouelanin,17,1,3,33.3,0,0,0,1,3,33.3,0,0,0,0,0,0,1,4,2,1,0,3
376319,422_14_52,EGYPT,9154,9,ibrahim elgammal,32,7,19,36.8,5,11,45.5,2,8,25,0,0,0,1,0,1,5,3,4,1,0,16
376320,422_14_52,EGYPT,18516,10,mouhanad elsabagh,19,2,6,33.3,2,5,40,0,1,0,0,0,0,1,0,1,2,0,2,0,0,4
376321,422_14_52,EGYPT,25439,11,sherif genedy,17,1,6,16.7,1,2,50,0,4,0,0,0,0,1,1,2,0,1,2,3,0,2
376322,422_14_52,EGYPT,16644,12,youssef shousha,22,2,4,50,1,2,50,1,2,50,0,0,0,0,1,1,0,0,4,1,1,5
376323,422_14_52,EGYPT,25440,13,moustafa elmekawi,10,1,4,25,0,2,0,1,2,50,0,0,0,2,3,5,0,4,0,0,0,3
376324,422_14_52,EGYPT,18519,14,ramy ibrahim,20,3,7,42.9,0,4,0,3,3,100,0,0,0,1,0,1,0,4,0,1,0,9
376325,422_14_52,EGYPT,9161,15,ashraf rabie,6,0,2,0,0,1,0,0,1,0,0,0,0,1,0,1,1,2,0,0,0,0
376326,422_14_52,EGYPT,0,TOTALS,EGYPT,200,27,73,37,16,39,41,11,34,32.4,0,4,0,13,12,25,11,23,18,8,1,65
376327,422_14_53,KOREA,18641,4,taejong moon,27,4,9,44.4,1,2,50,3,7,42.9,5,5,100,0,1,1,1,1,2,1,0,16
376328,422_14_53,KOREA,18640,5,chan hee park,5,0,1,0,0,1,0,0,0,0,1,2,50,0,0,0,2,0,0,0,0,1
376329,422_14_53,KOREA,9631,6,donggeun yang,27,4,9,44.4,2,2,100,2,7,28.6,0,0,0,0,1,1,4,1,1,2,1,10
376330,422_14_53,KOREA,11667,7,taesul kim,4,0,1,0,0,0,0,0,1,0,0,0,0,0,0,0,0,2,0,0,0,0
376331,422_14_53,KOREA,14338,8,jonghyun lee,25,4,7,57.1,4,7,57.1,0,0,0,2,2,100,1,2,3,1,1,1,1,1,10
376332,422_14_53,KOREA,9054,9,sunhyung kim,9,0,1,0,0,1,0,0,0,0,2,2,100,0,2,2,2,0,2,0,0,2
376333,422_14_53,KOREA,18643,10,sungmin cho,20,0,4,0,0,1,0,0,3,0,0,0,0,0,1,1,4,1,2,0,0,0
376334,422_14_53,KOREA,9635,11,heejong yang,23,0,0,0,0,0,0,0,0,0,0,0,0,2,3,5,0,2,0,0,0,0
376335,422_14_53,KOREA,3914,12,joo sung kim,11,1,3,33.3,1,3,33.3,0,0,0,1,4,25,0,0,0,0,0,0,0,0,3
376336,422_14_53,KOREA,25437,13,ilyoung heo,5,1,1,100,0,0,0,1,1,100,3,3,100,0,1,1,0,1,1,0,0,6
376337,422_14_53,KOREA,11670,14,sekeun oh,21,6,8,75,6,8,75,0,0,0,1,1,100,0,2,2,2,2,2,1,1,13
376338,422_14_53,KOREA,18644,15,jongkyu kim,23,3,5,60,3,5,60,0,0,0,4,4,100,1,1,2,1,3,2,1,3,10
376339,422_14_53,KOREA,0,TOTALS,KOREA,200,23,49,46.9,17,30,56.7,6,19,31.6,19,23,82.6,4,15,19,17,14,13,6,6,71
376340,422_14_53,MEXICO,16880,4,paul stoll,5,1,1,100,1,1,100,0,0,0,0,0,0,0,0,0,2,1,1,0,0,2
376341,422_14_53,MEXICO,23812,5,marco ramos,28,5,9,55.6,2,3,66.7,3,6,50,1,2,50,4,2,6,1,4,0,0,0,14
376342,422_14_53,MEXICO,23755,6,roman martinez,14,3,5,60,0,0,0,3,5,60,0,0,0,1,2,3,1,1,0,0,0,9
376343,422_14_53,MEXICO,23756,7,jorge gutierrez,26,5,11,45.5,5,11,45.5,0,0,0,1,2,50,1,2,3,4,1,1,1,0,11
376344,422_14_53,MEXICO,9836,8,gustavo ayon,0,0,0,0,0,0,0,0,0,0,0,0,0,0,0,0,0,0,0,0,0,0
376345,422_14_53,MEXICO,23813,9,francisco cruz,19,6,10,60,5,9,55.6,1,1,100,0,0,0,2,0,2,3,0,3,0,0,13
376346,422_14_53,MEXICO,25444,10,israel gutierrez,0,0,0,0,0,0,0,0,0,0,0,0,0,0,1,1,0,0,0,0,0,0
376347,422_14_53,MEXICO,25445,11,david meza,9,0,3,0,0,3,0,0,0,0,0,0,0,1,0,1,1,2,2,0,0,0
376348,422_14_53,MEXICO,9835,12,hector hernandez,37,7,13,53.8,5,8,62.5,2,5,40,0,0,0,2,9,11,0,1,0,1,0,16
376349,422_14_53,MEXICO,21215,13,orlando mendez,22,3,9,33.3,2,4,50,1,5,20,0,0,0,2,0,2,4,3,4,1,0,7
376350,422_14_53,MEXICO,25446,14,adrian zamora,23,5,7,71.4,5,7,71.4,0,0,0,1,1,100,4,2,6,0,3,1,0,1,11
376351,422_14_53,MEXICO,25447,15,adam parada,17,2,4,50,2,4,50,0,0,0,0,0,0,2,4,6,0,3,2,0,0,4
376352,422_14_53,MEXICO,0,TOTALS,MEXICO,200,37,72,51.4,27,50,54,10,22,45.5,3,5,60,20,24,44,16,19,14,3,1,87
376353,422_14_54,UKRAINE,5790,4,maksym pustozvonov,11,0,1,0,0,1,0,0,0,0,0,0,0,0,4,4,0,2,1,1,0,0
376354,422_14_54,UKRAINE,25435,5,"eugene ""pooh"" jeter",28,5,16,31.2,3,11,27.3,2,5,40,1,2,50,2,2,4,2,4,2,1,0,13
376355,422_14_54,UKRAINE,12946,6,olexandr mishula,25,2,10,20,1,3,33.3,1,7,14.3,1,2,50,1,0,1,4,2,3,0,0,6
376356,422_14_54,UKRAINE,22292,7,sviatoslav mykhailiuk,11,1,4,25,0,2,0,1,2,50,0,0,0,1,1,2,0,0,2,0,0,3
376357,422_14_54,UKRAINE,7931,8,sergii gladyr,1,0,0,0,0,0,0,0,0,0,0,0,0,0,0,0,0,0,0,0,0,0
376358,422_14_54,UKRAINE,10926,9,oleksandr lypovyy,27,3,6,50,3,3,100,0,3,0,0,0,0,2,0,2,1,3,6,2,1,6
376359,422_14_54,UKRAINE,8223,10,kyryl natyazhko,12,2,3,66.7,2,3,66.7,0,0,0,2,2,100,0,2,2,0,2,1,0,0,6
376360,422_14_54,UKRAINE,1026,11,dmytro zabirchenko,17,2,3,66.7,0,1,0,2,2,100,1,2,50,0,2,2,1,3,1,0,0,7
376361,422_14_54,UKRAINE,5791,12,maxym kornienko,25,1,6,16.7,1,4,25,0,2,0,2,2,100,0,6,6,0,1,0,1,0,4
376362,422_14_54,UKRAINE,10713,13,ihor zaytsev,17,4,6,66.7,2,3,66.7,2,3,66.7,1,2,50,0,3,3,0,2,0,0,0,11
376363,422_14_54,UKRAINE,19863,14,artem pustovyi,1,0,0,0,0,0,0,0,0,0,0,0,0,0,0,0,0,0,0,0,0,0
376364,422_14_54,UKRAINE,5792,15,slava kravtsov,26,5,7,71.4,5,7,71.4,0,0,0,5,7,71.4,1,3,4,0,2,1,0,1,15
376365,422_14_54,UKRAINE,0,TOTALS,UKRAINE,200,25,62,40.3,17,38,44.7,8,24,33.3,13,19,68.4,10,24,34,8,21,19,5,2,71
376366,422_14_54,USA,9010,4,stephen curry,19,3,6,50,0,2,0,3,4,75,5,5,100,0,1,1,1,3,1,1,0,14
376367,422_14_54,USA,13751,5,klay thompson,24,3,7,42.9,2,5,40,1,2,50,0,0,0,1,4,5,4,1,1,0,2,7
376368,422_14_54,USA,16600,6,derrick rose,19,2,9,22.2,2,8,25,0,1,0,0,0,0,1,3,4,4,1,0,1,0,4
376369,422_14_54,USA,25451,7,kenneth faried,24,5,6,83.3,5,6,83.3,0,0,0,0,0,0,2,6,8,1,2,0,0,2,10
376370,422_14_54,USA,3452,8,rudy gay,12,1,7,14.3,1,6,16.7,0,1,0,0,0,0,1,2,3,1,1,1,2,0,2
376371,422_14_54,USA,25452,9,demar derozan,13,1,2,50,1,2,50,0,0,0,3,4,75,0,0,0,0,2,0,0,0,5
376372,422_14_54,USA,16977,10,kyrie irving,21,4,6,66.7,3,5,60,1,1,100,2,2,100,0,3,3,6,2,2,4,0,11
376373,422_14_54,USA,12194,11,mason plumlee,4,1,1,100,1,1,100,0,0,0,0,0,0,1,1,2,0,1,1,0,0,2
376374,422_14_54,USA,25453,12,demarcus cousins,15,4,8,50,4,8,50,0,0,0,3,5,60,2,1,3,1,1,0,1,1,11
376375,422_14_54,USA,21035,13,james harden,24,7,12,58.3,7,9,77.8,0,3,0,3,5,60,2,1,3,5,2,2,2,0,17
376376,422_14_54,USA,21036,14,anthony davis,21,6,9,66.7,6,9,66.7,0,0,0,0,0,0,2,4,6,1,3,1,1,1,12
376377,422_14_54,USA,14750,15,andre drummond,4,0,0,0,0,0,0,0,0,0,0,0,0,0,2,2,1,0,1,0,0,0
376378,422_14_54,USA,0,TOTALS,USA,200,37,73,50.7,32,61,52.5,5,12,41.7,16,21,76.2,14,28,42,25,19,10,12,6,95
376379,422_14_55,IRAN,23303,4,rouzbeh arghavan,7,0,0,0,0,0,0,0,0,0,0,0,0,0,2,2,0,1,0,0,0,0
376380,422_14_55,IRAN,22993,5,sajjad mashayekhi,0,0,0,0,0,0,0,0,0,0,0,0,0,0,0,0,0,0,0,0,0,0
376381,422_14_55,IRAN,22994,6,behnam yakhchali,9,0,0,0,0,0,0,0,0,0,0,0,0,0,0,0,1,0,1,0,0,0
376382,422_14_55,IRAN,9685,7,mahdi kamrani,35,7,12,58.3,4,6,66.7,3,6,50,0,0,0,0,1,1,5,4,2,4,0,17
376383,422_14_55,IRAN,13745,8,arsalan kazemi,0,0,0,0,0,0,0,0,0,0,0,0,0,0,0,0,0,0,0,0,0,0
376384,422_14_55,IRAN,14408,9,arman zangeneh,8,0,0,0,0,0,0,0,0,0,0,0,0,0,0,0,0,1,0,0,0,0
376385,422_14_55,IRAN,9688,10,hamed afagh,29,5,7,71.4,5,6,83.3,0,1,0,0,0,0,1,3,4,1,2,2,2,0,10
376386,422_14_55,IRAN,9690,11,oshin sahakian,27,0,2,0,0,1,0,0,1,0,0,0,0,0,3,3,0,1,0,0,0,0
376387,422_14_55,IRAN,16613,12,asghar kardoust,6,0,0,0,0,0,0,0,0,0,0,0,0,0,1,1,0,3,1,1,0,0
376388,422_14_55,IRAN,13739,13,mohammad jamshidi,10,2,4,50,2,2,100,0,2,0,0,0,0,0,0,0,0,1,0,0,0,4
376389,422_14_55,IRAN,11627,14,samad nikkhah bahrami,37,7,15,46.7,5,10,50,2,5,40,7,11,63.6,2,0,2,4,2,4,0,0,23
376390,422_14_55,IRAN,9693,15,hamed haddadi,32,6,19,31.6,6,17,35.3,0,2,0,10,13,76.9,9,6,15,0,3,3,1,1,22
376391,422_14_55,IRAN,0,TOTALS,IRAN,200,27,59,45.8,22,42,52.4,5,17,29.4,17,24,70.8,13,19,32,11,18,15,8,1,76
376392,422_14_55,FRANCE,12495,4,thomas heurtel,24,6,9,66.7,5,6,83.3,1,3,33.3,2,2,100,1,1,2,4,1,4,1,0,15
376393,422_14_55,FRANCE,2588,5,nicolas batum,15,1,2,50,1,1,100,0,1,0,0,0,0,1,0,1,2,2,0,1,0,2
376394,422_14_55,FRANCE,2589,6,antoine diot,22,1,5,20,0,2,0,1,3,33.3,0,2,0,0,5,5,2,2,2,1,0,3
376395,422_14_55,FRANCE,11076,7,joffrey lauvergne,18,5,9,55.6,3,6,50,2,3,66.7,0,0,0,2,3,5,0,2,0,0,1,12
376396,422_14_55,FRANCE,1864,8,charles kahudi,8,2,2,100,2,2,100,0,0,0,0,0,0,0,1,1,0,2,0,1,0,4
376397,422_14_55,FRANCE,6249,9,edwin jackson,15,3,8,37.5,2,4,50,1,4,25,0,0,0,0,0,0,1,1,0,0,0,7
376398,422_14_55,FRANCE,12971,10,evan fournier,18,3,5,60,0,0,0,3,5,60,4,6,66.7,0,1,1,1,4,1,0,0,13
376399,422_14_55,FRANCE,4663,11,florent pietrus,17,0,0,0,0,0,0,0,0,0,0,0,0,0,2,2,1,3,0,0,1,0
376400,422_14_55,FRANCE,17374,12,rudy gobert,12,1,1,100,1,1,100,0,0,0,1,1,100,0,3,3,0,2,0,1,0,3
376401,422_14_55,FRANCE,4665,13,boris diaw,27,4,5,80,3,4,75,1,1,100,3,4,75,0,5,5,3,0,4,0,1,12
376402,422_14_55,FRANCE,7987,14,kim tillie,5,1,2,50,1,2,50,0,0,0,0,0,0,0,0,0,0,2,1,0,0,2
376403,422_14_55,FRANCE,5044,15,mickael gelabale,19,3,5,60,1,1,100,2,4,50,0,0,0,0,1,1,1,2,1,1,0,8
376404,422_14_55,FRANCE,0,TOTALS,FRANCE,200,30,53,56.6,19,29,65.5,11,24,45.8,10,15,66.7,4,24,28,15,23,14,6,3,81
376405,422_14_56,CROATIA,1844,4,ante tomic,13,3,4,75,3,4,75,0,0,0,1,4,25,0,2,2,5,4,1,0,0,7
376406,422_14_56,CROATIA,1121,5,luksa andric,13,3,3,100,3,3,100,0,0,0,0,0,0,1,1,2,3,0,2,0,0,6
376407,422_14_56,CROATIA,25431,6,oliver lafayette,12,2,3,66.7,1,2,50,1,1,100,0,0,0,0,1,1,1,3,3,2,0,5
376408,422_14_56,CROATIA,6280,7,bojan bogdanovic,26,4,8,50,3,4,75,1,4,25,14,17,82.4,0,2,2,2,2,2,0,0,23
376409,422_14_56,CROATIA,15894,8,dario saric,14,5,5,100,3,3,100,2,2,100,3,3,100,1,3,4,3,4,2,0,0,15
376410,422_14_56,CROATIA,1846,9,damjan rudez,18,1,4,25,0,0,0,1,4,25,3,3,100,1,0,1,0,1,3,0,0,6
376411,422_14_56,CROATIA,4585,10,roko ukic,24,3,5,60,2,2,100,1,3,33.3,0,0,0,0,2,2,6,3,1,2,0,7
376412,422_14_56,CROATIA,1249,11,krunoslav simon,28,3,10,30,0,4,0,3,6,50,0,0,0,2,5,7,4,2,0,1,0,9
376413,422_14_56,CROATIA,1250,12,damir markota,23,4,6,66.7,3,4,75,1,2,50,1,2,50,3,4,7,1,2,3,0,0,10
376414,422_14_56,CROATIA,18415,13,mario hezonja,6,1,1,100,1,1,100,0,0,0,0,0,0,1,1,2,0,4,2,0,0,2
376415,422_14_56,CROATIA,16607,14,luka zoric,14,3,6,50,3,6,50,0,0,0,3,3,100,2,0,2,0,3,2,0,0,9
376416,422_14_56,CROATIA,13759,15,luka babic,9,1,2,50,0,0,0,1,2,50,1,2,50,0,1,1,1,2,1,0,0,4
376417,422_14_56,CROATIA,0,TOTALS,CROATIA,200,33,57,57.9,22,33,66.7,11,24,45.8,26,34,76.5,11,23,34,26,30,22,5,0,103
376418,422_14_56,PUERTO RICO,23748,4,ramon clemente,8,0,0,0,0,0,0,0,0,0,2,4,50,1,0,1,0,1,0,0,0,2
376419,422_14_56,PUERTO RICO,19036,5,jose barea,25,6,13,46.2,1,4,25,5,9,55.6,3,4,75,0,0,0,1,5,5,1,0,20
376420,422_14_56,PUERTO RICO,21059,6,alex franklin,25,5,9,55.6,2,4,50,3,5,60,0,0,0,1,2,3,0,2,1,3,0,13
376421,422_14_56,PUERTO RICO,100,7,carlos arroyo,0,0,0,0,0,0,0,0,0,0,0,0,0,0,0,0,0,0,0,0,0,0
376422,422_14_56,PUERTO RICO,3479,8,angel vassallo,0,0,0,0,0,0,0,0,0,0,0,0,0,0,0,0,0,0,0,0,0,0
376423,422_14_56,PUERTO RICO,25443,9,carlos rivera,25,3,8,37.5,3,6,50,0,2,0,1,1,100,0,1,1,6,2,1,2,0,7
376424,422_14_56,PUERTO RICO,8997,10,jorge bryan diaz,5,0,0,0,0,0,0,0,0,0,0,0,0,0,0,0,0,0,0,0,0,0
376425,422_14_56,PUERTO RICO,481,11,ricky sanchez,24,3,5,60,1,2,50,2,3,66.7,3,6,50,3,0,3,2,5,0,0,0,11
376426,422_14_56,PUERTO RICO,7435,12,david huertas,22,3,7,42.9,3,6,50,0,1,0,3,3,100,2,2,4,0,5,2,0,0,9
376427,422_14_56,PUERTO RICO,16592,13,renaldo balkman,20,3,5,60,3,5,60,0,0,0,0,0,0,2,1,3,1,2,4,2,0,6
376428,422_14_56,PUERTO RICO,3478,14,alexander galindo,23,5,12,41.7,4,6,66.7,1,6,16.7,0,0,0,0,4,4,0,3,0,2,1,11
376429,422_14_56,PUERTO RICO,108,15,daniel santiago,23,1,4,25,1,4,25,0,0,0,1,2,50,1,1,2,2,4,3,0,0,3
376430,422_14_56,PUERTO RICO,0,TOTALS,PUERTO RICO,200,29,63,46,18,37,48.6,11,26,42.3,13,20,65,12,13,25,12,29,18,10,1,82
376431,422_14_57,LITHUANIA,1728,4,martynas pocius,21,3,5,60,2,2,100,1,3,33.3,0,0,0,1,2,3,1,1,3,0,0,7
376432,422_14_57,LITHUANIA,6225,5,adas juskevicius,21,2,7,28.6,1,4,25,1,3,33.3,1,2,50,0,1,1,3,3,2,2,1,6
376433,422_14_57,LITHUANIA,10639,6,mindaugas kuzminskas,0,0,0,0,0,0,0,0,0,0,0,0,0,0,0,0,0,0,0,0,0,0
376434,422_14_57,LITHUANIA,5073,7,darjus lavrinovic,22,4,8,50,3,6,50,1,2,50,2,2,100,3,5,8,0,2,2,0,0,11
376435,422_14_57,LITHUANIA,980,8,jonas maciulis,17,0,4,0,0,2,0,0,2,0,4,4,100,0,2,2,1,4,3,2,0,4
376436,422_14_57,LITHUANIA,3474,9,renaldas seibutis,32,2,6,33.3,2,6,33.3,0,0,0,2,3,66.7,1,0,1,1,0,0,0,0,6
376437,422_14_57,LITHUANIA,292,10,simas jasaitis,24,1,2,50,0,1,0,1,1,100,0,0,0,1,3,4,0,1,0,0,0,3
376438,422_14_57,LITHUANIA,8177,11,donatas motiejunas,14,2,5,40,1,3,33.3,1,2,50,0,2,0,0,2,2,0,0,0,0,0,5
376439,422_14_57,LITHUANIA,21,12,ksistof lavrinovic,10,2,5,40,1,3,33.3,1,2,50,0,0,0,0,4,4,0,1,0,0,1,5
376440,422_14_57,LITHUANIA,987,13,paulius jankunas,16,2,3,66.7,2,3,66.7,0,0,0,2,2,100,0,4,4,2,0,2,0,0,6
376441,422_14_57,LITHUANIA,10916,14,jonas valanciunas,17,5,7,71.4,5,7,71.4,0,0,0,2,2,100,1,1,2,0,3,0,0,2,12
376442,422_14_57,LITHUANIA,6221,15,sarunas vasiliauskas,6,1,4,25,1,3,33.3,0,1,0,0,0,0,0,1,1,1,2,1,0,0,2
376443,422_14_57,LITHUANIA,0,TOTALS,LITHUANIA,200,24,56,42.9,18,40,45,6,16,37.5,13,17,76.5,9,29,38,9,17,14,4,4,67
376444,422_14_57,SLOVENIA,24203,4,jure balazic,17,1,5,20,0,0,0,1,5,20,0,0,0,0,3,3,0,5,0,0,0,3
376445,422_14_57,SLOVENIA,5023,5,uros slokar,16,2,6,33.3,2,6,33.3,0,0,0,1,2,50,1,1,2,0,2,0,0,2,5
376446,422_14_57,SLOVENIA,17812,6,aleksej nikolic,0,0,0,0,0,0,0,0,0,0,0,0,0,0,0,0,0,0,0,0,0,0
376447,422_14_57,SLOVENIA,17343,7,klemen prepelic,0,0,0,0,0,0,0,0,0,0,0,0,0,0,0,0,0,0,0,0,0,0
376448,422_14_57,SLOVENIA,10978,8,edo muric,12,0,1,0,0,1,0,0,0,0,0,0,0,1,2,3,0,0,0,0,0,0
376449,422_14_57,SLOVENIA,15479,9,jaka blazic,0,0,0,0,0,0,0,0,0,0,0,0,0,0,0,0,0,0,0,0,0,0
376450,422_14_57,SLOVENIA,4764,10,miha zupan,26,6,10,60,5,6,83.3,1,4,25,0,0,0,1,1,2,1,3,0,1,0,13
376451,422_14_57,SLOVENIA,1068,11,goran dragic,33,5,14,35.7,5,9,55.6,0,5,0,2,5,40,0,1,1,4,4,3,2,0,12
376452,422_14_57,SLOVENIA,6197,12,zoran dragic,32,4,8,50,2,4,50,2,4,50,0,0,0,1,5,6,2,2,0,1,1,10
376453,422_14_57,SLOVENIA,1064,13,domen lorbek,35,6,14,42.9,4,7,57.1,2,7,28.6,0,0,0,0,3,3,2,3,3,1,0,14
376454,422_14_57,SLOVENIA,5782,14,jaka klobucar,8,0,0,0,0,0,0,0,0,0,0,0,0,0,0,0,3,0,2,0,0,0
376455,422_14_57,SLOVENIA,17344,15,alen omic,21,2,7,28.6,2,7,28.6,0,0,0,3,3,100,5,3,8,0,3,1,1,0,7
376456,422_14_57,SLOVENIA,0,TOTALS,SLOVENIA,200,26,65,40,20,40,50,6,25,24,6,10,60,11,23,34,12,22,11,6,3,64
376457,422_14_58,TURKEY,20219,4,cedi osman,16,3,5,60,2,3,66.7,1,2,50,0,0,0,1,0,1,1,2,0,1,0,7
376458,422_14_58,TURKEY,15304,5,sinan guler,23,0,6,0,0,4,0,0,2,0,2,2,100,1,1,2,0,4,0,1,1,2
376459,422_14_58,TURKEY,4571,6,baris ermis,13,0,1,0,0,0,0,0,1,0,0,0,0,0,2,2,2,3,3,0,0,0
376460,422_14_58,TURKEY,1798,7,cenk akyol,23,3,8,37.5,0,2,0,3,6,50,0,0,0,0,1,1,0,3,1,0,0,9
376461,422_14_58,TURKEY,2576,8,baris hersek,12,1,3,33.3,0,1,0,1,2,50,0,0,0,0,0,0,1,1,0,1,1,3
376462,422_14_58,TURKEY,7785,9,emir preldzic,18,3,7,42.9,3,6,50,0,1,0,3,4,75,0,2,2,5,1,2,0,0,9
376463,422_14_58,TURKEY,4569,10,kerem tunceri,18,0,3,0,0,1,0,0,2,0,2,2,100,0,0,0,5,0,2,0,0,2
376464,422_14_58,TURKEY,1796,11,oguz savas,24,7,9,77.8,7,8,87.5,0,1,0,1,2,50,2,4,6,3,1,0,2,0,15
376465,422_14_58,TURKEY,4576,12,kerem gonlum,18,5,8,62.5,5,8,62.5,0,0,0,0,0,0,2,4,6,1,2,0,0,0,10
376466,422_14_58,TURKEY,4572,13,ender arslan,15,1,4,25,0,2,0,1,2,50,0,0,0,0,0,0,4,0,1,1,0,3
376467,422_14_58,TURKEY,7790,14,omer asik,13,4,9,44.4,4,9,44.4,0,0,0,1,2,50,2,8,10,0,0,2,1,0,9
376468,422_14_58,TURKEY,10942,15,furkan aldemir,8,4,4,100,4,4,100,0,0,0,0,3,0,3,3,6,0,0,1,1,0,8
376469,422_14_58,TURKEY,0,TOTALS,TURKEY,200,31,67,46.3,25,48,52.1,6,19,31.6,9,15,60,12,31,43,22,17,12,8,2,77
376470,422_14_58,DOMINICAN REPUBLIC,19011,4,edgar sosa,20,2,8,25,1,3,33.3,1,5,20,0,0,0,0,1,1,3,1,0,0,0,5
376471,422_14_58,DOMINICAN REPUBLIC,461,5,manuel fortuna,10,4,4,100,4,4,100,0,0,0,0,0,0,0,0,0,0,1,1,1,0,8
376472,422_14_58,DOMINICAN REPUBLIC,14632,6,juan coronado,22,2,4,50,2,3,66.7,0,1,0,0,0,0,0,2,2,6,3,0,1,1,4
376473,422_14_58,DOMINICAN REPUBLIC,25436,7,victor liz,12,5,7,71.4,4,6,66.7,1,1,100,1,2,50,0,1,1,0,0,1,0,0,12
376474,422_14_58,DOMINICAN REPUBLIC,23761,8,edward santana,4,0,2,0,0,1,0,0,1,0,0,0,0,1,0,1,0,2,1,0,0,0
376475,422_14_58,DOMINICAN REPUBLIC,4116,9,francisco garcia,28,7,12,58.3,3,6,50,4,6,66.7,0,0,0,0,2,2,2,1,2,2,0,18
376476,422_14_58,DOMINICAN REPUBLIC,23762,10,james feldeine,17,2,5,40,1,3,33.3,1,2,50,1,2,50,0,1,1,0,0,4,1,0,6
376477,422_14_58,DOMINICAN REPUBLIC,19070,11,eloy vargas,22,2,9,22.2,2,9,22.2,0,0,0,0,0,0,0,4,4,0,3,1,0,0,4
376478,422_14_58,DOMINICAN REPUBLIC,19016,12,orlando sanchez,14,0,2,0,0,2,0,0,0,0,0,0,0,2,3,5,1,3,1,1,0,0
376479,422_14_58,DOMINICAN REPUBLIC,9947,13,eulis baez,25,1,2,50,1,1,100,0,1,0,0,0,0,0,3,3,2,1,0,1,0,2
376480,422_14_58,DOMINICAN REPUBLIC,16889,14,ronald ramon,12,0,2,0,0,0,0,0,2,0,0,0,0,0,1,1,1,3,0,1,0,0
376481,422_14_58,DOMINICAN REPUBLIC,430,15,jack martinez,15,2,6,33.3,1,4,25,1,2,50,0,0,0,1,8,9,1,0,2,0,0,5
376482,422_14_58,DOMINICAN REPUBLIC,0,TOTALS,DOMINICAN REPUBLIC,200,27,63,42.9,19,42,45.2,8,21,38.1,2,4,50,5,27,32,16,18,13,8,1,64
376483,422_14_59,SERBIA,5751,4,milos teodosic,30,4,8,50,2,3,66.7,2,5,40,0,0,0,1,2,3,2,2,6,2,0,10
376484,422_14_59,SERBIA,2100,5,marko simonovic,14,1,2,50,0,0,0,1,2,50,2,2,100,0,0,0,2,0,1,1,0,5
376485,422_14_59,SERBIA,25441,6,stefan jovic,13,0,1,0,0,1,0,0,0,0,0,0,0,0,2,2,0,0,0,1,0,0
376486,422_14_59,SERBIA,17361,7,bogdan bogdanovic,24,3,7,42.9,1,2,50,2,5,40,0,0,0,0,2,2,4,4,1,1,0,8
376487,422_14_59,SERBIA,15386,8,nemanja bjelica,22,6,14,42.9,5,11,45.5,1,3,33.3,6,7,85.7,5,5,10,3,3,3,0,0,19
376488,422_14_59,SERBIA,2654,9,stefan markovic,26,2,4,50,2,3,66.7,0,1,0,0,1,0,1,1,2,3,4,2,1,0,4
376489,422_14_59,SERBIA,19860,10,nikola kalinic,12,0,1,0,0,0,0,0,1,0,1,2,50,0,2,2,0,2,1,0,0,1
376490,422_14_59,SERBIA,15504,11,stefan bircevic,12,2,3,66.7,1,1,100,1,2,50,0,0,0,0,2,2,0,5,1,0,1,5
376491,422_14_59,SERBIA,93,12,nenad krstic,6,1,4,25,1,4,25,0,0,0,0,0,0,0,1,1,0,1,0,0,0,2
376492,422_14_59,SERBIA,2656,13,miroslav raduljica,26,4,11,36.4,4,11,36.4,0,0,0,5,6,83.3,1,3,4,1,2,3,1,0,13
376493,422_14_59,SERBIA,24202,14,rasko katic,6,0,3,0,0,3,0,0,0,0,0,0,0,0,0,0,0,1,0,0,0,0
376494,422_14_59,SERBIA,5756,15,vladimir stimac,9,3,6,50,3,6,50,0,0,0,0,2,0,1,2,3,0,2,0,1,0,6
376495,422_14_59,SERBIA,0,TOTALS,SERBIA,200,26,64,40.6,19,45,42.2,7,19,36.8,14,20,70,10,22,32,15,28,18,8,1,73
376496,422_14_59,SPAIN,61,4,pau gasol,28,6,11,54.5,6,10,60,0,1,0,8,8,100,3,1,4,1,1,1,0,1,20
376497,422_14_59,SPAIN,70,5,rudy fernandez,21,2,6,33.3,1,2,50,1,4,25,4,4,100,0,1,1,2,3,0,1,0,9
376498,422_14_59,SPAIN,1877,6,sergio rodriguez,15,0,4,0,0,2,0,0,2,0,2,2,100,0,1,1,1,2,2,1,0,2
376499,422_14_59,SPAIN,64,7,juan c. navarro,19,5,7,71.4,2,3,66.7,3,4,75,2,2,100,0,2,2,2,1,0,0,0,15
376500,422_14_59,SPAIN,65,8,jose calderon,14,3,4,75,1,2,50,2,2,100,0,0,0,0,1,1,0,1,1,0,0,8
376501,422_14_59,SPAIN,66,9,felipe reyes,7,0,1,0,0,0,0,0,1,0,3,4,75,0,5,5,1,3,0,0,0,3
376502,422_14_59,SPAIN,2628,10,victor claver,3,0,1,0,0,0,0,0,1,0,0,0,0,0,0,0,0,2,1,0,0,0
376503,422_14_59,SPAIN,6259,11,ricky rubio,22,3,5,60,3,4,75,0,1,0,6,6,100,0,4,4,6,5,7,7,0,12
376504,422_14_59,SPAIN,1871,12,sergio llull,25,2,7,28.6,1,3,33.3,1,4,25,0,0,0,0,3,3,1,3,2,0,0,5
376505,422_14_59,SPAIN,1108,13,marc gasol,28,5,6,83.3,4,5,80,1,1,100,0,2,0,1,7,8,2,1,2,0,1,11
376506,422_14_59,SPAIN,7001,14,serge ibaka,14,1,4,25,1,3,33.3,0,1,0,0,0,0,2,2,4,0,3,1,0,1,2
376507,422_14_59,SPAIN,19988,15,alex abrines,4,1,3,33.3,1,2,50,0,1,0,0,0,0,1,0,1,0,0,0,1,0,2
376508,422_14_59,SPAIN,0,TOTALS,SPAIN,200,28,59,47.5,20,36,55.6,8,23,34.8,25,28,89.3,8,30,38,16,26,18,10,3,89
376509,422_14_60,ARGENTINA,80,4,luis scola,31,6,17,35.3,5,15,33.3,1,2,50,4,6,66.7,1,4,5,3,2,1,2,0,17
376510,422_14_60,ARGENTINA,16652,5,tayavek gallizzi,0,0,0,0,0,0,0,0,0,0,0,0,0,0,0,0,0,0,0,0,0,0
376511,422_14_60,ARGENTINA,12069,6,marcos mata,19,0,1,0,0,1,0,0,0,0,0,0,0,1,2,3,1,1,0,1,0,0
376512,422_14_60,ARGENTINA,21037,7,facundo campazzo,30,3,14,21.4,2,9,22.2,1,5,20,3,3,100,0,1,1,5,2,1,1,0,10
376513,422_14_60,ARGENTINA,357,8,pablo prigioni,28,4,6,66.7,2,2,100,2,4,50,0,0,0,0,0,0,1,3,1,3,0,10
376514,422_14_60,ARGENTINA,12228,9,nicolas laprovittola,15,3,5,60,2,4,50,1,1,100,0,0,0,1,2,3,1,2,1,0,0,7
376515,422_14_60,ARGENTINA,81,10,leo gutierrez,13,1,4,25,0,0,0,1,4,25,0,0,0,0,1,1,1,4,0,1,0,3
376516,422_14_60,ARGENTINA,14903,11,marcos delia,9,1,1,100,1,1,100,0,0,0,2,2,100,0,0,0,0,1,0,0,0,4
376517,422_14_60,ARGENTINA,77,12,walter herrmann,21,3,7,42.9,3,6,50,0,1,0,1,1,100,0,5,5,0,1,0,0,0,7
376518,422_14_60,ARGENTINA,82,13,andres nocioni,27,2,6,33.3,2,4,50,0,2,0,4,5,80,0,4,4,0,4,2,2,0,8
376519,422_14_60,ARGENTINA,12297,14,matias bortolin,0,0,0,0,0,0,0,0,0,0,0,0,0,0,0,0,0,0,0,0,0,0
376520,422_14_60,ARGENTINA,21197,15,selem safar,7,1,2,50,0,1,0,1,1,100,2,2,100,0,0,0,1,1,0,0,0,5
376521,422_14_60,ARGENTINA,0,TOTALS,ARGENTINA,200,24,63,38.1,17,43,39.5,7,20,35,16,19,84.2,5,20,25,13,21,6,10,0,71
376522,422_14_60,GREECE,8303,4,vaggelis mantzaris,4,0,0,0,0,0,0,0,0,0,0,0,0,0,1,1,0,0,1,0,0,0
376523,422_14_60,GREECE,5050,5,giannis bourousis,31,6,13,46.2,5,10,50,1,3,33.3,3,4,75,3,12,15,2,2,2,1,3,16
376524,422_14_60,GREECE,123,6,nikos zisis,29,3,5,60,2,3,66.7,1,2,50,6,6,100,0,2,2,5,2,1,0,0,13
376525,422_14_60,GREECE,1053,7,kostas vasileiadis,8,1,2,50,1,2,50,0,0,0,0,0,0,0,0,0,0,1,0,0,0,2
376526,422_14_60,GREECE,12472,8,nick calathes,31,8,12,66.7,6,9,66.7,2,3,66.7,0,0,0,1,4,5,4,4,3,0,1,18
376527,422_14_60,GREECE,11632,9,andreas glyniadakis,0,0,0,0,0,0,0,0,0,0,0,0,0,0,0,0,0,0,0,0,0,0
376528,422_14_60,GREECE,10606,10,kostas papanikolaou,28,3,6,50,3,5,60,0,1,0,0,0,0,0,4,4,0,2,1,0,1,6
376529,422_14_60,GREECE,8304,11,kostas sloukas,9,1,2,50,0,0,0,1,2,50,0,0,0,0,0,0,1,1,1,1,0,3
376530,422_14_60,GREECE,15374,12,kostas kaimakoglou,12,0,3,0,0,1,0,0,2,0,2,2,100,0,2,2,1,3,1,1,0,2
376531,422_14_60,GREECE,24314,13,giannis antetokounmpo,12,0,2,0,0,2,0,0,0,0,0,0,0,1,5,6,0,3,1,0,1,0
376532,422_14_60,GREECE,1061,14,ian vougioukas,9,1,5,20,1,5,20,0,0,0,2,2,100,2,0,2,0,2,0,0,2,4
376533,422_14_60,GREECE,1056,15,georgios printezis,28,6,8,75,5,6,83.3,1,2,50,2,2,100,1,3,4,0,2,2,0,0,15
376534,422_14_60,GREECE,0,TOTALS,GREECE,200,29,58,50,23,43,53.5,6,15,40,15,16,93.8,8,33,41,13,22,14,3,8,79
376535,422_14_61,USA,9010,4,stephen curry,25,7,10,70,1,1,100,6,9,66.7,0,0,0,0,3,3,4,1,0,1,0,20
376536,422_14_61,USA,13751,5,klay thompson,22,6,14,42.9,3,5,60,3,9,33.3,0,0,0,0,5,5,2,3,2,0,0,15
376537,422_14_61,USA,16600,6,derrick rose,16,0,5,0,0,4,0,0,1,0,0,0,0,1,1,2,4,0,3,1,0,0
376538,422_14_61,USA,25451,7,kenneth faried,20,4,8,50,4,8,50,0,0,0,0,0,0,6,2,8,0,0,1,0,0,8
376539,422_14_61,USA,3452,8,rudy gay,13,4,7,57.1,2,4,50,2,3,66.7,0,0,0,0,1,1,0,0,0,0,0,10
376540,422_14_61,USA,25452,9,demar derozan,13,0,1,0,0,0,0,0,1,0,0,0,0,0,2,2,2,0,0,0,0,0
376541,422_14_61,USA,16977,10,kyrie irving,24,2,5,40,2,4,50,0,1,0,0,0,0,1,2,3,2,1,2,0,0,4
376542,422_14_61,USA,12194,11,mason plumlee,6,0,0,0,0,0,0,0,0,0,0,0,0,1,0,1,0,0,0,0,0,0
376543,422_14_61,USA,25453,12,demarcus cousins,15,5,5,100,5,5,100,0,0,0,1,1,100,2,5,7,1,3,1,0,2,11
376544,422_14_61,USA,21035,13,james harden,20,3,7,42.9,1,2,50,2,5,40,4,4,100,0,4,4,2,1,3,2,0,12
376545,422_14_61,USA,21036,14,anthony davis,20,2,9,22.2,2,9,22.2,0,0,0,0,0,0,1,5,6,1,1,1,2,4,4
376546,422_14_61,USA,14750,15,andre drummond,6,1,2,50,1,2,50,0,0,0,0,0,0,1,1,2,0,2,2,0,0,2
376547,422_14_61,USA,0,TOTALS,USA,200,34,73,46.6,21,44,47.7,13,29,44.8,5,5,100,14,31,45,18,12,15,6,6,86
376548,422_14_61,MEXICO,16880,4,paul stoll,15,2,7,28.6,1,2,50,1,5,20,0,0,0,1,5,6,2,0,2,0,0,5
376549,422_14_61,MEXICO,23812,5,marco ramos,23,2,5,40,2,4,50,0,1,0,0,0,0,1,5,6,0,2,2,0,0,4
376550,422_14_61,MEXICO,23755,6,roman martinez,10,3,6,50,2,3,66.7,1,3,33.3,0,0,0,0,0,0,0,1,1,0,0,7
376551,422_14_61,MEXICO,23756,7,jorge gutierrez,27,3,8,37.5,2,7,28.6,1,1,100,0,0,0,0,3,3,3,4,2,2,0,7
376552,422_14_61,MEXICO,9836,8,gustavo ayon,37,11,19,57.9,11,19,57.9,0,0,0,3,8,37.5,6,2,8,0,2,2,2,1,25
376553,422_14_61,MEXICO,23813,9,francisco cruz,19,3,11,27.3,3,9,33.3,0,2,0,0,0,0,2,3,5,1,0,4,2,0,6
376554,422_14_61,MEXICO,25444,10,israel gutierrez,4,0,0,0,0,0,0,0,0,0,0,0,0,0,0,0,0,0,1,0,0,0
376555,422_14_61,MEXICO,25445,11,david meza,8,1,3,33.3,1,3,33.3,0,0,0,0,0,0,1,0,1,1,1,0,0,0,2
376556,422_14_61,MEXICO,9835,12,hector hernandez,24,0,2,0,0,1,0,0,1,0,0,0,0,3,3,6,1,0,0,0,1,0
376557,422_14_61,MEXICO,21215,13,orlando mendez,18,2,7,28.6,1,4,25,1,3,33.3,0,0,0,0,0,0,2,0,0,0,0,5
376558,422_14_61,MEXICO,25446,14,adrian zamora,8,1,5,20,1,5,20,0,0,0,0,0,0,2,1,3,0,1,0,0,0,2
376559,422_14_61,MEXICO,25447,15,adam parada,7,0,0,0,0,0,0,0,0,0,0,0,0,1,1,2,0,1,1,1,0,0
376560,422_14_61,MEXICO,0,TOTALS,MEXICO,200,28,73,38.4,24,57,42.1,4,16,25,3,8,37.5,17,25,42,10,12,16,7,2,63
376561,422_14_62,FRANCE,12495,4,thomas heurtel,24,3,5,60,2,4,50,1,1,100,3,4,75,0,0,0,4,2,3,0,0,10
376562,422_14_62,FRANCE,2588,5,nicolas batum,31,5,13,38.5,5,7,71.4,0,6,0,4,6,66.7,0,2,2,1,2,1,4,1,14
376563,422_14_62,FRANCE,2589,6,antoine diot,16,1,3,33.3,1,1,100,0,2,0,0,0,0,0,2,2,3,2,0,1,0,2
376564,422_14_62,FRANCE,11076,7,joffrey lauvergne,19,3,6,50,2,5,40,1,1,100,1,2,50,0,2,2,1,3,1,0,0,8
376565,422_14_62,FRANCE,1864,8,charles kahudi,0,0,0,0,0,0,0,0,0,0,0,0,0,0,0,0,0,0,0,0,0,0
376566,422_14_62,FRANCE,6249,9,edwin jackson,3,0,2,0,0,0,0,0,2,0,0,0,0,0,0,0,0,0,0,0,0,0
376567,422_14_62,FRANCE,12971,10,evan fournier,19,5,10,50,4,5,80,1,5,20,2,4,50,0,4,4,1,1,1,0,0,13
376568,422_14_62,FRANCE,4663,11,florent pietrus,21,2,2,100,2,2,100,0,0,0,2,2,100,2,2,4,0,1,0,0,1,6
376569,422_14_62,FRANCE,17374,12,rudy gobert,14,1,1,100,1,1,100,0,0,0,0,0,0,0,4,4,0,2,1,0,2,2
376570,422_14_62,FRANCE,4665,13,boris diaw,27,1,7,14.3,0,5,0,1,2,50,0,0,0,0,5,5,5,2,5,0,1,3
376571,422_14_62,FRANCE,7987,14,kim tillie,0,0,0,0,0,0,0,0,0,0,0,0,0,0,0,0,0,0,0,0,0,0
376572,422_14_62,FRANCE,5044,15,mickael gelabale,26,4,7,57.1,1,4,25,3,3,100,0,0,0,1,5,6,0,1,3,0,0,11
376573,422_14_62,FRANCE,0,TOTALS,FRANCE,200,25,56,44.6,18,34,52.9,7,22,31.8,12,18,66.7,5,31,36,15,16,15,5,5,69
376574,422_14_62,CROATIA,1844,4,ante tomic,26,7,10,70,7,10,70,0,0,0,3,4,75,3,3,6,0,1,1,1,0,17
376575,422_14_62,CROATIA,1121,5,luksa andric,0,0,0,0,0,0,0,0,0,0,0,0,0,0,0,0,0,0,0,0,0,0
376576,422_14_62,CROATIA,25431,6,oliver lafayette,25,1,8,12.5,1,5,20,0,3,0,0,0,0,2,2,4,6,4,3,0,0,2
376577,422_14_62,CROATIA,6280,7,bojan bogdanovic,36,11,19,57.9,8,12,66.7,3,7,42.9,2,4,50,1,5,6,1,4,0,1,0,27
376578,422_14_62,CROATIA,15894,8,dario saric,27,2,6,33.3,2,6,33.3,0,0,0,0,0,0,0,7,7,0,3,3,3,1,4
376579,422_14_62,CROATIA,1846,9,damjan rudez,16,1,6,16.7,0,1,0,1,5,20,0,0,0,0,4,4,0,2,0,0,0,3
376580,422_14_62,CROATIA,4585,10,roko ukic,15,0,5,0,0,3,0,0,2,0,0,0,0,1,1,2,1,1,0,0,0,0
376581,422_14_62,CROATIA,1249,11,krunoslav simon,28,1,9,11.1,0,3,0,1,6,16.7,3,4,75,0,2,2,2,4,0,1,0,6
376582,422_14_62,CROATIA,1250,12,damir markota,17,1,3,33.3,0,1,0,1,2,50,0,0,0,1,2,3,0,1,1,0,0,3
376583,422_14_62,CROATIA,18415,13,mario hezonja,0,0,0,0,0,0,0,0,0,0,0,0,0,0,0,0,0,0,0,0,0,0
376584,422_14_62,CROATIA,16607,14,luka zoric,10,1,1,100,1,1,100,0,0,0,0,0,0,0,0,0,0,1,2,0,1,2
376585,422_14_62,CROATIA,13759,15,luka babic,0,0,0,0,0,0,0,0,0,0,0,0,0,0,0,0,0,0,0,0,0,0
376586,422_14_62,CROATIA,0,TOTALS,CROATIA,200,25,67,37.3,19,42,45.2,6,25,24,8,12,66.7,9,28,37,10,21,11,6,2,64
376587,422_14_63,DOMINICAN REPUBLIC,19011,4,edgar sosa,24,2,7,28.6,2,5,40,0,2,0,2,4,50,0,1,1,1,1,2,0,0,6
376588,422_14_63,DOMINICAN REPUBLIC,461,5,manuel fortuna,2,0,0,0,0,0,0,0,0,0,0,0,0,0,0,0,0,0,0,0,0,0
376589,422_14_63,DOMINICAN REPUBLIC,14632,6,juan coronado,19,1,5,20,1,3,33.3,0,2,0,1,2,50,0,0,0,0,2,0,1,1,3
376590,422_14_63,DOMINICAN REPUBLIC,25436,7,victor liz,5,0,1,0,0,1,0,0,0,0,0,0,0,0,0,0,0,1,1,0,0,0
376591,422_14_63,DOMINICAN REPUBLIC,23761,8,edward santana,0,0,0,0,0,0,0,0,0,0,0,0,0,0,0,0,0,0,0,0,0,0
376592,422_14_63,DOMINICAN REPUBLIC,4116,9,francisco garcia,21,3,5,60,2,3,66.7,1,2,50,0,0,0,0,1,1,1,3,3,2,2,7
376593,422_14_63,DOMINICAN REPUBLIC,23762,10,james feldeine,36,8,14,57.1,8,13,61.5,0,1,0,2,3,66.7,2,6,8,3,1,3,2,1,18
376594,422_14_63,DOMINICAN REPUBLIC,19070,11,eloy vargas,27,1,6,16.7,1,6,16.7,0,0,0,1,2,50,2,6,8,0,3,1,1,1,3
376595,422_14_63,DOMINICAN REPUBLIC,19016,12,orlando sanchez,3,0,1,0,0,1,0,0,0,0,0,0,0,0,1,1,0,2,0,0,0,0
376596,422_14_63,DOMINICAN REPUBLIC,9947,13,eulis baez,21,2,4,50,2,3,66.7,0,1,0,5,6,83.3,0,1,1,0,2,3,0,0,9
376597,422_14_63,DOMINICAN REPUBLIC,16889,14,ronald ramon,23,1,4,25,0,0,0,1,4,25,0,0,0,0,1,1,0,3,0,0,0,3
376598,422_14_63,DOMINICAN REPUBLIC,430,15,jack martinez,19,4,7,57.1,4,7,57.1,0,0,0,4,4,100,2,9,11,1,3,3,3,0,12
376599,422_14_63,DOMINICAN REPUBLIC,0,TOTALS,DOMINICAN REPUBLIC,200,22,54,40.7,20,42,47.6,2,12,16.7,15,21,71.4,6,27,33,6,21,16,9,5,61
376600,422_14_63,SLOVENIA,24203,4,jure balazic,14,1,6,16.7,0,1,0,1,5,20,4,4,100,2,2,4,0,4,1,0,0,7
376601,422_14_63,SLOVENIA,5023,5,uros slokar,32,4,9,44.4,3,8,37.5,1,1,100,0,0,0,0,6,6,0,2,0,2,0,9
376602,422_14_63,SLOVENIA,17812,6,aleksej nikolic,0,0,0,0,0,0,0,0,0,0,0,0,0,0,0,0,0,0,0,0,0,0
376603,422_14_63,SLOVENIA,17343,7,klemen prepelic,15,2,4,50,1,1,100,1,3,33.3,0,0,0,0,1,1,0,0,0,0,0,5
376604,422_14_63,SLOVENIA,10978,8,edo muric,10,0,2,0,0,1,0,0,1,0,0,0,0,2,3,5,0,2,3,0,0,0
376605,422_14_63,SLOVENIA,15479,9,jaka blazic,2,1,1,100,1,1,100,0,0,0,0,0,0,0,0,0,0,2,0,0,0,2
376606,422_14_63,SLOVENIA,4764,10,miha zupan,18,1,3,33.3,0,0,0,1,3,33.3,0,0,0,1,3,4,2,4,1,0,0,3
376607,422_14_63,SLOVENIA,1068,11,goran dragic,27,6,12,50,6,8,75,0,4,0,0,0,0,0,2,2,6,3,6,1,0,12
376608,422_14_63,SLOVENIA,6197,12,zoran dragic,32,8,15,53.3,6,10,60,2,5,40,0,2,0,0,3,3,1,2,1,4,1,18
376609,422_14_63,SLOVENIA,1064,13,domen lorbek,29,2,4,50,2,3,66.7,0,1,0,4,4,100,0,1,1,2,1,0,0,0,8
376610,422_14_63,SLOVENIA,5782,14,jaka klobucar,13,2,5,40,2,2,100,0,3,0,1,2,50,0,1,1,1,1,1,0,0,5
376611,422_14_63,SLOVENIA,17344,15,alen omic,8,1,3,33.3,1,3,33.3,0,0,0,0,0,0,1,1,2,0,3,3,0,0,2
376612,422_14_63,SLOVENIA,0,TOTALS,SLOVENIA,200,28,64,43.8,22,38,57.9,6,26,23.1,9,12,75,11,27,38,12,24,16,7,1,71
376613,422_14_64,SPAIN,61,4,pau gasol,25,8,10,80,8,8,100,0,2,0,1,2,50,1,4,5,1,1,4,0,3,17
376614,422_14_64,SPAIN,70,5,rudy fernandez,18,2,5,40,1,1,100,1,4,25,0,0,0,0,0,0,4,4,0,3,0,5
376615,422_14_64,SPAIN,1877,6,sergio rodriguez,18,2,4,50,1,3,33.3,1,1,100,0,0,0,0,0,0,2,1,1,1,0,5
376616,422_14_64,SPAIN,64,7,juan c. navarro,24,1,6,16.7,1,1,100,0,5,0,2,5,40,1,0,1,1,1,0,0,0,4
376617,422_14_64,SPAIN,65,8,jose calderon,14,3,4,75,0,0,0,3,4,75,2,2,100,0,1,1,0,1,1,0,0,11
376618,422_14_64,SPAIN,66,9,felipe reyes,13,4,6,66.7,4,6,66.7,0,0,0,3,4,75,2,2,4,1,3,1,0,1,11
376619,422_14_64,SPAIN,2628,10,victor claver,6,0,2,0,0,1,0,0,1,0,0,0,0,0,2,2,1,0,0,0,0,0
376620,422_14_64,SPAIN,6259,11,ricky rubio,20,2,4,50,2,4,50,0,0,0,3,4,75,0,5,5,6,2,2,5,1,7
376621,422_14_64,SPAIN,1871,12,sergio llull,15,3,5,60,2,2,100,1,3,33.3,0,3,0,0,1,1,1,2,1,0,1,7
376622,422_14_64,SPAIN,1108,13,marc gasol,26,4,4,100,3,3,100,1,1,100,0,0,0,1,5,6,4,1,0,0,4,9
376623,422_14_64,SPAIN,7001,14,serge ibaka,17,4,7,57.1,4,6,66.7,0,1,0,3,4,75,3,3,6,0,4,1,0,3,11
376624,422_14_64,SPAIN,19988,15,alex abrines,6,1,2,50,1,1,100,0,1,0,0,0,0,0,0,0,0,1,0,0,0,2
376625,422_14_64,SPAIN,0,TOTALS,SPAIN,200,34,59,57.6,27,36,75,7,23,30.4,14,24,58.3,9,24,33,21,21,11,9,13,89
376626,422_14_64,SENEGAL,11764,4,thierno niang,11,2,5,40,2,3,66.7,0,2,0,0,2,0,0,1,1,1,2,2,0,0,4
376627,422_14_64,SENEGAL,18541,5,xane dalmeida,24,2,6,33.3,1,4,25,1,2,50,0,0,0,1,3,4,4,4,6,0,0,5
376628,422_14_64,SENEGAL,23085,6,ibrahima thomas,11,1,4,25,1,3,33.3,0,1,0,0,2,0,5,2,7,0,2,1,0,0,2
376629,422_14_64,SENEGAL,18542,7,mamadou ndoye,5,0,1,0,0,1,0,0,0,0,1,2,50,0,0,0,1,1,2,0,0,1
376630,422_14_64,SENEGAL,18543,8,mohamet diop,16,1,5,20,1,4,25,0,1,0,0,0,0,0,0,0,0,3,1,1,0,2
376631,422_14_64,SENEGAL,3592,9,maleye ndoye,24,1,5,20,1,4,25,0,1,0,0,0,0,0,0,0,0,2,1,0,0,2
376632,422_14_64,SENEGAL,25448,10,djibril thiam,0,0,0,0,0,0,0,0,0,0,0,0,0,0,0,0,0,0,0,0,0,0
376633,422_14_64,SENEGAL,9148,11,mouhammad faye,20,5,7,71.4,4,4,100,1,3,33.3,1,1,100,0,2,2,1,2,2,0,0,12
376634,422_14_64,SENEGAL,25449,12,maurice ndour,20,1,1,100,1,1,100,0,0,0,2,2,100,1,1,2,0,2,1,1,0,4
376635,422_14_64,SENEGAL,23089,13,hamady ndiaye,20,2,3,66.7,2,3,66.7,0,0,0,2,2,100,2,2,4,0,3,1,0,0,6
376636,422_14_64,SENEGAL,25450,14,gorgui dieng,27,1,9,11.1,1,9,11.1,0,0,0,4,6,66.7,3,4,7,2,1,3,1,0,6
376637,422_14_64,SENEGAL,23091,15,abdou badji,22,5,13,38.5,5,12,41.7,0,1,0,2,2,100,1,6,7,0,2,0,1,0,12
376638,422_14_64,SENEGAL,0,TOTALS,SENEGAL,200,21,59,35.6,19,48,39.6,2,11,18.2,12,19,63.2,15,22,37,9,24,21,4,0,56
376639,422_14_65,NEW ZEALAND,6772,4,lindsay tait,6,0,0,0,0,0,0,0,0,0,0,0,0,0,0,0,2,0,0,0,0,0
376640,422_14_65,NEW ZEALAND,21055,5,everard bartlett,7,0,1,0,0,0,0,0,1,0,0,0,0,0,1,1,0,0,0,0,0,0
376641,422_14_65,NEW ZEALAND,39,6,kirk penney,23,1,7,14.3,1,3,33.3,0,4,0,4,5,80,0,2,2,3,2,3,1,0,6
376642,422_14_65,NEW ZEALAND,6773,7,mika vukona,25,2,6,33.3,2,6,33.3,0,0,0,5,6,83.3,5,5,10,2,4,2,3,0,9
376643,422_14_65,NEW ZEALAND,16521,8,jarrod kenny,7,0,0,0,0,0,0,0,0,0,0,0,0,0,0,0,1,2,0,0,0,0
376644,422_14_65,NEW ZEALAND,11656,9,corey webster,28,10,21,47.6,7,13,53.8,3,8,37.5,3,3,100,1,3,4,0,3,0,1,0,26
376645,422_14_65,NEW ZEALAND,16523,10,thomas abercrombie,19,3,7,42.9,3,5,60,0,2,0,0,0,0,1,2,3,1,5,2,0,0,6
376646,422_14_65,NEW ZEALAND,16524,11,bj anthony,12,2,3,66.7,2,3,66.7,0,0,0,0,0,0,0,1,1,1,1,0,0,0,4
376647,422_14_65,NEW ZEALAND,25442,12,isaac fotu,25,4,7,57.1,2,4,50,2,3,66.7,1,3,33.3,0,1,1,1,4,1,0,0,11
376648,422_14_65,NEW ZEALAND,6846,13,casey frank,13,1,4,25,0,1,0,1,3,33.3,0,0,0,1,1,2,0,2,2,0,0,3
376649,422_14_65,NEW ZEALAND,13832,14,rob loe,9,0,1,0,0,1,0,0,0,0,0,0,0,1,1,2,0,2,0,0,0,0
376650,422_14_65,NEW ZEALAND,21056,15,tai webster,27,3,5,60,3,4,75,0,1,0,0,0,0,0,2,2,1,3,4,2,1,6
376651,422_14_65,NEW ZEALAND,0,TOTALS,NEW ZEALAND,200,26,62,41.9,20,40,50,6,22,27.3,13,17,76.5,12,25,37,12,28,14,7,1,71
376652,422_14_65,LITHUANIA,1728,4,martynas pocius,24,3,7,42.9,1,2,50,2,5,40,3,6,50,1,2,3,1,3,1,1,0,11
376653,422_14_65,LITHUANIA,6225,5,adas juskevicius,20,1,4,25,1,2,50,0,2,0,0,0,0,0,0,0,3,1,0,0,0,2
376654,422_14_65,LITHUANIA,10639,6,mindaugas kuzminskas,10,1,2,50,1,1,100,0,1,0,0,1,0,0,0,0,0,2,1,1,0,2
376655,422_14_65,LITHUANIA,5073,7,darjus lavrinovic,13,3,4,75,1,2,50,2,2,100,2,2,100,0,2,2,0,4,1,0,0,10
376656,422_14_65,LITHUANIA,980,8,jonas maciulis,11,1,5,20,0,2,0,1,3,33.3,2,4,50,0,0,0,0,2,1,1,0,5
376657,422_14_65,LITHUANIA,3474,9,renaldas seibutis,34,4,13,30.8,4,9,44.4,0,4,0,1,1,100,0,0,0,5,2,2,0,0,9
376658,422_14_65,LITHUANIA,292,10,simas jasaitis,16,0,1,0,0,1,0,0,0,0,0,0,0,0,1,1,0,2,1,0,0,0
376659,422_14_65,LITHUANIA,8177,11,donatas motiejunas,21,2,7,28.6,2,4,50,0,3,0,4,6,66.7,3,5,8,0,1,1,2,0,8
376660,422_14_65,LITHUANIA,21,12,ksistof lavrinovic,9,0,1,0,0,1,0,0,0,0,2,2,100,0,1,1,1,0,0,0,0,2
376661,422_14_65,LITHUANIA,987,13,paulius jankunas,10,1,3,33.3,1,2,50,0,1,0,0,0,0,0,1,1,0,1,1,1,0,2
376662,422_14_65,LITHUANIA,10916,14,jonas valanciunas,27,8,11,72.7,8,11,72.7,0,0,0,6,6,100,5,8,13,0,1,0,0,3,22
376663,422_14_65,LITHUANIA,6221,15,sarunas vasiliauskas,5,1,2,50,0,0,0,1,2,50,0,0,0,0,0,0,3,1,1,0,0,3
376664,422_14_65,LITHUANIA,0,TOTALS,LITHUANIA,200,25,60,41.7,19,37,51.4,6,23,26.1,20,28,71.4,11,26,37,13,20,10,6,3,76
376665,422_14_66,SERBIA,5751,4,milos teodosic,33,4,10,40,2,4,50,2,6,33.3,3,3,100,0,2,2,5,2,3,1,0,13
376666,422_14_66,SERBIA,2100,5,marko simonovic,4,2,2,100,1,1,100,1,1,100,0,0,0,0,0,0,0,2,0,0,0,5
376667,422_14_66,SERBIA,25441,6,stefan jovic,20,1,1,100,1,1,100,0,0,0,0,0,0,0,1,1,1,3,1,1,0,2
376668,422_14_66,SERBIA,17361,7,bogdan bogdanovic,27,7,11,63.6,3,4,75,4,7,57.1,3,4,75,0,1,1,2,1,2,0,0,21
376669,422_14_66,SERBIA,15386,8,nemanja bjelica,31,3,6,50,3,6,50,0,0,0,2,2,100,2,8,10,2,4,0,2,0,8
376670,422_14_66,SERBIA,2654,9,stefan markovic,20,1,4,25,0,2,0,1,2,50,0,0,0,1,1,2,2,3,2,1,0,3
376671,422_14_66,SERBIA,19860,10,nikola kalinic,21,4,6,66.7,3,5,60,1,1,100,3,4,75,1,3,4,2,1,1,1,0,12
376672,422_14_66,SERBIA,15504,11,stefan bircevic,4,0,0,0,0,0,0,0,0,0,0,0,0,0,1,1,1,2,0,0,0,0
376673,422_14_66,SERBIA,93,12,nenad krstic,15,3,6,50,3,6,50,0,0,0,4,4,100,0,0,0,1,0,0,0,0,10
376674,422_14_66,SERBIA,2656,13,miroslav raduljica,25,7,12,58.3,7,12,58.3,0,0,0,2,3,66.7,1,5,6,1,4,1,0,0,16
376675,422_14_66,SERBIA,24202,14,rasko katic,0,0,0,0,0,0,0,0,0,0,0,0,0,0,0,0,0,0,0,0,0,0
376676,422_14_66,SERBIA,5756,15,vladimir stimac,1,0,1,0,0,1,0,0,0,0,0,0,0,0,0,0,0,0,0,0,0,0
376677,422_14_66,SERBIA,0,TOTALS,SERBIA,200,32,59,54.2,23,42,54.8,9,17,52.9,17,20,85,6,23,29,17,22,10,6,0,90
376678,422_14_66,GREECE,8303,4,vaggelis mantzaris,11,1,2,50,0,0,0,1,2,50,2,2,100,0,0,0,1,1,0,0,0,5
376679,422_14_66,GREECE,5050,5,giannis bourousis,29,3,6,50,2,4,50,1,2,50,2,2,100,1,4,5,2,5,3,2,0,9
376680,422_14_66,GREECE,123,6,nikos zisis,29,4,9,44.4,1,5,20,3,4,75,1,2,50,0,0,0,3,2,0,0,0,12
376681,422_14_66,GREECE,1053,7,kostas vasileiadis,17,1,3,33.3,0,0,0,1,3,33.3,3,4,75,0,0,0,2,2,0,0,0,6
376682,422_14_66,GREECE,12472,8,nick calathes,26,6,13,46.2,4,8,50,2,5,40,0,0,0,1,4,5,2,3,2,2,0,14
376683,422_14_66,GREECE,11632,9,andreas glyniadakis,0,0,0,0,0,0,0,0,0,0,0,0,0,0,0,0,0,0,0,0,0,0
376684,422_14_66,GREECE,10606,10,kostas papanikolaou,17,0,3,0,0,0,0,0,3,0,1,2,50,0,2,2,0,3,2,2,1,1
376685,422_14_66,GREECE,8304,11,kostas sloukas,7,0,2,0,0,1,0,0,1,0,0,0,0,1,0,1,0,0,0,0,0,0
376686,422_14_66,GREECE,15374,12,kostas kaimakoglou,23,2,4,50,2,2,100,0,2,0,2,2,100,1,5,6,1,0,2,0,0,6
376687,422_14_66,GREECE,24314,13,giannis antetokounmpo,14,3,3,100,2,2,100,1,1,100,0,0,0,0,2,2,0,4,4,0,1,7
376688,422_14_66,GREECE,1061,14,ian vougioukas,3,0,1,0,0,1,0,0,0,0,0,0,0,0,0,0,0,3,1,0,0,0
376689,422_14_66,GREECE,1056,15,georgios printezis,24,4,9,44.4,4,8,50,0,1,0,4,4,100,1,3,4,5,2,0,2,0,12
376690,422_14_66,GREECE,0,TOTALS,GREECE,200,24,55,43.6,15,31,48.4,9,24,37.5,15,18,83.3,6,23,29,16,25,14,8,2,72
376691,422_14_67,TURKEY,20219,4,cedi osman,5,0,0,0,0,0,0,0,0,0,0,0,0,0,0,0,0,0,0,0,0,0
376692,422_14_67,TURKEY,15304,5,sinan guler,35,7,13,53.8,7,12,58.3,0,1,0,2,2,100,0,4,4,2,2,3,1,0,16
376693,422_14_67,TURKEY,4571,6,baris ermis,1,0,0,0,0,0,0,0,0,0,0,0,0,1,0,1,0,0,0,0,0,0
376694,422_14_67,TURKEY,1798,7,cenk akyol,18,2,4,50,1,2,50,1,2,50,2,2,100,0,0,0,0,2,0,0,0,7
376695,422_14_67,TURKEY,2576,8,baris hersek,4,0,0,0,0,0,0,0,0,0,0,0,0,0,0,0,0,0,0,0,0,0
376696,422_14_67,TURKEY,7785,9,emir preldzic,33,5,14,35.7,2,7,28.6,3,7,42.9,3,4,75,2,5,7,2,1,2,2,0,16
376697,422_14_67,TURKEY,4569,10,kerem tunceri,14,2,4,50,0,1,0,2,3,66.7,0,0,0,0,1,1,3,2,0,0,0,6
376698,422_14_67,TURKEY,1796,11,oguz savas,7,0,4,0,0,4,0,0,0,0,1,2,50,1,1,2,0,1,1,2,1,1
376699,422_14_67,TURKEY,4576,12,kerem gonlum,26,2,5,40,2,5,40,0,0,0,0,0,0,0,6,6,0,3,1,0,0,4
376700,422_14_67,TURKEY,4572,13,ender arslan,25,4,12,33.3,1,3,33.3,3,9,33.3,0,1,0,1,1,2,2,3,0,0,0,11
376701,422_14_67,TURKEY,7790,14,omer asik,28,1,1,100,1,1,100,0,0,0,2,3,66.7,1,2,3,0,3,2,1,2,4
376702,422_14_67,TURKEY,10942,15,furkan aldemir,5,0,0,0,0,0,0,0,0,0,0,0,0,0,0,0,0,1,1,1,0,0
376703,422_14_67,TURKEY,0,TOTALS,TURKEY,200,23,57,40.4,14,35,40,9,22,40.9,10,14,71.4,7,23,30,9,19,10,7,3,65
376704,422_14_67,AUSTRALIA,9039,4,chris goulding,0,0,0,0,0,0,0,0,0,0,0,0,0,0,0,0,0,0,0,0,0,0
376705,422_14_67,AUSTRALIA,13813,5,ryan broekhoff,18,2,5,40,1,2,50,1,3,33.3,0,0,0,0,4,4,0,4,2,0,0,5
376706,422_14_67,AUSTRALIA,3458,6,adam gibson,6,0,1,0,0,0,0,0,1,0,0,0,0,0,0,0,0,1,1,0,0,0
376707,422_14_67,AUSTRALIA,11635,7,joe ingles,35,4,5,80,3,4,75,1,1,100,1,3,33.3,1,5,6,3,1,4,1,0,10
376708,422_14_67,AUSTRALIA,3466,8,brad newley,22,1,7,14.3,1,4,25,0,3,0,1,5,20,1,1,2,1,1,1,1,0,3
376709,422_14_67,AUSTRALIA,13811,9,matthew dellavedova,29,4,9,44.4,2,3,66.7,2,6,33.3,3,4,75,0,3,3,5,1,2,0,0,13
376710,422_14_67,AUSTRALIA,25376,10,cameron bairstow,19,3,6,50,3,6,50,0,0,0,4,4,100,3,2,5,2,0,0,1,0,10
376711,422_14_67,AUSTRALIA,20984,11,dante exum,10,0,1,0,0,0,0,0,1,0,0,0,0,0,2,2,0,2,0,0,0,0
376712,422_14_67,AUSTRALIA,16519,12,aron baynes,31,7,15,46.7,7,15,46.7,0,0,0,1,3,33.3,3,4,7,2,3,1,0,2,15
376713,422_14_67,AUSTRALIA,142,13,david andersen,24,3,7,42.9,3,7,42.9,0,0,0,0,0,0,1,5,6,2,5,3,0,0,6
376714,422_14_67,AUSTRALIA,13814,14,brock motum,2,1,1,100,1,1,100,0,0,0,0,0,0,1,1,2,0,1,0,0,0,2
376715,422_14_67,AUSTRALIA,3457,15,nate jawai,4,0,1,0,0,1,0,0,0,0,0,0,0,0,1,1,0,3,0,0,0,0
376716,422_14_67,AUSTRALIA,0,TOTALS,AUSTRALIA,200,25,58,43.1,21,43,48.8,4,15,26.7,10,19,52.6,13,31,44,15,22,16,3,2,64
376717,422_14_68,BRAZIL,332,4,marcelo machado,0,0,0,0,0,0,0,0,0,0,0,0,0,0,0,0,0,0,0,0,0,0
376718,422_14_68,BRAZIL,14848,5,raulzinho neto,24,9,10,90,8,9,88.9,1,1,100,2,2,100,0,1,1,2,3,0,1,0,21
376719,422_14_68,BRAZIL,23752,6,rafael hettsheimeir,0,0,0,0,0,0,0,0,0,0,0,0,0,0,0,0,0,0,0,0,0,0
376720,422_14_68,BRAZIL,21034,7,larry taylor,8,1,3,33.3,1,1,100,0,2,0,2,2,100,0,1,1,0,0,0,0,0,4
376721,422_14_68,BRAZIL,4102,8,alex garcia,15,2,3,66.7,1,1,100,1,2,50,0,0,0,0,1,1,2,3,1,0,0,5
376722,422_14_68,BRAZIL,4098,9,marcelinho huertas,15,0,4,0,0,1,0,0,3,0,0,0,0,0,1,1,0,3,1,0,0,0
376723,422_14_68,BRAZIL,4100,10,leandrinho barbosa,26,4,11,36.4,4,8,50,0,3,0,2,2,100,0,2,2,0,3,2,1,0,10
376724,422_14_68,BRAZIL,4103,11,anderson varejao,32,3,7,42.9,3,7,42.9,0,0,0,2,3,66.7,5,4,9,4,2,1,1,0,8
376725,422_14_68,BRAZIL,4104,12,guilherme giovannoni,8,2,3,66.7,0,0,0,2,3,66.7,1,1,100,0,1,1,0,1,0,0,0,7
376726,422_14_68,BRAZIL,9844,13,nene hilario,20,3,4,75,3,4,75,0,0,0,1,2,50,0,4,4,4,3,0,1,2,7
376727,422_14_68,BRAZIL,19020,14,marquinhos vieira,32,4,10,40,3,5,60,1,5,20,4,5,80,0,8,8,1,2,2,0,0,13
376728,422_14_68,BRAZIL,4106,15,tiago splitter,20,4,5,80,4,5,80,0,0,0,2,4,50,3,5,8,3,2,1,1,0,10
376729,422_14_68,BRAZIL,0,TOTALS,BRAZIL,200,32,60,53.3,27,41,65.9,5,19,26.3,16,21,76.2,9,30,39,16,22,8,5,2,85
376730,422_14_68,ARGENTINA,80,4,luis scola,34,2,10,20,2,10,20,0,0,0,5,10,50,1,6,7,3,4,3,0,0,9
376731,422_14_68,ARGENTINA,16652,5,tayavek gallizzi,0,0,0,0,0,0,0,0,0,0,0,0,0,0,0,0,0,0,0,0,0,0
376732,422_14_68,ARGENTINA,12069,6,marcos mata,14,0,1,0,0,0,0,0,1,0,0,0,0,1,2,3,0,2,1,0,0,0
376733,422_14_68,ARGENTINA,21037,7,facundo campazzo,29,4,12,33.3,2,5,40,2,7,28.6,1,2,50,0,1,1,1,2,0,0,0,11
376734,422_14_68,ARGENTINA,357,8,pablo prigioni,28,6,7,85.7,3,3,100,3,4,75,3,4,75,2,2,4,3,4,3,0,0,18
376735,422_14_68,ARGENTINA,12228,9,nicolas laprovittola,7,0,1,0,0,1,0,0,0,0,0,0,0,0,1,1,0,1,0,0,0,0
376736,422_14_68,ARGENTINA,81,10,leo gutierrez,23,2,7,28.6,0,0,0,2,7,28.6,0,0,0,0,3,3,2,3,1,1,0,6
376737,422_14_68,ARGENTINA,14903,11,marcos delia,6,1,1,100,1,1,100,0,0,0,0,0,0,0,1,1,0,0,0,1,0,2
376738,422_14_68,ARGENTINA,77,12,walter herrmann,18,1,3,33.3,0,1,0,1,2,50,2,2,100,0,1,1,0,0,0,0,0,5
376739,422_14_68,ARGENTINA,82,13,andres nocioni,25,2,8,25,2,4,50,0,4,0,0,0,0,0,4,4,1,4,1,1,0,4
376740,422_14_68,ARGENTINA,12297,14,matias bortolin,0,0,0,0,0,0,0,0,0,0,0,0,0,0,0,0,0,0,0,0,0,0
376741,422_14_68,ARGENTINA,21197,15,selem safar,16,4,6,66.7,2,2,100,2,4,50,0,0,0,0,0,0,0,2,0,0,0,10
376742,422_14_68,ARGENTINA,0,TOTALS,ARGENTINA,200,22,56,39.3,12,27,44.4,10,29,34.5,11,18,61.1,4,22,26,10,22,10,3,0,65
376743,422_14_69,LITHUANIA,1728,4,martynas pocius,24,4,8,50,1,3,33.3,3,5,60,2,2,100,0,1,1,3,1,0,2,0,13
376744,422_14_69,LITHUANIA,6225,5,adas juskevicius,17,1,5,20,1,3,33.3,0,2,0,1,2,50,0,2,2,0,1,2,0,0,3
376745,422_14_69,LITHUANIA,10639,6,mindaugas kuzminskas,0,0,0,0,0,0,0,0,0,0,0,0,0,0,0,0,0,0,0,0,0,0
376746,422_14_69,LITHUANIA,5073,7,darjus lavrinovic,18,4,7,57.1,1,3,33.3,3,4,75,0,0,0,1,4,5,1,4,1,0,1,11
376747,422_14_69,LITHUANIA,980,8,jonas maciulis,36,4,5,80,3,4,75,1,1,100,0,1,0,1,1,2,2,3,3,1,0,9
376748,422_14_69,LITHUANIA,3474,9,renaldas seibutis,37,6,10,60,3,7,42.9,3,3,100,4,4,100,0,1,1,3,3,1,0,0,19
376749,422_14_69,LITHUANIA,292,10,simas jasaitis,4,1,2,50,1,1,100,0,1,0,0,0,0,0,1,1,0,2,1,0,0,2
376750,422_14_69,LITHUANIA,8177,11,donatas motiejunas,16,1,5,20,1,4,25,0,1,0,0,0,0,2,1,3,1,1,1,0,1,2
376751,422_14_69,LITHUANIA,21,12,ksistof lavrinovic,10,0,2,0,0,1,0,0,1,0,0,0,0,0,1,1,2,1,0,0,2,0
376752,422_14_69,LITHUANIA,987,13,paulius jankunas,8,1,3,33.3,1,3,33.3,0,0,0,0,0,0,0,1,1,0,1,2,0,0,2
376753,422_14_69,LITHUANIA,10916,14,jonas valanciunas,27,5,9,55.6,5,9,55.6,0,0,0,2,2,100,3,10,13,1,2,2,0,1,12
376754,422_14_69,LITHUANIA,6221,15,sarunas vasiliauskas,3,0,2,0,0,1,0,0,1,0,0,0,0,0,1,1,0,1,0,0,0,0
376755,422_14_69,LITHUANIA,0,TOTALS,LITHUANIA,200,27,58,46.6,17,39,43.6,10,19,52.6,9,11,81.8,9,27,36,13,20,15,3,5,73
376756,422_14_69,TURKEY,20219,4,cedi osman,7,1,2,50,1,1,100,0,1,0,0,0,0,0,2,2,0,2,2,1,1,2
376757,422_14_69,TURKEY,15304,5,sinan guler,36,4,6,66.7,3,3,100,1,3,33.3,0,0,0,0,1,1,3,3,1,1,0,9
376758,422_14_69,TURKEY,4571,6,baris ermis,0,0,0,0,0,0,0,0,0,0,0,0,0,0,0,0,0,0,0,0,0,0
376759,422_14_69,TURKEY,1798,7,cenk akyol,8,0,4,0,0,1,0,0,3,0,0,0,0,0,1,1,0,1,0,0,0,0
376760,422_14_69,TURKEY,2576,8,baris hersek,6,0,1,0,0,0,0,0,1,0,0,0,0,0,0,0,0,0,1,0,0,0
376761,422_14_69,TURKEY,7785,9,emir preldzic,37,3,12,25,3,8,37.5,0,4,0,4,6,66.7,0,4,4,5,3,3,3,1,10
376762,422_14_69,TURKEY,4569,10,kerem tunceri,12,0,1,0,0,1,0,0,0,0,0,0,0,0,1,1,0,1,1,0,0,0
376763,422_14_69,TURKEY,1796,11,oguz savas,6,2,3,66.7,2,3,66.7,0,0,0,0,0,0,0,0,0,0,2,1,0,0,4
376764,422_14_69,TURKEY,4576,12,kerem gonlum,33,6,12,50,6,12,50,0,0,0,1,1,100,4,5,9,2,3,0,0,1,13
376765,422_14_69,TURKEY,4572,13,ender arslan,25,2,6,33.3,0,0,0,2,6,33.3,6,8,75,0,0,0,1,2,1,2,0,12
376766,422_14_69,TURKEY,7790,14,omer asik,28,5,10,50,5,10,50,0,0,0,1,2,50,3,7,10,2,4,1,1,2,11
376767,422_14_69,TURKEY,10942,15,furkan aldemir,3,0,1,0,0,1,0,0,0,0,0,0,0,0,0,0,0,0,0,0,0,0
376768,422_14_69,TURKEY,0,TOTALS,TURKEY,200,23,58,39.7,20,40,50,3,18,16.7,12,17,70.6,10,22,32,13,21,11,8,5,61
376769,422_14_70,SLOVENIA,24203,4,jure balazic,31,3,8,37.5,2,3,66.7,1,5,20,2,4,50,1,5,6,1,2,2,0,2,9
376770,422_14_70,SLOVENIA,5023,5,uros slokar,14,3,5,60,2,4,50,1,1,100,0,0,0,1,1,2,1,3,3,0,0,7
376771,422_14_70,SLOVENIA,17812,6,aleksej nikolic,4,0,1,0,0,0,0,0,1,0,0,0,0,0,0,0,0,1,0,0,0,0
376772,422_14_70,SLOVENIA,17343,7,klemen prepelic,13,2,2,100,1,1,100,1,1,100,4,4,100,1,0,1,1,2,2,0,0,9
376773,422_14_70,SLOVENIA,10978,8,edo muric,10,2,3,66.7,2,3,66.7,0,0,0,2,2,100,0,0,0,0,2,1,0,1,6
376774,422_14_70,SLOVENIA,15479,9,jaka blazic,1,0,0,0,0,0,0,0,0,0,0,0,0,0,0,0,0,0,2,0,0,0
376775,422_14_70,SLOVENIA,4764,10,miha zupan,16,1,5,20,1,3,33.3,0,2,0,0,2,0,1,0,1,1,4,2,0,0,2
376776,422_14_70,SLOVENIA,1068,11,goran dragic,29,6,15,40,5,10,50,1,5,20,0,0,0,1,3,4,4,4,4,0,0,13
376777,422_14_70,SLOVENIA,6197,12,zoran dragic,28,4,12,33.3,2,6,33.3,2,6,33.3,1,2,50,0,5,5,0,2,2,0,2,11
376778,422_14_70,SLOVENIA,1064,13,domen lorbek,24,5,8,62.5,4,4,100,1,4,25,1,3,33.3,0,6,6,2,2,3,0,0,12
376779,422_14_70,SLOVENIA,5782,14,jaka klobucar,12,1,4,25,0,2,0,1,2,50,0,0,0,0,1,1,2,1,2,1,0,3
376780,422_14_70,SLOVENIA,17344,15,alen omic,18,2,3,66.7,2,3,66.7,0,0,0,0,0,0,1,2,3,0,3,1,0,0,4
376781,422_14_70,SLOVENIA,0,TOTALS,SLOVENIA,200,29,66,43.9,21,39,53.8,8,27,29.6,10,17,58.8,12,26,38,12,26,25,1,5,76
376782,422_14_70,USA,9010,4,stephen curry,17,2,9,22.2,2,6,33.3,0,3,0,2,2,100,0,1,1,2,3,0,1,0,6
376783,422_14_70,USA,13751,5,klay thompson,28,7,12,58.3,3,4,75,4,8,50,2,4,50,1,2,3,2,3,0,2,1,20
376784,422_14_70,USA,16600,6,derrick rose,18,6,10,60,6,8,75,0,2,0,0,0,0,3,0,3,5,1,2,1,0,12
376785,422_14_70,USA,25451,7,kenneth faried,20,5,9,55.6,5,9,55.6,0,0,0,4,5,80,4,6,10,1,1,0,0,0,14
376786,422_14_70,USA,3452,8,rudy gay,14,2,3,66.7,0,0,0,2,3,66.7,1,2,50,0,4,4,2,2,1,0,0,7
376787,422_14_70,USA,25452,9,demar derozan,9,3,3,100,3,3,100,0,0,0,0,0,0,0,2,2,0,2,1,0,0,6
376788,422_14_70,USA,16977,10,kyrie irving,22,5,9,55.6,4,8,50,1,1,100,1,1,100,2,2,4,3,1,0,4,0,12
376789,422_14_70,USA,12194,11,mason plumlee,6,2,3,66.7,2,3,66.7,0,0,0,0,1,0,1,1,2,1,0,1,0,0,4
376790,422_14_70,USA,25453,12,demarcus cousins,13,4,5,80,4,5,80,0,0,0,1,3,33.3,3,2,5,1,5,2,3,1,9
376791,422_14_70,USA,21035,13,james harden,26,4,14,28.6,2,12,16.7,2,2,100,4,5,80,1,4,5,3,2,2,1,0,14
376792,422_14_70,USA,21036,14,anthony davis,21,5,11,45.5,5,11,45.5,0,0,0,3,4,75,6,5,11,1,2,2,0,3,13
376793,422_14_70,USA,14750,15,andre drummond,6,1,4,25,1,4,25,0,0,0,0,0,0,1,0,1,0,0,0,0,2,2
376794,422_14_70,USA,0,TOTALS,USA,200,46,92,50,37,73,50.7,9,19,47.4,18,27,66.7,24,30,54,21,22,11,12,7,119
376795,422_14_71,SERBIA,5751,4,milos teodosic,29,5,9,55.6,2,4,50,3,5,60,10,10,100,0,3,3,4,3,2,1,0,23
376796,422_14_71,SERBIA,2100,5,marko simonovic,4,0,0,0,0,0,0,0,0,0,0,0,0,0,0,0,0,0,0,0,0,0
376797,422_14_71,SERBIA,25441,6,stefan jovic,10,0,2,0,0,0,0,0,2,0,0,0,0,1,2,3,3,0,1,0,0,0
376798,422_14_71,SERBIA,17361,7,bogdan bogdanovic,26,5,9,55.6,3,4,75,2,5,40,0,0,0,0,6,6,2,3,1,0,2,12
376799,422_14_71,SERBIA,15386,8,nemanja bjelica,30,3,10,30,2,6,33.3,1,4,25,1,2,50,0,8,8,5,2,1,0,1,8
376800,422_14_71,SERBIA,2654,9,stefan markovic,29,4,8,50,3,5,60,1,3,33.3,0,0,0,1,2,3,1,4,0,1,0,9
376801,422_14_71,SERBIA,19860,10,nikola kalinic,22,2,2,100,1,1,100,1,1,100,0,0,0,0,2,2,1,2,1,1,1,5
376802,422_14_71,SERBIA,15504,11,stefan bircevic,9,1,3,33.3,0,0,0,1,3,33.3,0,0,0,0,1,1,0,3,0,0,0,3
376803,422_14_71,SERBIA,93,12,nenad krstic,16,5,7,71.4,5,7,71.4,0,0,0,0,0,0,0,1,1,2,1,0,0,1,10
376804,422_14_71,SERBIA,2656,13,miroslav raduljica,20,4,6,66.7,4,6,66.7,0,0,0,2,4,50,1,3,4,1,3,0,0,0,10
376805,422_14_71,SERBIA,24202,14,rasko katic,2,0,1,0,0,1,0,0,0,0,0,0,0,0,0,0,0,0,0,0,0,0
376806,422_14_71,SERBIA,5756,15,vladimir stimac,4,2,5,40,2,3,66.7,0,2,0,0,0,0,1,0,1,0,0,0,0,0,4
376807,422_14_71,SERBIA,0,TOTALS,SERBIA,200,31,62,50,22,37,59.5,9,25,36,13,16,81.2,6,31,37,19,21,6,3,5,84
376808,422_14_71,BRAZIL,332,4,marcelo machado,8,0,4,0,0,3,0,0,1,0,0,0,0,0,2,2,0,1,0,0,0,0
376809,422_14_71,BRAZIL,14848,5,raulzinho neto,16,2,5,40,1,3,33.3,1,2,50,1,2,50,0,5,5,1,0,0,1,0,6
376810,422_14_71,BRAZIL,23752,6,rafael hettsheimeir,11,1,4,25,1,3,33.3,0,1,0,0,2,0,2,0,2,0,1,1,0,0,2
376811,422_14_71,BRAZIL,21034,7,larry taylor,9,0,0,0,0,0,0,0,0,0,0,2,0,1,1,2,0,1,1,0,0,0
376812,422_14_71,BRAZIL,4102,8,alex garcia,21,3,7,42.9,1,3,33.3,2,4,50,0,0,0,0,2,2,1,4,0,1,0,8
376813,422_14_71,BRAZIL,4098,9,marcelinho huertas,24,2,5,40,2,4,50,0,1,0,0,0,0,1,1,2,9,0,2,0,0,4
376814,422_14_71,BRAZIL,4100,10,leandrinho barbosa,26,2,6,33.3,2,4,50,0,2,0,1,2,50,0,0,0,0,2,0,0,0,5
376815,422_14_71,BRAZIL,4103,11,anderson varejao,26,4,10,40,4,10,40,0,0,0,4,5,80,3,6,9,0,3,1,1,1,12
376816,422_14_71,BRAZIL,4104,12,guilherme giovannoni,3,0,1,0,0,0,0,0,1,0,0,0,0,0,0,0,0,0,0,0,0,0
376817,422_14_71,BRAZIL,9844,13,nene hilario,19,2,8,25,2,8,25,0,0,0,0,0,0,1,3,4,0,1,0,0,2,4
376818,422_14_71,BRAZIL,19020,14,marquinhos vieira,20,5,8,62.5,3,5,60,2,3,66.7,0,0,0,0,1,1,0,3,1,0,0,12
376819,422_14_71,BRAZIL,4106,15,tiago splitter,17,1,7,14.3,1,7,14.3,0,0,0,1,2,50,4,4,8,2,2,1,1,0,3
376820,422_14_71,BRAZIL,0,TOTALS,BRAZIL,200,22,65,33.8,17,50,34,5,15,33.3,7,15,46.7,14,26,40,13,18,7,4,3,56
376821,422_14_72,FRANCE,12495,4,thomas heurtel,23,4,7,57.1,3,4,75,1,3,33.3,4,4,100,0,3,3,4,2,1,0,0,13
376822,422_14_72,FRANCE,2588,5,nicolas batum,32,2,8,25,2,4,50,0,4,0,5,6,83.3,2,2,4,1,3,1,0,1,9
376823,422_14_72,FRANCE,2589,6,antoine diot,23,2,7,28.6,2,6,33.3,0,1,0,0,0,0,1,1,2,4,2,0,2,0,4
376824,422_14_72,FRANCE,11076,7,joffrey lauvergne,17,1,3,33.3,0,2,0,1,1,100,1,2,50,3,7,10,0,1,1,0,0,4
376825,422_14_72,FRANCE,1864,8,charles kahudi,0,0,0,0,0,0,0,0,0,0,0,0,0,0,0,0,0,0,0,0,0,0
376826,422_14_72,FRANCE,6249,9,edwin jackson,3,0,1,0,0,1,0,0,0,0,0,0,0,0,1,1,0,1,0,0,0,0
376827,422_14_72,FRANCE,12971,10,evan fournier,17,1,6,16.7,1,2,50,0,4,0,2,2,100,0,2,2,2,1,0,0,0,4
376828,422_14_72,FRANCE,4663,11,florent pietrus,10,1,2,50,1,2,50,0,0,0,0,0,0,1,0,1,0,2,1,0,0,2
376829,422_14_72,FRANCE,17374,12,rudy gobert,23,2,4,50,2,4,50,0,0,0,1,2,50,4,9,13,0,4,2,1,1,5
376830,422_14_72,FRANCE,4665,13,boris diaw,30,6,12,50,3,5,60,3,7,42.9,0,2,0,2,3,5,3,2,4,1,0,15
376831,422_14_72,FRANCE,7987,14,kim tillie,0,0,0,0,0,0,0,0,0,0,0,0,0,0,0,0,0,0,0,0,0,0
376832,422_14_72,FRANCE,5044,15,mickael gelabale,22,3,6,50,2,2,100,1,4,25,2,2,100,0,3,3,0,4,3,0,0,9
376833,422_14_72,FRANCE,0,TOTALS,FRANCE,200,22,56,39.3,16,32,50,6,24,25,15,20,75,16,34,50,14,22,16,4,2,65
376834,422_14_72,SPAIN,61,4,pau gasol,32,7,12,58.3,7,11,63.6,0,1,0,3,3,100,2,6,8,1,5,3,1,3,17
376835,422_14_72,SPAIN,70,5,rudy fernandez,25,2,6,33.3,2,3,66.7,0,3,0,2,2,100,1,0,1,3,0,0,1,0,6
376836,422_14_72,SPAIN,1877,6,sergio rodriguez,13,0,3,0,0,0,0,0,3,0,0,0,0,0,0,0,2,1,1,0,0,0
376837,422_14_72,SPAIN,64,7,juan c. navarro,26,4,11,36.4,3,6,50,1,5,20,1,2,50,1,0,1,1,2,1,0,0,10
376838,422_14_72,SPAIN,65,8,jose calderon,14,2,4,50,1,1,100,1,3,33.3,0,0,0,0,1,1,1,1,1,0,0,5
376839,422_14_72,SPAIN,66,9,felipe reyes,0,0,0,0,0,0,0,0,0,0,0,0,0,0,0,0,0,0,0,0,0,0
376840,422_14_72,SPAIN,2628,10,victor claver,0,0,0,0,0,0,0,0,0,0,0,0,0,0,0,0,0,0,0,0,0,0
376841,422_14_72,SPAIN,6259,11,ricky rubio,27,1,7,14.3,1,6,16.7,0,1,0,2,2,100,1,1,2,1,4,1,3,0,4
376842,422_14_72,SPAIN,1871,12,sergio llull,15,2,5,40,2,2,100,0,3,0,1,2,50,0,0,0,0,1,1,0,0,5
376843,422_14_72,SPAIN,1108,13,marc gasol,30,1,7,14.3,1,7,14.3,0,0,0,1,2,50,0,4,4,0,3,0,0,1,3
376844,422_14_72,SPAIN,7001,14,serge ibaka,19,1,7,14.3,1,4,25,0,3,0,0,0,0,1,1,2,0,1,0,0,1,2
376845,422_14_72,SPAIN,19988,15,alex abrines,0,0,0,0,0,0,0,0,0,0,0,0,0,0,0,0,0,0,0,0,0,0
376846,422_14_72,SPAIN,0,TOTALS,SPAIN,200,20,62,32.3,18,40,45,2,22,9.1,10,13,76.9,8,20,28,9,18,8,5,5,52
376847,422_14_73,USA,9010,4,stephen curry,15,4,8,50,1,2,50,3,6,50,2,2,100,0,3,3,1,4,1,0,0,13
376848,422_14_73,USA,13751,5,klay thompson,26,7,12,58.3,5,7,71.4,2,5,40,0,0,0,0,3,3,3,3,1,1,2,16
376849,422_14_73,USA,16600,6,derrick rose,15,1,8,12.5,1,4,25,0,4,0,2,2,100,0,1,1,1,0,3,1,0,4
376850,422_14_73,USA,25451,7,kenneth faried,24,3,8,37.5,3,8,37.5,0,0,0,3,5,60,3,3,6,3,2,1,1,0,9
376851,422_14_73,USA,3452,8,rudy gay,13,1,2,50,1,2,50,0,0,0,1,1,100,1,6,7,0,1,1,1,0,3
376852,422_14_73,USA,25452,9,demar derozan,8,0,1,0,0,1,0,0,0,0,0,0,0,0,0,0,1,1,0,0,0,0
376853,422_14_73,USA,16977,10,kyrie irving,34,8,15,53.3,6,10,60,2,5,40,0,0,0,1,0,1,4,1,2,2,0,18
376854,422_14_73,USA,12194,11,mason plumlee,7,1,2,50,1,2,50,0,0,0,0,2,0,2,2,4,0,1,1,0,0,2
376855,422_14_73,USA,25453,12,demarcus cousins,13,3,5,60,3,5,60,0,0,0,1,2,50,2,4,6,0,5,2,0,0,7
376856,422_14_73,USA,21035,13,james harden,23,6,11,54.5,4,7,57.1,2,4,50,2,2,100,1,1,2,0,2,1,3,0,16
376857,422_14_73,USA,21036,14,anthony davis,19,4,7,57.1,4,7,57.1,0,0,0,0,0,0,2,4,6,1,5,2,0,2,8
376858,422_14_73,USA,14750,15,andre drummond,3,0,1,0,0,1,0,0,0,0,0,4,0,2,2,4,0,2,0,0,0,0
376859,422_14_73,USA,0,TOTALS,USA,200,38,80,47.5,29,56,51.8,9,24,37.5,11,20,55,18,32,50,14,27,16,9,4,96
376860,422_14_73,LITHUANIA,1728,4,martynas pocius,25,4,7,57.1,3,5,60,1,2,50,1,2,50,0,2,2,1,2,1,0,0,10
376861,422_14_73,LITHUANIA,6225,5,adas juskevicius,26,1,8,12.5,1,4,25,0,4,0,10,10,100,1,0,1,2,1,3,1,0,12
376862,422_14_73,LITHUANIA,10639,6,mindaugas kuzminskas,27,6,9,66.7,6,8,75,0,1,0,3,6,50,3,6,9,1,0,1,0,2,15
376863,422_14_73,LITHUANIA,5073,7,darjus lavrinovic,17,2,7,28.6,1,3,33.3,1,4,25,4,5,80,0,2,2,0,1,3,0,2,9
376864,422_14_73,LITHUANIA,980,8,jonas maciulis,13,1,6,16.7,1,4,25,0,2,0,0,0,0,0,2,2,0,1,3,1,0,2
376865,422_14_73,LITHUANIA,3474,9,renaldas seibutis,18,0,2,0,0,2,0,0,0,0,3,4,75,2,0,2,2,3,2,1,0,3
376866,422_14_73,LITHUANIA,292,10,simas jasaitis,4,0,0,0,0,0,0,0,0,0,0,0,0,0,0,0,0,0,1,0,0,0
376867,422_14_73,LITHUANIA,8177,11,donatas motiejunas,17,1,5,20,1,3,33.3,0,2,0,0,2,0,0,3,3,0,4,1,1,2,2
376868,422_14_73,LITHUANIA,21,12,ksistof lavrinovic,13,0,3,0,0,1,0,0,2,0,0,0,0,1,2,3,1,3,2,0,0,0
376869,422_14_73,LITHUANIA,987,13,paulius jankunas,6,0,2,0,0,2,0,0,0,0,0,0,0,1,1,2,1,0,1,0,0,0
376870,422_14_73,LITHUANIA,10916,14,jonas valanciunas,28,2,5,40,2,5,40,0,0,0,11,13,84.6,0,7,7,0,2,0,1,0,15
376871,422_14_73,LITHUANIA,6221,15,sarunas vasiliauskas,8,0,2,0,0,1,0,0,1,0,0,0,0,1,0,1,2,2,3,0,0,0
376872,422_14_73,LITHUANIA,0,TOTALS,LITHUANIA,200,17,56,30.4,15,38,39.5,2,18,11.1,32,42,76.2,10,28,38,10,20,21,5,6,68
376873,422_14_74,FRANCE,12495,4,thomas heurtel,25,3,9,33.3,2,5,40,1,4,25,5,6,83.3,0,2,2,6,1,3,0,0,12
376874,422_14_74,FRANCE,2588,5,nicolas batum,37,11,17,64.7,3,5,60,8,12,66.7,5,6,83.3,1,1,2,3,1,2,1,0,35
376875,422_14_74,FRANCE,2589,6,antoine diot,16,1,5,20,1,3,33.3,0,2,0,0,0,0,1,0,1,1,2,0,2,0,2
376876,422_14_74,FRANCE,11076,7,joffrey lauvergne,8,2,4,50,2,4,50,0,0,0,0,0,0,1,1,2,0,1,0,0,0,4
376877,422_14_74,FRANCE,1864,8,charles kahudi,0,0,0,0,0,0,0,0,0,0,0,0,0,0,0,0,0,0,0,0,0,0
376878,422_14_74,FRANCE,6249,9,edwin jackson,9,1,5,20,0,2,0,1,3,33.3,0,0,0,0,0,0,0,0,0,0,0,3
376879,422_14_74,FRANCE,12971,10,evan fournier,14,3,6,50,1,2,50,2,4,50,2,2,100,1,1,2,1,1,3,1,0,10
376880,422_14_74,FRANCE,4663,11,florent pietrus,13,0,1,0,0,0,0,0,1,0,0,0,0,1,1,2,0,4,0,1,0,0
376881,422_14_74,FRANCE,17374,12,rudy gobert,23,2,2,100,2,2,100,0,0,0,0,0,0,0,5,5,0,3,1,1,2,4
376882,422_14_74,FRANCE,4665,13,boris diaw,32,5,9,55.6,2,4,50,3,5,60,0,0,0,2,8,10,5,4,3,0,0,13
376883,422_14_74,FRANCE,7987,14,kim tillie,0,0,0,0,0,0,0,0,0,0,0,0,0,0,0,0,0,0,0,0,0,0
376884,422_14_74,FRANCE,5044,15,mickael gelabale,23,1,5,20,1,3,33.3,0,2,0,0,0,0,0,2,2,1,3,0,0,0,2
376885,422_14_74,FRANCE,0,TOTALS,FRANCE,200,29,63,46,14,30,46.7,15,33,45.5,12,14,85.7,9,23,32,17,20,12,6,2,85
376886,422_14_74,SERBIA,5751,4,milos teodosic,33,9,12,75,4,5,80,5,7,71.4,1,2,50,0,3,3,3,3,2,1,0,24
376887,422_14_74,SERBIA,2100,5,marko simonovic,0,0,0,0,0,0,0,0,0,0,2,2,100,0,0,0,0,0,0,0,0,2
376888,422_14_74,SERBIA,25441,6,stefan jovic,13,0,1,0,0,1,0,0,0,0,0,0,0,0,3,3,1,0,0,1,0,0
376889,422_14_74,SERBIA,17361,7,bogdan bogdanovic,28,4,5,80,2,2,100,2,3,66.7,3,4,75,0,1,1,4,2,1,1,0,13
376890,422_14_74,SERBIA,15386,8,nemanja bjelica,36,3,8,37.5,3,5,60,0,3,0,4,4,100,1,6,7,5,3,0,0,1,10
376891,422_14_74,SERBIA,2654,9,stefan markovic,26,5,9,55.6,4,7,57.1,1,2,50,0,1,0,0,3,3,5,5,1,2,0,11
376892,422_14_74,SERBIA,19860,10,nikola kalinic,23,3,5,60,3,5,60,0,0,0,2,4,50,0,2,2,1,2,3,1,0,8
376893,422_14_74,SERBIA,15504,11,stefan bircevic,2,0,0,0,0,0,0,0,0,0,0,0,0,0,0,0,0,1,0,0,0,0
376894,422_14_74,SERBIA,93,12,nenad krstic,16,4,9,44.4,4,9,44.4,0,0,0,3,4,75,0,3,3,0,0,0,0,0,11
376895,422_14_74,SERBIA,2656,13,miroslav raduljica,23,4,7,57.1,4,7,57.1,0,0,0,3,4,75,1,3,4,0,2,1,0,1,11
376896,422_14_74,SERBIA,24202,14,rasko katic,0,0,0,0,0,0,0,0,0,0,0,0,0,0,0,0,0,0,0,0,0,0
376897,422_14_74,SERBIA,5756,15,vladimir stimac,0,0,0,0,0,0,0,0,0,0,0,0,0,0,0,0,0,0,0,0,0,0
376898,422_14_74,SERBIA,0,TOTALS,SERBIA,200,32,56,57.1,24,41,58.5,8,15,53.3,18,25,72,3,25,28,19,18,9,6,2,90
376899,422_14_75,LITHUANIA,1728,4,martynas pocius,24,4,8,50,2,3,66.7,2,5,40,1,2,50,1,3,4,3,5,1,0,0,11
376900,422_14_75,LITHUANIA,6225,5,adas juskevicius,20,4,8,50,3,6,50,1,2,50,5,5,100,1,0,1,1,5,1,1,1,14
376901,422_14_75,LITHUANIA,10639,6,mindaugas kuzminskas,7,0,1,0,0,1,0,0,0,0,0,0,0,2,0,2,0,1,0,0,0,0
376902,422_14_75,LITHUANIA,5073,7,darjus lavrinovic,14,2,4,50,1,3,33.3,1,1,100,0,0,0,1,0,1,0,2,1,0,0,5
376903,422_14_75,LITHUANIA,980,8,jonas maciulis,29,4,10,40,4,7,57.1,0,3,0,3,4,75,1,4,5,1,4,1,2,0,11
376904,422_14_75,LITHUANIA,3474,9,renaldas seibutis,33,4,9,44.4,3,7,42.9,1,2,50,4,4,100,0,2,2,4,2,2,0,0,13
376905,422_14_75,LITHUANIA,292,10,simas jasaitis,7,0,0,0,0,0,0,0,0,0,1,2,50,0,1,1,0,1,0,0,0,1
376906,422_14_75,LITHUANIA,8177,11,donatas motiejunas,9,1,6,16.7,0,4,0,1,2,50,0,0,0,3,0,3,0,2,0,0,0,3
376907,422_14_75,LITHUANIA,21,12,ksistof lavrinovic,0,0,0,0,0,0,0,0,0,0,0,0,0,0,0,0,0,0,0,0,0,0
376908,422_14_75,LITHUANIA,987,13,paulius jankunas,22,4,9,44.4,3,7,42.9,1,2,50,1,1,100,2,2,4,3,4,0,0,0,10
376909,422_14_75,LITHUANIA,10916,14,jonas valanciunas,35,8,12,66.7,8,12,66.7,0,0,0,9,10,90,1,8,9,0,2,0,0,0,25
376910,422_14_75,LITHUANIA,6221,15,sarunas vasiliauskas,0,0,0,0,0,0,0,0,0,0,0,0,0,0,0,0,0,0,0,0,0,0
376911,422_14_75,LITHUANIA,0,TOTALS,LITHUANIA,200,31,67,46.3,24,50,48,7,17,41.2,24,28,85.7,15,21,36,12,28,7,3,1,93
376912,422_14_75,FRANCE,12495,4,thomas heurtel,20,3,5,60,2,4,50,1,1,100,6,8,75,0,3,3,1,4,0,0,0,13
376913,422_14_75,FRANCE,2588,5,nicolas batum,34,8,12,66.7,6,7,85.7,2,5,40,9,11,81.8,2,1,3,1,2,2,3,0,27
376914,422_14_75,FRANCE,2589,6,antoine diot,25,3,5,60,1,2,50,2,3,66.7,0,0,0,0,0,0,1,2,0,0,1,8
376915,422_14_75,FRANCE,11076,7,joffrey lauvergne,23,6,10,60,5,7,71.4,1,3,33.3,0,0,0,0,9,9,1,3,0,1,0,13
376916,422_14_75,FRANCE,1864,8,charles kahudi,0,0,0,0,0,0,0,0,0,0,0,0,0,0,0,0,0,0,0,0,0,0
376917,422_14_75,FRANCE,6249,9,edwin jackson,6,1,2,50,0,0,0,1,2,50,0,0,0,0,0,0,0,0,0,0,0,3
376918,422_14_75,FRANCE,12971,10,evan fournier,16,0,4,0,0,3,0,0,1,0,4,4,100,1,1,2,1,2,0,0,0,4
376919,422_14_75,FRANCE,4663,11,florent pietrus,16,1,1,100,1,1,100,0,0,0,2,4,50,3,3,6,1,2,0,0,0,4
376920,422_14_75,FRANCE,17374,12,rudy gobert,9,2,2,100,2,2,100,0,0,0,0,0,0,1,0,1,1,4,1,0,0,4
376921,422_14_75,FRANCE,4665,13,boris diaw,33,6,10,60,6,7,85.7,0,3,0,3,6,50,1,1,2,4,3,2,0,1,15
376922,422_14_75,FRANCE,7987,14,kim tillie,0,0,0,0,0,0,0,0,0,0,0,0,0,0,0,0,0,0,0,0,0,0
376923,422_14_75,FRANCE,5044,15,mickael gelabale,18,2,6,33.3,2,4,50,0,2,0,0,0,0,0,2,2,1,3,2,0,0,4
376924,422_14_75,FRANCE,0,TOTALS,FRANCE,200,32,57,56.1,25,37,67.6,7,20,35,24,33,72.7,10,21,31,12,25,7,4,2,95
376925,422_14_76,USA,9010,4,stephen curry,23,2,7,28.6,0,0,0,2,7,28.6,4,4,100,0,1,1,0,2,1,0,0,10
376926,422_14_76,USA,13751,5,klay thompson,21,5,8,62.5,3,3,100,2,5,40,0,0,0,0,0,0,2,3,1,0,2,12
376927,422_14_76,USA,16600,6,derrick rose,16,0,4,0,0,2,0,0,2,0,0,0,0,0,1,1,6,0,2,1,0,0
376928,422_14_76,USA,25451,7,kenneth faried,20,4,11,36.4,4,10,40,0,1,0,2,4,50,3,3,6,0,3,0,0,0,10
376929,422_14_76,USA,3452,8,rudy gay,16,5,9,55.6,4,6,66.7,1,3,33.3,0,0,0,3,0,3,0,4,1,0,0,11
376930,422_14_76,USA,25452,9,demar derozan,14,3,4,75,2,3,66.7,1,1,100,3,3,100,0,1,1,1,1,0,1,0,10
376931,422_14_76,USA,16977,10,kyrie irving,24,10,13,76.9,4,7,57.1,6,6,100,0,0,0,0,1,1,4,2,2,0,1,26
376932,422_14_76,USA,12194,11,mason plumlee,9,0,0,0,0,0,0,0,0,0,1,2,50,0,4,4,0,1,0,0,0,1
376933,422_14_76,USA,25453,12,demarcus cousins,17,3,4,75,3,4,75,0,0,0,7,8,87.5,1,9,10,1,3,1,1,2,13
376934,422_14_76,USA,21035,13,james harden,21,8,11,72.7,5,6,83.3,3,5,60,4,4,100,1,2,3,2,2,0,0,0,23
376935,422_14_76,USA,21036,14,anthony davis,14,2,4,50,2,4,50,0,0,0,3,4,75,1,3,4,0,3,0,1,1,7
376936,422_14_76,USA,14750,15,andre drummond,5,3,3,100,3,3,100,0,0,0,0,0,0,1,1,2,0,1,0,0,1,6
376937,422_14_76,USA,0,TOTALS,USA,200,45,78,57.7,30,48,62.5,15,30,50,24,29,82.8,16,28,44,16,25,8,4,7,129
376938,422_14_76,SERBIA,5751,4,milos teodosic,23,4,7,57.1,3,4,75,1,3,33.3,1,2,50,0,0,0,7,2,1,0,0,10
376939,422_14_76,SERBIA,2100,5,marko simonovic,8,0,3,0,0,1,0,0,2,0,0,0,0,0,0,0,0,0,0,0,0,0
376940,422_14_76,SERBIA,25441,6,stefan jovic,14,3,5,60,3,4,75,0,1,0,0,0,0,1,1,2,3,3,2,1,0,6
376941,422_14_76,SERBIA,17361,7,bogdan bogdanovic,24,5,17,29.4,4,8,50,1,9,11.1,4,4,100,0,2,2,1,2,1,0,0,15
376942,422_14_76,SERBIA,15386,8,nemanja bjelica,27,6,11,54.5,4,6,66.7,2,5,40,4,6,66.7,1,2,3,4,5,2,0,1,18
376943,422_14_76,SERBIA,2654,9,stefan markovic,23,1,3,33.3,1,1,100,0,2,0,1,2,50,0,6,6,3,2,0,2,0,3
376944,422_14_76,SERBIA,19860,10,nikola kalinic,25,8,9,88.9,7,7,100,1,2,50,1,3,33.3,2,1,3,1,3,0,0,0,18
376945,422_14_76,SERBIA,15504,11,stefan bircevic,8,0,1,0,0,0,0,0,1,0,0,0,0,0,0,0,0,4,0,0,0,0
376946,422_14_76,SERBIA,93,12,nenad krstic,13,2,5,40,2,5,40,0,0,0,0,0,0,1,0,1,0,1,1,0,0,4
376947,422_14_76,SERBIA,2656,13,miroslav raduljica,14,3,6,50,3,6,50,0,0,0,3,3,100,0,3,3,0,4,3,0,0,9
376948,422_14_76,SERBIA,24202,14,rasko katic,8,1,3,33.3,1,3,33.3,0,0,0,0,0,0,1,0,1,1,1,0,0,0,2
376949,422_14_76,SERBIA,5756,15,vladimir stimac,13,3,5,60,3,5,60,0,0,0,1,1,100,1,1,2,0,0,0,0,0,7
376950,422_14_76,SERBIA,0,TOTALS,SERBIA,200,36,75,48,31,50,62,5,25,20,15,21,71.4,12,20,32,20,27,10,3,1,92
420316,470_15_01,EGYPT,13947,1,kamal khalifa,19,3,5,60,2,4,50,1,1,100,0,0,0,3,2,5,1,3,0,0,1,7
420317,470_15_01,EGYPT,21074,4,ehab amin,19,5,12,41.7,4,6,66.7,1,6,16.7,0,0,0,1,1,2,4,2,1,2,0,11
420318,470_15_01,EGYPT,25438,5,amr gendy,15,2,5,40,1,2,50,1,3,33.3,2,2,100,0,5,5,0,1,2,2,0,7
420319,470_15_01,EGYPT,9152,6,ramy gunady,18,3,5,60,1,2,50,2,3,66.7,2,2,100,0,1,1,1,1,1,1,0,10
420320,470_15_01,EGYPT,9154,9,ibrahim elgammal,20,4,10,40,1,1,100,3,9,33.3,3,3,100,4,2,6,1,0,2,1,0,14
420321,470_15_01,EGYPT,28081,10,ahmed tawfik,16,0,3,0,0,2,0,0,1,0,1,2,50,1,1,2,2,3,1,0,1,1
420322,470_15_01,EGYPT,28082,11,aly ahmed,13,3,6,50,3,6,50,0,0,0,1,2,50,2,1,3,1,4,2,0,0,7
420323,470_15_01,EGYPT,16644,12,youssef shousha,20,4,8,50,3,5,60,1,3,33.3,0,0,0,4,5,9,3,2,2,1,1,9
420324,470_15_01,EGYPT,13949,14,ramy abdallah,17,1,4,25,0,1,0,1,3,33.3,0,0,0,2,2,4,1,3,1,1,0,3
420325,470_15_01,EGYPT,28083,30,ahmed elmaragi,11,2,7,28.6,0,0,0,2,7,28.6,0,2,0,1,2,3,2,0,0,0,0,6
420326,470_15_01,EGYPT,18381,50,assem marei,17,4,6,66.7,4,6,66.7,0,0,0,2,3,66.7,3,3,6,3,2,3,0,0,10
420327,470_15_01,EGYPT,11817,55,omar oraby,15,4,5,80,4,5,80,0,0,0,3,4,75,1,6,7,2,2,3,1,3,11
420328,470_15_01,EGYPT,0,TOTALS,EGYPT,200,35,76,46.1,23,40,57.5,12,36,33.3,14,20,70,22,31,53,21,23,19,9,6,96
420329,470_15_01,GABON,28084,4,samuel styve ndong,11,3,4,75,3,4,75,0,0,0,0,0,0,2,0,2,0,1,2,1,0,6
420330,470_15_01,GABON,28085,5,rodrigue mouckaga atsu,18,0,3,0,0,0,0,0,3,0,0,0,0,0,1,1,0,1,0,0,0,0
420331,470_15_01,GABON,28086,6,gyll therence mayimba,0,0,0,0,0,0,0,0,0,0,0,0,0,0,0,0,0,0,0,0,0,0
420332,470_15_01,GABON,28087,7,lerry rostand essono mve,26,2,7,28.6,2,4,50,0,3,0,4,10,40,0,2,2,3,0,2,3,0,8
420333,470_15_01,GABON,28088,8,aymar-kabrel boundou,25,1,7,14.3,1,4,25,0,3,0,4,4,100,1,1,2,1,2,3,3,0,6
420334,470_15_01,GABON,9385,9,silvere abessolo toung,4,0,0,0,0,0,0,0,0,0,0,0,0,0,0,0,0,0,0,0,0,0
420335,470_15_01,GABON,28089,10,lin francis kobangoye ikinda,27,1,9,11.1,1,6,16.7,0,3,0,1,2,50,0,1,1,2,1,2,0,0,3
420336,470_15_01,GABON,28090,11,marvin joy mapaga,13,2,4,50,2,2,100,0,2,0,0,1,0,0,0,0,0,4,2,1,0,4
420337,470_15_01,GABON,28091,12,jason reteno,7,1,2,50,1,2,50,0,0,0,0,0,0,0,0,0,0,1,1,0,1,2
420338,470_15_01,GABON,28092,13,stephane lasme,30,4,9,44.4,4,6,66.7,0,3,0,1,2,50,2,9,11,0,3,4,1,1,9
420339,470_15_01,GABON,28093,14,freddy obame obame,32,3,7,42.9,3,6,50,0,1,0,3,6,50,0,4,4,2,2,1,1,0,9
420340,470_15_01,GABON,28094,15,lionel fabre,7,1,1,100,1,1,100,0,0,0,0,0,0,0,0,0,0,1,0,0,0,2
420341,470_15_01,GABON,0,TOTALS,GABON,200,18,53,34,18,35,51.4,0,18,0,13,25,52,5,21,26,8,16,19,10,2,49
420342,470_15_02,NIGERIA,23139,4,ben uzoh,16,2,4,50,2,4,50,0,0,0,0,2,0,0,2,2,4,1,1,3,0,4
420343,470_15_02,NIGERIA,13976,5,michael umeh,25,5,10,50,5,6,83.3,0,4,0,3,3,100,0,2,2,4,1,6,3,0,13
420344,470_15_02,NIGERIA,21026,6,ike diogu,0,0,0,0,0,0,0,0,0,0,0,0,0,0,0,0,0,0,0,0,0,0
420345,470_15_02,NIGERIA,21027,7,al-farouq aminu,21,6,8,75,6,8,75,0,0,0,3,6,50,4,4,8,3,4,4,0,0,15
420346,470_15_02,NIGERIA,23141,8,jamal olasewere,10,0,2,0,0,1,0,0,1,0,0,0,0,0,0,0,0,4,2,0,0,0
420347,470_15_02,NIGERIA,3647,9,chamberlain oguchi,26,4,8,50,0,1,0,4,7,57.1,2,2,100,0,2,2,1,2,2,1,0,14
420348,470_15_02,NIGERIA,23140,10,stan okoye,12,0,3,0,0,3,0,0,0,0,2,4,50,0,1,1,2,3,1,0,0,2
420349,470_15_02,NIGERIA,23143,11,andy ogide,19,4,9,44.4,2,2,100,2,7,28.6,2,2,100,1,5,6,0,2,0,0,0,12
420350,470_15_02,NIGERIA,28095,12,michael gbinije,11,2,4,50,0,1,0,2,3,66.7,0,0,0,0,1,1,1,3,1,1,0,6
420351,470_15_02,NIGERIA,28096,13,olaseni lawal,24,1,1,100,1,1,100,0,0,0,3,6,50,3,11,14,3,2,1,0,0,5
420352,470_15_02,NIGERIA,21031,14,alade aminu,25,4,6,66.7,4,6,66.7,0,0,0,3,4,75,5,5,10,1,2,3,2,0,11
420353,470_15_02,NIGERIA,3656,15,olumide oyedeji,10,2,2,100,2,2,100,0,0,0,2,5,40,0,2,2,0,3,1,0,0,6
420354,470_15_02,NIGERIA,0,TOTALS,NIGERIA,200,30,57,52.6,22,35,62.9,8,22,36.4,20,34,58.8,14,37,51,19,27,22,10,0,88
420355,470_15_02,CAF,3641,4,destin damachoua,35,4,10,40,2,4,50,2,6,33.3,5,6,83.3,0,2,2,3,1,4,5,0,15
420356,470_15_02,CAF,28097,5,joseph madozein,0,0,0,0,0,0,0,0,0,0,0,0,0,0,0,0,0,0,0,0,0,0
420357,470_15_02,CAF,28098,6,junior pehoua,21,0,2,0,0,0,0,0,2,0,1,3,33.3,0,1,1,1,1,3,0,0,1
420358,470_15_02,CAF,28099,7,freddy-glenn feidanga-temodea,5,0,1,0,0,1,0,0,0,0,0,0,0,0,1,1,0,4,0,0,0,0
420359,470_15_02,CAF,28100,8,johan roy stanley grebongo,25,2,5,40,0,1,0,2,4,50,2,4,50,1,2,3,0,4,1,0,0,8
420360,470_15_02,CAF,28101,9,dimitri kongbo,16,2,5,40,2,5,40,0,0,0,0,0,0,2,2,4,0,4,2,0,1,4
420361,470_15_02,CAF,28102,10,sydney pehoua,4,0,1,0,0,0,0,0,1,0,1,2,50,0,1,1,0,1,1,1,0,1
420362,470_15_02,CAF,13988,11,yannick zachee,27,3,9,33.3,2,5,40,1,4,25,0,2,0,0,2,2,2,4,2,0,0,7
420363,470_15_02,CAF,9195,12,max severin febou yadapa,0,0,0,0,0,0,0,0,0,0,0,0,0,0,0,0,0,0,0,0,0,0
420364,470_15_02,CAF,13989,13,max kouguere,28,3,15,20,2,6,33.3,1,9,11.1,6,7,85.7,0,5,5,1,5,4,1,0,13
420365,470_15_02,CAF,28103,14,philippe djada mabada,9,1,3,33.3,0,0,0,1,3,33.3,0,0,0,0,0,0,0,0,1,1,0,3
420366,470_15_02,CAF,11782,15,jimmy djimrabaye,30,3,9,33.3,3,7,42.9,0,2,0,5,6,83.3,0,1,1,4,5,2,3,0,11
420367,470_15_02,CAF,0,TOTALS,CAF,200,18,60,30,11,29,37.9,7,31,22.6,20,30,66.7,5,19,24,11,29,21,11,1,63
420368,470_15_03,MALI,23144,4,ibrahim saounera,34,1,3,33.3,1,3,33.3,0,0,0,9,11,81.8,1,1,2,0,2,1,1,0,11
420369,470_15_03,MALI,11717,5,mahamadou kante,10,0,2,0,0,1,0,0,1,0,1,2,50,0,2,2,0,1,4,0,0,1
420370,470_15_03,MALI,11718,6,abdrahamane maiga,0,0,0,0,0,0,0,0,0,0,0,0,0,0,0,0,0,0,0,0,0,0
420371,470_15_03,MALI,28104,7,ibrahim djambo,17,1,5,20,1,4,25,0,1,0,3,3,100,1,2,3,1,1,3,1,0,5
420372,470_15_03,MALI,7055,8,waly coulibaly,12,0,1,0,0,1,0,0,0,0,0,0,0,0,0,0,1,1,0,0,0,0
420373,470_15_03,MALI,11976,9,boubacar moungoro,18,2,8,25,0,1,0,2,7,28.6,0,0,0,1,1,2,1,1,1,0,0,6
420374,470_15_03,MALI,28105,10,mohamed bah,8,0,1,0,0,1,0,0,0,0,0,0,0,0,3,3,0,0,0,0,0,0
420375,470_15_03,MALI,23146,11,namory boundy,5,0,1,0,0,1,0,0,0,0,0,0,0,0,1,1,0,0,0,0,0,0
420376,470_15_03,MALI,23147,12,boubacar sidibe,13,4,5,80,4,5,80,0,0,0,2,4,50,0,2,2,0,5,1,0,0,10
420377,470_15_03,MALI,1768,13,souarata cisse,34,1,12,8.3,1,5,20,0,7,0,8,9,88.9,1,6,7,2,4,4,0,0,10
420378,470_15_03,MALI,18495,14,mohamed tangara,28,0,5,0,0,4,0,0,1,0,2,2,100,0,5,5,2,2,2,0,0,2
420379,470_15_03,MALI,28106,15,drissa ballo,21,5,6,83.3,5,6,83.3,0,0,0,1,2,50,2,5,7,1,4,3,1,1,11
420380,470_15_03,MALI,0,TOTALS,MALI,200,14,49,28.6,12,32,37.5,2,17,11.8,26,33,78.8,9,32,41,8,22,19,3,1,56
420381,470_15_03,CAMEROON,28107,4,arnaud adala moto,17,3,7,42.9,3,5,60,0,2,0,2,2,100,2,4,6,1,2,1,1,0,8
420382,470_15_03,CAMEROON,28108,5,aldo curti,10,1,3,33.3,1,1,100,0,2,0,0,2,0,0,2,2,3,1,0,1,0,2
420383,470_15_03,CAMEROON,9200,6,parfait bitee,21,1,5,20,0,1,0,1,4,25,0,0,0,0,1,1,3,2,0,0,0,3
420384,470_15_03,CAMEROON,28109,7,kenneth kadji,27,5,10,50,2,3,66.7,3,7,42.9,4,6,66.7,1,5,6,1,4,1,1,0,17
420385,470_15_03,CAMEROON,11673,8,harding nana,10,1,7,14.3,1,4,25,0,3,0,2,3,66.7,2,0,2,0,3,0,0,0,4
420386,470_15_03,CAMEROON,23129,9,jeremy nzeulie,31,4,9,44.4,3,4,75,1,5,20,2,4,50,1,1,2,2,2,1,0,0,11
420387,470_15_03,CAMEROON,28110,10,seidou njoya,13,1,2,50,0,1,0,1,1,100,0,0,0,0,0,0,2,4,2,0,0,3
420388,470_15_03,CAMEROON,11960,11,frank tchoubaye,22,2,8,25,0,2,0,2,6,33.3,3,6,50,1,2,3,0,0,2,1,0,9
420389,470_15_03,CAMEROON,11676,12,alexis wangmene,7,1,3,33.3,1,3,33.3,0,0,0,2,4,50,2,1,3,1,2,0,0,0,4
420390,470_15_03,CAMEROON,28111,13,boris siakam,8,1,1,100,1,1,100,0,0,0,0,0,0,0,1,1,0,0,1,0,0,2
420391,470_15_03,CAMEROON,23130,14,steve moundou missi,10,0,2,0,0,0,0,0,2,0,1,2,50,2,3,5,0,1,1,0,1,1
420392,470_15_03,CAMEROON,9206,15,gaston essengue,24,3,7,42.9,3,7,42.9,0,0,0,0,0,0,0,3,3,0,5,1,1,0,6
420393,470_15_03,CAMEROON,0,TOTALS,CAMEROON,200,23,64,35.9,15,32,46.9,8,32,25,16,29,55.2,11,26,37,13,26,12,5,1,70
420394,470_15_04,TUNISIA,18347,4,omar abada,9,1,3,33.3,1,2,50,0,1,0,0,0,0,0,1,1,0,1,0,0,0,2
420395,470_15_04,TUNISIA,28112,5,mohamed abbassi,16,2,5,40,2,5,40,0,0,0,0,0,0,0,1,1,0,1,1,0,0,4
420396,470_15_04,TUNISIA,9216,6,nizar knioua,19,3,4,75,3,3,100,0,1,0,1,2,50,0,0,0,2,1,1,2,0,7
420397,470_15_04,TUNISIA,18521,7,mourad el mabrouk,17,1,6,16.7,0,2,0,1,4,25,0,0,0,0,0,0,1,3,1,0,1,3
420398,470_15_04,TUNISIA,28113,8,mehdi seyeh,11,0,2,0,0,2,0,0,0,0,0,0,0,0,2,2,3,2,0,0,0,0
420399,470_15_04,TUNISIA,9278,9,mohamed hadidane,17,2,5,40,1,3,33.3,1,2,50,3,3,100,1,5,6,2,1,0,1,0,8
420400,470_15_04,TUNISIA,28114,10,michael brandon roll,26,2,10,20,1,4,25,1,6,16.7,0,0,0,1,6,7,5,1,1,1,0,5
420401,470_15_04,TUNISIA,13953,11,mohamed mokhtar ghyaza,15,1,4,25,1,4,25,0,0,0,3,3,100,2,3,5,0,2,0,1,0,5
420402,470_15_04,TUNISIA,13954,12,makram ben romdhane,29,9,14,64.3,7,10,70,2,4,50,4,4,100,5,1,6,3,2,2,1,0,24
420403,470_15_04,TUNISIA,9219,13,amine rzig,16,3,6,50,2,3,66.7,1,3,33.3,1,2,50,1,4,5,1,2,2,0,0,8
420404,470_15_04,TUNISIA,9220,14,hamdi braa,0,0,0,0,0,0,0,0,0,0,0,0,0,0,0,0,0,0,0,0,0,0
420405,470_15_04,TUNISIA,13956,15,salah mejri,25,4,12,33.3,4,10,40,0,2,0,3,6,50,3,7,10,0,3,2,2,3,11
420406,470_15_04,TUNISIA,0,TOTALS,TUNISIA,200,28,71,39.4,22,48,45.8,6,23,26.1,15,20,75,13,35,48,17,19,11,8,4,77
420407,470_15_04,UGANDA,28115,4,stanley ocitti,38,7,16,43.8,3,7,42.9,4,9,44.4,2,2,100,0,4,4,0,4,1,0,0,20
420408,470_15_04,UGANDA,28116,5,jimmy enabu,17,2,4,50,2,4,50,0,0,0,1,1,100,0,4,4,0,2,0,0,0,5
420409,470_15_04,UGANDA,14035,7,joseph ikong,5,0,1,0,0,0,0,0,1,0,0,0,0,1,0,1,0,0,2,0,0,0
420410,470_15_04,UGANDA,28117,8,josh johnson,14,1,1,100,1,1,100,0,0,0,1,2,50,0,1,1,2,0,3,0,0,3
420411,470_15_04,UGANDA,28118,9,samuel mukooza,27,2,10,20,2,6,33.3,0,4,0,0,0,0,2,1,3,0,4,3,0,0,4
420412,470_15_04,UGANDA,6470,10,kassim nagwere,21,0,4,0,0,1,0,0,3,0,2,2,100,0,3,3,4,0,1,0,0,2
420413,470_15_04,UGANDA,28119,11,samuel kalwanyi,9,1,4,25,1,4,25,0,0,0,0,0,0,0,0,0,0,3,0,0,0,2
420414,470_15_04,UGANDA,14033,12,stephen omwony,31,5,16,31.2,2,7,28.6,3,9,33.3,2,2,100,0,5,5,0,4,4,0,0,15
420415,470_15_04,UGANDA,28120,13,dhal marial,5,0,0,0,0,0,0,0,0,0,0,0,0,0,2,2,0,0,0,0,0,0
420416,470_15_04,UGANDA,14037,14,henry malinga,19,2,3,66.7,2,3,66.7,0,0,0,0,2,0,2,2,4,2,3,2,0,0,4
420417,470_15_04,UGANDA,28121,15,brandon sebirumbi,15,0,4,0,0,4,0,0,0,0,0,0,0,2,2,4,1,4,1,0,2,0
420418,470_15_04,UGANDA,0,TOTALS,UGANDA,200,20,63,31.7,13,37,35.1,7,26,26.9,8,11,72.7,9,30,39,9,24,17,0,2,55
420419,470_15_05,COTE D'IVOIRE,28122,4,serge asselain,8,2,3,66.7,1,1,100,1,2,50,4,4,100,1,0,1,0,0,1,0,1,9
420420,470_15_05,COTE D'IVOIRE,9166,5,souleyman diabate,35,5,16,31.2,4,10,40,1,6,16.7,1,1,100,2,6,8,3,1,7,0,0,12
420421,470_15_05,COTE D'IVOIRE,28123,7,cedric kouadio,23,2,5,40,2,4,50,0,1,0,5,7,71.4,0,2,2,0,3,3,0,0,9
420422,470_15_05,COTE D'IVOIRE,28124,8,kehasson oulai,5,1,1,100,1,1,100,0,0,0,0,3,0,0,1,1,0,1,1,0,0,2
420423,470_15_05,COTE D'IVOIRE,3659,9,morlaye bangoura,4,0,0,0,0,0,0,0,0,0,0,0,0,0,0,0,0,1,1,0,0,0
420424,470_15_05,COTE D'IVOIRE,11801,10,alassane meite,9,0,1,0,0,1,0,0,0,0,0,0,0,0,1,1,0,0,2,1,0,0
420425,470_15_05,COTE D'IVOIRE,9162,11,jean-philippe koffi,38,2,11,18.2,2,4,50,0,7,0,4,4,100,2,8,10,4,2,5,1,0,8
420426,470_15_05,COTE D'IVOIRE,28125,12,eudes bahin,16,1,3,33.3,1,2,50,0,1,0,0,0,0,1,3,4,0,1,0,1,0,2
420427,470_15_05,COTE D'IVOIRE,9164,13,eric tape,20,2,9,22.2,2,8,25,0,1,0,2,4,50,2,1,3,1,1,3,2,0,6
420428,470_15_05,COTE D'IVOIRE,13983,14,namori meite,30,2,5,40,2,3,66.7,0,2,0,1,4,25,1,4,5,2,3,3,1,0,5
420429,470_15_05,COTE D'IVOIRE,28126,15,aboubacar hima,12,0,0,0,0,0,0,0,0,0,3,4,75,0,1,1,0,2,2,1,0,3
420430,470_15_05,COTE D'IVOIRE,0,TOTALS,COTE D'IVOIRE,200,17,54,31.5,15,34,44.1,2,20,10,20,31,64.5,10,33,43,10,15,29,7,1,56
420431,470_15_05,CAPE VERDE,23105,4,dimitry coronel,31,6,14,42.9,4,11,36.4,2,3,66.7,1,1,100,1,3,4,3,2,2,4,0,15
420432,470_15_05,CAPE VERDE,11659,5,jeff xavier,22,7,14,50,2,5,40,5,9,55.6,0,0,0,0,3,3,4,0,2,1,0,19
420433,470_15_05,CAPE VERDE,13950,6,ivan almeida,21,5,10,50,4,7,57.1,1,3,33.3,0,0,0,4,5,9,4,4,5,2,2,11
420434,470_15_05,CAPE VERDE,23107,7,braima freire,6,0,0,0,0,0,0,0,0,0,0,0,0,1,0,1,0,3,3,0,0,0
420435,470_15_05,CAPE VERDE,28127,8,mario correia,31,4,15,26.7,0,2,0,4,13,30.8,2,2,100,0,3,3,3,3,5,1,0,14
420436,470_15_05,CAPE VERDE,13951,9,joel almeida,9,0,6,0,0,1,0,0,5,0,0,0,0,0,2,2,0,0,0,0,0,0
420437,470_15_05,CAPE VERDE,28128,10,michael mendes,6,0,1,0,0,1,0,0,0,0,0,0,0,0,1,1,0,1,0,0,0,0
420438,470_15_05,CAPE VERDE,28129,11,fidel mendonca,5,0,4,0,0,1,0,0,3,0,0,0,0,0,0,0,0,0,1,1,0,0
420439,470_15_05,CAPE VERDE,28130,12,keven gomes,4,1,1,100,1,1,100,0,0,0,0,0,0,1,1,2,0,3,0,0,0,2
420440,470_15_05,CAPE VERDE,23112,13,brian rudolph,0,0,0,0,0,0,0,0,0,0,0,0,0,0,0,0,0,0,0,0,0,0
420441,470_15_05,CAPE VERDE,23113,14,kevin coronel,15,2,5,40,2,5,40,0,0,0,1,4,25,3,0,3,1,3,1,1,1,5
420442,470_15_05,CAPE VERDE,9139,15,rodrigo mascarenhas,34,2,2,100,2,2,100,0,0,0,3,3,100,3,11,14,4,3,3,1,1,7
420443,470_15_05,CAPE VERDE,0,TOTALS,CAPE VERDE,184,27,72,37.5,15,36,41.7,12,36,33.3,7,10,70,16,30,46,19,22,22,11,4,73
420444,470_15_06,ANGOLA,13818,4,edson ndoniema,13,2,3,66.7,2,2,100,0,1,0,0,2,0,0,0,0,0,2,3,1,0,4
420445,470_15_06,ANGOLA,3574,5,armando costa,30,1,4,25,0,3,0,1,1,100,3,4,75,1,6,7,3,2,3,1,0,6
420446,470_15_06,ANGOLA,3420,6,carlos morais,27,4,12,33.3,1,4,25,3,8,37.5,7,8,87.5,1,1,2,2,4,3,0,0,18
420447,470_15_06,ANGOLA,16597,7,roberto fortes,12,2,2,100,1,1,100,1,1,100,1,3,33.3,0,1,1,1,1,1,0,0,6
420448,470_15_06,ANGOLA,11834,8,hermenegildo santos,4,0,0,0,0,0,0,0,0,0,2,2,100,0,0,0,0,3,0,0,0,2
420449,470_15_06,ANGOLA,11630,9,leonel paulo,15,2,3,66.7,2,2,100,0,1,0,2,2,100,1,4,5,1,4,3,1,2,6
420450,470_15_06,ANGOLA,7039,10,valdelicio macanga maia joaquim,2,0,2,0,0,2,0,0,0,0,0,0,0,0,0,0,0,1,0,0,0,0
420451,470_15_06,ANGOLA,23104,11,reggie moore,20,2,6,33.3,1,1,100,1,5,20,2,2,100,1,5,6,0,3,4,1,0,7
420452,470_15_06,ANGOLA,9123,12,felizardo ambrosio,17,2,5,40,2,4,50,0,1,0,5,5,100,4,1,5,0,4,3,1,0,9
420453,470_15_06,ANGOLA,11831,13,yanick moreira,18,3,5,60,3,5,60,0,0,0,3,8,37.5,3,5,8,0,3,1,1,0,9
420454,470_15_06,ANGOLA,13819,14,braulio morais,19,5,7,71.4,4,5,80,1,2,50,0,0,0,0,1,1,4,4,1,2,0,11
420455,470_15_06,ANGOLA,12,15,eduardo mingas,23,2,4,50,2,3,66.7,0,1,0,2,2,100,2,3,5,0,3,0,0,0,6
420456,470_15_06,ANGOLA,0,TOTALS,ANGOLA,200,25,53,47.2,18,32,56.2,7,21,33.3,27,38,71.1,15,30,45,11,34,22,8,2,84
420457,470_15_06,MOZAMBIQUE,28131,4,hugo martins,3,0,1,0,0,1,0,0,0,0,0,0,0,0,0,0,0,0,0,0,0,0
420458,470_15_06,MOZAMBIQUE,9320,5,armando baptista,9,0,2,0,0,1,0,0,1,0,1,2,50,1,0,1,0,3,0,0,0,1
420459,470_15_06,MOZAMBIQUE,7042,6,david canivete,34,3,9,33.3,2,5,40,1,4,25,6,6,100,1,3,4,3,4,4,2,0,13
420460,470_15_06,MOZAMBIQUE,11728,7,ermelindo novela,13,1,2,50,1,1,100,0,1,0,1,2,50,0,2,2,0,1,2,1,0,3
420461,470_15_06,MOZAMBIQUE,18509,8,augusto matos,29,7,16,43.8,6,10,60,1,6,16.7,12,16,75,1,1,2,0,4,1,2,0,27
420462,470_15_06,MOZAMBIQUE,28132,9,helton ubisse,22,3,5,60,3,5,60,0,0,0,4,5,80,3,2,5,0,3,0,0,0,10
420463,470_15_06,MOZAMBIQUE,28133,10,elton mazive,2,0,0,0,0,0,0,0,0,0,0,0,0,0,0,0,0,2,0,0,0,0
420464,470_15_06,MOZAMBIQUE,3628,11,custodio muchate,9,0,1,0,0,0,0,0,1,0,2,2,100,0,2,2,0,5,1,0,0,2
420465,470_15_06,MOZAMBIQUE,3629,12,octavio magolico,38,3,7,42.9,2,3,66.7,1,4,25,0,0,0,0,7,7,1,3,2,3,0,7
420466,470_15_06,MOZAMBIQUE,11896,13,pio matos,34,1,9,11.1,1,6,16.7,0,3,0,5,8,62.5,0,2,2,5,3,5,2,0,7
420467,470_15_06,MOZAMBIQUE,28134,14,luis barros,3,0,0,0,0,0,0,0,0,0,0,0,0,0,0,0,0,1,0,0,0,0
420468,470_15_06,MOZAMBIQUE,28135,15,baggio chimonzo,6,0,2,0,0,0,0,0,2,0,2,2,100,0,0,0,0,0,0,0,0,2
420469,470_15_06,MOZAMBIQUE,0,TOTALS,MOZAMBIQUE,200,18,54,33.3,15,32,46.9,3,22,13.6,33,43,76.7,7,19,26,9,29,16,10,0,72
420470,470_15_07,ALGERIA,28136,4,yanis mostefat,0,0,0,0,0,0,0,0,0,0,0,0,0,0,0,0,0,0,0,0,0,0
420471,470_15_07,ALGERIA,23100,5,abdesslem dekkiche,21,1,3,33.3,1,2,50,0,1,0,1,2,50,0,5,5,1,4,1,0,0,3
420472,470_15_07,ALGERIA,28137,6,faycal ramdane sahraoui,7,0,0,0,0,0,0,0,0,0,0,2,0,0,0,0,0,1,2,0,0,0
420473,470_15_07,ALGERIA,28138,7,samir mekdad,32,4,8,50,2,3,66.7,2,5,40,7,8,87.5,0,6,6,3,4,1,1,0,17
420474,470_15_07,ALGERIA,28139,8,mounir benzegala,34,5,13,38.5,1,5,20,4,8,50,2,3,66.7,0,4,4,6,1,0,1,0,16
420475,470_15_07,ALGERIA,11747,9,mohamed harat,26,7,14,50,7,14,50,0,0,0,7,12,58.3,4,8,12,2,4,1,1,0,21
420476,470_15_07,ALGERIA,11758,10,mohamed zerouali,5,0,1,0,0,1,0,0,0,0,0,0,0,0,0,0,0,1,0,0,0,0
420477,470_15_07,ALGERIA,28140,11,touhami ghezzoul,26,3,9,33.3,3,9,33.3,0,0,0,5,8,62.5,4,4,8,0,3,3,0,4,11
420478,470_15_07,ALGERIA,28141,12,kamel abdel-magid ammour,8,1,4,25,0,1,0,1,3,33.3,0,0,0,1,0,1,0,1,1,0,0,3
420479,470_15_07,ALGERIA,23102,13,hocine gaham,18,4,7,57.1,4,4,100,0,3,0,0,0,0,1,2,3,1,1,0,0,0,8
420480,470_15_07,ALGERIA,10431,14,mehdi cheriet,12,3,5,60,3,4,75,0,1,0,0,0,0,1,0,1,0,4,2,0,0,6
420481,470_15_07,ALGERIA,23103,15,mohamed sedik touati,11,1,3,33.3,1,3,33.3,0,0,0,0,0,0,2,1,3,1,3,0,1,0,2
420482,470_15_07,ALGERIA,0,TOTALS,ALGERIA,200,29,67,43.3,22,46,47.8,7,21,33.3,22,35,62.9,15,35,50,14,27,12,4,4,87
420483,470_15_07,ZIMBABWE,9324,4,taurai chitsinde,0,0,0,0,0,0,0,0,0,0,0,0,0,0,0,0,0,0,0,0,0,0
420484,470_15_07,ZIMBABWE,14048,5,tawanda chitsinde,32,4,6,66.7,1,1,100,3,5,60,0,0,0,0,2,2,2,3,3,2,0,11
420485,470_15_07,ZIMBABWE,28142,6,simbarashe mungomezi,19,1,6,16.7,1,3,33.3,0,3,0,8,9,88.9,0,2,2,0,3,0,1,0,10
420486,470_15_07,ZIMBABWE,28143,7,tinotenda mugabe,5,0,1,0,0,1,0,0,0,0,0,2,0,0,0,0,0,3,0,0,0,0
420487,470_15_07,ZIMBABWE,28144,8,moses muyambo,8,0,0,0,0,0,0,0,0,0,0,0,0,0,0,0,1,1,3,0,0,0
420488,470_15_07,ZIMBABWE,9329,9,eric banda,23,2,7,28.6,2,5,40,0,2,0,2,2,100,3,1,4,2,3,1,1,0,6
420489,470_15_07,ZIMBABWE,9328,10,duncan shenje,13,1,4,25,1,1,100,0,3,0,0,0,0,0,3,3,0,3,0,0,0,2
420490,470_15_07,ZIMBABWE,11891,11,vitalis chikoko,36,5,15,33.3,5,14,35.7,0,1,0,4,8,50,4,4,8,0,3,3,0,3,14
420491,470_15_07,ZIMBABWE,11885,12,tatenda maturure,35,4,17,23.5,3,13,23.1,1,4,25,5,11,45.5,2,8,10,0,2,5,3,0,14
420492,470_15_07,ZIMBABWE,28145,13,everisto pasipamire,25,4,11,36.4,4,10,40,0,1,0,2,3,66.7,5,4,9,0,3,1,0,2,10
420493,470_15_07,ZIMBABWE,28146,14,brian hore,4,0,0,0,0,0,0,0,0,0,0,0,0,0,0,0,0,3,1,0,0,0
420494,470_15_07,ZIMBABWE,28147,15,neville chivanganye,0,0,0,0,0,0,0,0,0,0,0,0,0,0,0,0,0,0,0,0,0,0
420495,470_15_07,ZIMBABWE,0,TOTALS,ZIMBABWE,200,21,67,31.3,17,48,35.4,4,19,21.1,21,35,60,17,26,43,5,27,17,7,5,67
420496,470_15_08,SENEGAL,11764,4,thierno niang,6,0,0,0,0,0,0,0,0,0,0,0,0,0,0,0,0,1,1,0,0,0
420497,470_15_08,SENEGAL,18541,5,xane dalmeida,35,1,5,20,1,3,33.3,0,2,0,1,2,50,0,3,3,5,2,3,0,0,3
420498,470_15_08,SENEGAL,23085,6,ibrahima thomas,0,0,0,0,0,0,0,0,0,0,0,0,0,0,0,0,0,0,0,0,0,0
420499,470_15_08,SENEGAL,18543,7,mohamet diop,5,1,1,100,0,0,0,1,1,100,0,0,0,0,1,1,1,1,1,0,0,3
420500,470_15_08,SENEGAL,13966,8,antoine mendy,31,5,13,38.5,2,4,50,3,9,33.3,4,6,66.7,2,2,4,1,2,2,2,0,17
420501,470_15_08,SENEGAL,3592,9,maleye ndoye,31,6,11,54.5,3,3,100,3,8,37.5,2,2,100,0,3,3,4,4,1,0,0,17
420502,470_15_08,SENEGAL,13963,10,ibrahima mbengue,0,0,0,0,0,0,0,0,0,0,0,0,0,0,0,0,0,0,0,0,0,0
420503,470_15_08,SENEGAL,9148,11,mouhammad faye,35,2,9,22.2,2,4,50,0,5,0,1,2,50,0,3,3,1,4,1,3,0,5
420504,470_15_08,SENEGAL,23090,12,saer sene,5,1,1,100,1,1,100,0,0,0,0,0,0,1,0,1,0,0,1,0,1,2
420505,470_15_08,SENEGAL,28148,13,cheikh tidiane mbodj,9,0,1,0,0,1,0,0,0,0,2,2,100,1,1,2,0,0,1,1,1,2
420506,470_15_08,SENEGAL,25450,14,gorgui dieng,35,9,18,50,9,15,60,0,3,0,8,11,72.7,5,10,15,3,4,5,2,0,26
420507,470_15_08,SENEGAL,23091,15,pape abdou badji,8,1,2,50,1,2,50,0,0,0,0,1,0,1,3,4,1,1,1,0,0,2
420508,470_15_08,SENEGAL,0,TOTALS,SENEGAL,200,26,61,42.6,19,33,57.6,7,28,25,18,26,69.2,11,30,41,16,19,19,8,2,77
420509,470_15_08,MOROCCO,18539,4,reda ali harras,23,3,7,42.9,2,3,66.7,1,4,25,0,1,0,0,5,5,2,3,0,0,0,7
420510,470_15_08,MOROCCO,11820,5,zakaria ait fatah,0,0,0,0,0,0,0,0,0,0,0,0,0,0,0,0,0,0,0,0,0,0
420511,470_15_08,MOROCCO,9124,6,soufiane kourodu,31,5,12,41.7,5,12,41.7,0,0,0,2,2,100,2,5,7,3,2,5,1,1,12
420512,470_15_08,MOROCCO,23152,7,abdelali lahrichi,0,0,0,0,0,0,0,0,0,0,0,0,0,0,0,0,0,0,0,0,0,0
420513,470_15_08,MOROCCO,3576,8,mustapha khalfi,36,4,12,33.3,4,8,50,0,4,0,4,4,100,0,5,5,8,3,2,0,0,12
420514,470_15_08,MOROCCO,18538,9,omar laanani,0,0,0,0,0,0,0,0,0,0,0,0,0,0,0,0,0,0,0,0,0,0
420515,470_15_08,MOROCCO,28149,10,mohamed choua,28,1,3,33.3,1,3,33.3,0,0,0,2,2,100,0,2,2,2,2,1,0,0,4
420516,470_15_08,MOROCCO,14004,11,abdelhakim zouita,40,13,21,61.9,13,20,65,0,1,0,1,5,20,2,2,4,1,4,7,1,0,27
420517,470_15_08,MOROCCO,14002,12,walid dahmani,0,0,0,0,0,0,0,0,0,0,0,0,0,0,0,0,0,0,0,0,0,0
420518,470_15_08,MOROCCO,28150,13,adil el makssoud,21,3,6,50,2,3,66.7,1,3,33.3,0,2,0,0,2,2,1,2,0,4,0,7
420519,470_15_08,MOROCCO,11818,14,hamza zehouani,0,0,0,0,0,0,0,0,0,0,0,0,0,0,0,0,0,0,0,0,0,0
420520,470_15_08,MOROCCO,9126,15,abderrahim najah,21,1,2,50,1,2,50,0,0,0,0,0,0,2,3,5,1,5,3,1,0,2
420521,470_15_08,MOROCCO,0,TOTALS,MOROCCO,200,30,63,47.6,28,51,54.9,2,12,16.7,9,16,56.2,7,26,33,18,21,20,7,1,71
420522,470_15_09,GABON,28084,4,samuel styve ndong,15,2,4,50,2,4,50,0,0,0,0,2,0,1,2,3,0,2,2,0,0,4
420523,470_15_09,GABON,28085,5,rodrigue mouckaga atsu,17,1,5,20,1,3,33.3,0,2,0,0,0,0,1,3,4,0,1,1,1,0,2
420524,470_15_09,GABON,28086,6,gyll therence mayimba,32,1,7,14.3,0,2,0,1,5,20,3,8,37.5,2,2,4,0,4,2,0,0,6
420525,470_15_09,GABON,28087,7,lerry rostand essono mve,34,3,9,33.3,3,7,42.9,0,2,0,5,7,71.4,4,5,9,2,1,9,7,0,11
420526,470_15_09,GABON,28088,8,aymar-kabrel boundou,21,3,8,37.5,2,5,40,1,3,33.3,1,2,50,0,1,1,2,2,3,3,0,8
420527,470_15_09,GABON,9385,9,silvere abessolo toung,0,0,0,0,0,0,0,0,0,0,0,0,0,0,0,0,0,0,0,0,0,0
420528,470_15_09,GABON,28089,10,lin francis kobangoye ikinda,20,3,6,50,2,3,66.7,1,3,33.3,0,0,0,0,1,1,0,5,2,0,0,7
420529,470_15_09,GABON,28090,11,marvin joy mapaga,9,0,0,0,0,0,0,0,0,0,1,2,50,0,1,1,0,4,3,1,0,1
420530,470_15_09,GABON,28091,12,jason reteno,11,0,1,0,0,0,0,0,1,0,1,2,50,0,1,1,0,2,3,0,0,1
420531,470_15_09,GABON,28092,13,stephane lasme,22,2,9,22.2,2,7,28.6,0,2,0,3,3,100,1,2,3,2,4,1,1,3,7
420532,470_15_09,GABON,28093,14,freddy obame obame,17,2,4,50,2,4,50,0,0,0,3,4,75,3,0,3,1,3,0,3,0,7
420533,470_15_09,GABON,28094,15,lionel fabre,4,0,2,0,0,2,0,0,0,0,0,4,0,0,0,0,0,1,0,0,1,0
420534,470_15_09,GABON,0,TOTALS,GABON,200,17,55,30.9,14,37,37.8,3,18,16.7,17,34,50,17,20,37,7,29,27,16,4,54
420535,470_15_09,MALI,23144,4,ibrahim saounera,17,1,7,14.3,1,6,16.7,0,1,0,3,3,100,0,0,0,3,2,6,1,0,5
420536,470_15_09,MALI,11717,5,mahamadou kante,17,0,0,0,0,0,0,0,0,0,0,0,0,0,1,1,5,1,2,2,0,0
420537,470_15_09,MALI,11718,6,abdrahamane maiga,6,1,2,50,0,0,0,1,2,50,0,0,0,0,0,0,0,1,3,0,0,3
420538,470_15_09,MALI,28104,7,ibrahim djambo,27,3,7,42.9,3,6,50,0,1,0,4,7,57.1,1,8,9,0,5,2,2,3,10
420539,470_15_09,MALI,7055,8,waly coulibaly,30,4,9,44.4,1,2,50,3,7,42.9,0,0,0,0,0,0,2,1,3,3,0,11
420540,470_15_09,MALI,11976,9,boubacar moungoro,17,5,8,62.5,2,3,66.7,3,5,60,0,2,0,0,2,2,1,2,4,1,0,13
420541,470_15_09,MALI,28105,10,mohamed bah,20,0,1,0,0,1,0,0,0,0,5,6,83.3,6,3,9,0,4,2,2,0,5
420542,470_15_09,MALI,23146,11,namory boundy,22,3,5,60,1,2,50,2,3,66.7,0,0,0,2,4,6,1,1,2,1,0,8
420543,470_15_09,MALI,23147,12,boubacar sidibe,17,3,5,60,3,5,60,0,0,0,2,2,100,2,5,7,0,3,0,0,1,8
420544,470_15_09,MALI,1768,13,souarata cisse,15,3,8,37.5,0,3,0,3,5,60,2,2,100,0,2,2,0,3,1,0,0,11
420545,470_15_09,MALI,18495,14,mohamed tangara,5,0,0,0,0,0,0,0,0,0,4,4,100,1,0,1,0,2,1,0,0,4
420546,470_15_09,MALI,28106,15,drissa ballo,7,0,0,0,0,0,0,0,0,0,0,2,0,0,1,1,0,3,3,0,0,0
420547,470_15_09,MALI,0,TOTALS,MALI,200,23,52,44.2,11,28,39.3,12,24,50,20,28,71.4,14,29,43,12,28,29,12,4,78
420548,470_15_10,UGANDA,28115,4,stanley ocitti,18,2,9,22.2,2,4,50,0,5,0,1,2,50,2,2,4,1,5,2,0,0,5
420549,470_15_10,UGANDA,28116,5,jimmy enabu,19,1,9,11.1,1,6,16.7,0,3,0,1,3,33.3,1,2,3,0,0,3,0,0,3
420550,470_15_10,UGANDA,14035,7,joseph ikong,4,0,1,0,0,0,0,0,1,0,0,0,0,0,1,1,0,1,1,0,0,0
420551,470_15_10,UGANDA,28117,8,josh johnson,11,0,2,0,0,2,0,0,0,0,3,4,75,0,0,0,2,1,1,0,0,3
420552,470_15_10,UGANDA,28118,9,samuel mukooza,22,3,7,42.9,2,4,50,1,3,33.3,1,4,25,0,1,1,3,3,2,0,0,8
420553,470_15_10,UGANDA,6470,10,kassim nagwere,28,2,6,33.3,1,1,100,1,5,20,0,4,0,0,2,2,1,2,3,0,0,5
420554,470_15_10,UGANDA,28119,11,samuel kalwanyi,20,2,7,28.6,2,7,28.6,0,0,0,1,4,25,0,6,6,2,1,0,1,0,5
420555,470_15_10,UGANDA,14033,12,stephen omwony,35,6,14,42.9,2,3,66.7,4,11,36.4,4,4,100,3,6,9,1,2,2,1,0,20
420556,470_15_10,UGANDA,28120,13,dhal marial,9,0,0,0,0,0,0,0,0,0,1,2,50,0,1,1,1,2,0,0,0,1
420557,470_15_10,UGANDA,14037,14,henry malinga,24,1,4,25,1,4,25,0,0,0,2,2,100,2,2,4,1,2,1,0,0,4
420558,470_15_10,UGANDA,28121,15,brandon sebirumbi,11,2,3,66.7,2,2,100,0,1,0,1,2,50,2,2,4,0,4,1,0,0,5
420559,470_15_10,UGANDA,0,TOTALS,UGANDA,200,19,62,30.6,13,33,39.4,6,29,20.7,15,31,48.4,11,27,38,12,23,16,2,0,59
420560,470_15_10,NIGERIA,23139,4,ben uzoh,20,2,5,40,2,5,40,0,0,0,2,4,50,1,2,3,4,4,0,2,1,6
420561,470_15_10,NIGERIA,13976,5,michael umeh,16,4,6,66.7,2,3,66.7,2,3,66.7,1,2,50,0,1,1,3,2,1,2,0,11
420562,470_15_10,NIGERIA,21026,6,ike diogu,0,0,0,0,0,0,0,0,0,0,0,0,0,0,0,0,0,0,0,0,0,0
420563,470_15_10,NIGERIA,21027,7,al-farouq aminu,23,3,8,37.5,1,4,25,2,4,50,6,6,100,0,2,2,3,2,0,1,0,14
420564,470_15_10,NIGERIA,23141,8,jamal olasewere,10,1,3,33.3,1,2,50,0,1,0,0,0,0,1,1,2,0,4,2,2,0,2
420565,470_15_10,NIGERIA,3647,9,chamberlain oguchi,20,9,16,56.2,1,2,50,8,14,57.1,4,4,100,0,2,2,2,3,0,1,0,30
420566,470_15_10,NIGERIA,23140,10,stan okoye,16,3,6,50,1,2,50,2,4,50,2,2,100,0,3,3,0,2,1,0,0,10
420567,470_15_10,NIGERIA,23143,11,andy ogide,18,2,4,50,1,1,100,1,3,33.3,0,0,0,0,1,1,0,2,1,0,0,5
420568,470_15_10,NIGERIA,28095,12,michael gbinije,20,0,5,0,0,2,0,0,3,0,1,2,50,0,3,3,2,3,3,0,0,1
420569,470_15_10,NIGERIA,28096,13,olaseni lawal,21,2,2,100,2,2,100,0,0,0,5,6,83.3,2,5,7,7,1,0,1,1,9
420570,470_15_10,NIGERIA,21031,14,alade aminu,20,4,6,66.7,4,5,80,0,1,0,2,4,50,0,7,7,2,3,2,1,2,10
420571,470_15_10,NIGERIA,3656,15,olumide oyedeji,16,0,2,0,0,1,0,0,1,0,0,0,0,2,6,8,0,3,2,0,0,0
420572,470_15_10,NIGERIA,0,TOTALS,NIGERIA,200,30,63,47.6,15,29,51.7,15,34,44.1,23,30,76.7,6,37,43,23,29,13,10,4,98
420573,470_15_11,EGYPT,13947,1,kamal khalifa,29,6,9,66.7,4,5,80,2,4,50,1,1,100,2,4,6,4,3,2,3,0,15
420574,470_15_11,EGYPT,21074,4,ehab amin,16,3,6,50,1,3,33.3,2,3,66.7,1,2,50,0,1,1,3,2,2,2,0,9
420575,470_15_11,EGYPT,25438,5,amr gendy,20,1,2,50,1,2,50,0,0,0,1,4,25,0,2,2,2,3,2,1,0,3
420576,470_15_11,EGYPT,9152,6,ramy gunady,15,5,9,55.6,3,4,75,2,5,40,0,0,0,0,0,0,2,4,1,2,0,12
420577,470_15_11,EGYPT,9154,9,ibrahim elgammal,21,4,11,36.4,2,8,25,2,3,66.7,3,4,75,0,1,1,2,1,1,1,0,13
420578,470_15_11,EGYPT,28081,10,ahmed tawfik,23,3,6,50,1,1,100,2,5,40,0,0,0,1,0,1,1,3,2,0,0,8
420579,470_15_11,EGYPT,28082,11,aly ahmed,1,0,0,0,0,0,0,0,0,0,0,2,0,0,0,0,0,1,1,0,0,0
420580,470_15_11,EGYPT,16644,12,youssef shousha,27,2,6,33.3,2,4,50,0,2,0,0,4,0,4,8,12,2,5,2,1,1,4
420581,470_15_11,EGYPT,13949,14,ramy abdallah,11,0,1,0,0,0,0,0,1,0,2,2,100,2,1,3,0,5,1,0,0,2
420582,470_15_11,EGYPT,28083,30,ahmed elmaragi,0,0,0,0,0,0,0,0,0,0,0,0,0,0,0,0,0,0,0,0,0,0
420583,470_15_11,EGYPT,18381,50,assem marei,30,3,9,33.3,3,9,33.3,0,0,0,7,14,50,4,4,8,4,5,3,1,1,13
420584,470_15_11,EGYPT,11817,55,omar oraby,7,2,3,66.7,2,3,66.7,0,0,0,0,0,0,0,0,0,0,1,0,0,0,4
420585,470_15_11,EGYPT,0,TOTALS,EGYPT,200,29,62,46.8,19,39,48.7,10,23,43.5,15,33,45.5,13,28,41,20,33,18,11,2,83
420586,470_15_11,CAMEROON,28107,4,arnaud adala moto,15,2,5,40,2,2,100,0,3,0,8,9,88.9,0,2,2,2,4,1,1,0,12
420587,470_15_11,CAMEROON,28108,5,aldo curti,18,2,4,50,1,2,50,1,2,50,0,0,0,1,3,4,0,3,4,2,0,5
420588,470_15_11,CAMEROON,9200,6,parfait bitee,0,0,0,0,0,0,0,0,0,0,0,0,0,0,0,0,0,0,0,0,0,0
420589,470_15_11,CAMEROON,28109,7,kenneth kadji,24,2,12,16.7,1,6,16.7,1,6,16.7,6,8,75,1,9,10,1,4,3,0,1,11
420590,470_15_11,CAMEROON,11673,8,harding nana,24,1,5,20,0,2,0,1,3,33.3,2,2,100,0,3,3,0,1,2,1,0,5
420591,470_15_11,CAMEROON,23129,9,jeremy nzeulie,35,5,12,41.7,2,4,50,3,8,37.5,6,8,75,0,1,1,2,1,3,0,1,19
420592,470_15_11,CAMEROON,28110,10,seidou njoya,16,1,3,33.3,1,2,50,0,1,0,6,7,85.7,1,1,2,0,0,1,0,0,8
420593,470_15_11,CAMEROON,11960,11,frank tchoubaye,19,3,7,42.9,2,3,66.7,1,4,25,3,5,60,3,2,5,1,1,2,0,1,10
420594,470_15_11,CAMEROON,11676,12,alexis wangmene,14,1,3,33.3,1,2,50,0,1,0,0,0,0,2,0,2,0,4,2,0,0,2
420595,470_15_11,CAMEROON,28111,13,boris siakam,5,0,0,0,0,0,0,0,0,0,0,0,0,1,0,1,1,3,1,0,0,0
420596,470_15_11,CAMEROON,23130,14,steve moundou missi,16,2,8,25,2,7,28.6,0,1,0,1,3,33.3,4,2,6,1,3,2,1,0,5
420597,470_15_11,CAMEROON,9206,15,gaston essengue,14,0,1,0,0,0,0,0,1,0,0,0,0,1,2,3,0,5,2,1,0,0
420598,470_15_11,CAMEROON,0,TOTALS,CAMEROON,200,19,60,31.7,12,30,40,7,30,23.3,32,42,76.2,16,28,44,8,29,23,6,3,77
420599,470_15_12,TUNISIA,18347,4,omar abada,14,0,2,0,0,0,0,0,2,0,1,2,50,0,0,0,0,2,1,0,0,1
420600,470_15_12,TUNISIA,28112,5,mohamed abbassi,3,1,2,50,1,2,50,0,0,0,0,0,0,0,0,0,0,1,0,0,0,2
420601,470_15_12,TUNISIA,9216,6,nizar knioua,15,0,4,0,0,2,0,0,2,0,0,0,0,0,1,1,1,1,3,2,0,0
420602,470_15_12,TUNISIA,18521,7,mourad el mabrouk,16,2,8,25,2,2,100,0,6,0,1,2,50,1,1,2,2,1,2,0,0,5
420603,470_15_12,TUNISIA,28113,8,mehdi seyeh,10,0,2,0,0,2,0,0,0,0,1,2,50,0,1,1,1,0,0,0,0,1
420604,470_15_12,TUNISIA,9278,9,mohamed hadidane,21,1,7,14.3,0,2,0,1,5,20,0,0,0,0,4,4,3,3,1,1,1,3
420605,470_15_12,TUNISIA,28114,10,michael brandon roll,29,4,10,40,3,5,60,1,5,20,3,4,75,3,2,5,2,2,3,1,0,12
420606,470_15_12,TUNISIA,13953,11,mohamed mokhtar ghyaza,15,0,2,0,0,2,0,0,0,0,5,7,71.4,0,1,1,1,0,0,2,0,5
420607,470_15_12,TUNISIA,13954,12,makram ben romdhane,22,4,7,57.1,4,5,80,0,2,0,1,1,100,4,7,11,1,3,2,3,0,9
420608,470_15_12,TUNISIA,9219,13,amine rzig,15,3,5,60,1,2,50,2,3,66.7,2,2,100,1,0,1,0,3,0,0,0,10
420609,470_15_12,TUNISIA,9220,14,hamdi braa,18,1,1,100,1,1,100,0,0,0,6,9,66.7,1,3,4,1,3,1,1,0,8
420610,470_15_12,TUNISIA,13956,15,salah mejri,22,5,8,62.5,5,6,83.3,0,2,0,2,3,66.7,2,4,6,0,5,2,0,2,12
420611,470_15_12,TUNISIA,0,TOTALS,TUNISIA,200,21,58,36.2,17,31,54.8,4,27,14.8,22,32,68.8,14,29,43,12,24,16,10,3,68
420612,470_15_12,CAF,3641,4,destin damachoua,33,2,10,20,0,5,0,2,5,40,1,2,50,1,3,4,0,3,9,3,0,7
420613,470_15_12,CAF,28097,5,joseph madozein,0,0,0,0,0,0,0,0,0,0,0,0,0,0,0,0,0,0,0,0,0,0
420614,470_15_12,CAF,28098,6,junior pehoua,22,1,8,12.5,1,3,33.3,0,5,0,1,4,25,3,2,5,1,5,0,0,0,3
420615,470_15_12,CAF,28099,7,freddy-glenn feidanga-temodea,12,0,0,0,0,0,0,0,0,0,0,2,0,0,1,1,0,3,1,0,0,0
420616,470_15_12,CAF,28100,8,johan roy stanley grebongo,32,3,10,30,2,4,50,1,6,16.7,4,7,57.1,2,6,8,1,4,1,0,0,11
420617,470_15_12,CAF,28101,9,dimitri kongbo,10,0,1,0,0,1,0,0,0,0,0,0,0,1,0,1,1,2,0,0,0,0
420618,470_15_12,CAF,28102,10,sydney pehoua,6,0,1,0,0,1,0,0,0,0,0,0,0,0,1,1,0,0,0,0,0,0
420619,470_15_12,CAF,13988,11,yannick zachee,14,1,2,50,1,1,100,0,1,0,2,4,50,0,2,2,2,2,2,2,0,4
420620,470_15_12,CAF,9195,12,max severin febou yadapa,0,0,0,0,0,0,0,0,0,0,0,0,0,0,0,0,0,0,0,0,0,0
420621,470_15_12,CAF,13989,13,max kouguere,36,8,17,47.1,7,10,70,1,7,14.3,3,5,60,1,6,7,1,3,3,2,0,20
420622,470_15_12,CAF,28103,14,philippe djada mabada,5,0,0,0,0,0,0,0,0,0,0,0,0,0,0,0,0,1,0,0,0,0
420623,470_15_12,CAF,11782,15,jimmy djimrabaye,30,2,7,28.6,2,5,40,0,2,0,3,6,50,2,6,8,1,2,2,0,0,7
420624,470_15_12,CAF,0,TOTALS,CAF,200,17,56,30.4,13,30,43.3,4,26,15.4,14,30,46.7,14,28,42,7,27,18,7,0,52
420625,470_15_13,COTE D'IVOIRE,28122,4,serge asselain,26,4,13,30.8,1,3,33.3,3,10,30,1,6,16.7,3,2,5,2,5,1,1,0,12
420626,470_15_13,COTE D'IVOIRE,9166,5,souleyman diabate,36,6,11,54.5,2,3,66.7,4,8,50,1,1,100,2,3,5,8,0,0,6,0,17
420627,470_15_13,COTE D'IVOIRE,28123,7,cedric kouadio,15,1,2,50,1,1,100,0,1,0,0,0,0,1,2,3,1,0,2,0,0,2
420628,470_15_13,COTE D'IVOIRE,28124,8,kehasson oulai,0,0,0,0,0,0,0,0,0,0,0,0,0,0,0,0,0,0,0,0,0,0
420629,470_15_13,COTE D'IVOIRE,3659,9,morlaye bangoura,0,0,0,0,0,0,0,0,0,0,0,0,0,0,0,0,0,0,0,0,0,0
420630,470_15_13,COTE D'IVOIRE,11801,10,alassane meite,29,3,8,37.5,3,5,60,0,3,0,1,2,50,0,3,3,3,1,4,2,0,7
420631,470_15_13,COTE D'IVOIRE,9162,11,jean-philippe koffi,28,0,3,0,0,1,0,0,2,0,2,2,100,1,4,5,0,4,0,0,0,2
420632,470_15_13,COTE D'IVOIRE,28125,12,eudes bahin,12,0,3,0,0,2,0,0,1,0,0,0,0,1,0,1,0,2,2,0,0,0
420633,470_15_13,COTE D'IVOIRE,9164,13,eric tape,30,5,13,38.5,5,12,41.7,0,1,0,3,4,75,3,7,10,1,4,1,3,1,13
420634,470_15_13,COTE D'IVOIRE,13983,14,namori meite,16,1,4,25,1,2,50,0,2,0,1,2,50,1,4,5,0,1,0,0,0,3
420635,470_15_13,COTE D'IVOIRE,28126,15,aboubacar hima,8,2,2,100,2,2,100,0,0,0,4,5,80,0,2,2,0,3,3,0,0,8
420636,470_15_13,COTE D'IVOIRE,0,TOTALS,COTE D'IVOIRE,200,22,59,37.3,15,31,48.4,7,28,25,13,22,59.1,12,29,41,15,20,15,12,1,64
420637,470_15_13,ZIMBABWE,9324,4,taurai chitsinde,23,3,6,50,1,4,25,2,2,100,1,4,25,3,2,5,1,0,1,0,0,9
420638,470_15_13,ZIMBABWE,14048,5,tawanda chitsinde,35,4,14,28.6,1,4,25,3,10,30,0,0,0,0,1,1,1,1,0,1,0,11
420639,470_15_13,ZIMBABWE,28142,6,simbarashe mungomezi,9,0,0,0,0,0,0,0,0,0,0,0,0,0,0,0,1,3,1,1,0,0
420640,470_15_13,ZIMBABWE,28143,7,tinotenda mugabe,7,1,3,33.3,1,2,50,0,1,0,0,0,0,0,1,1,1,1,0,0,0,2
420641,470_15_13,ZIMBABWE,28144,8,moses muyambo,9,0,2,0,0,1,0,0,1,0,1,2,50,0,0,0,0,2,3,0,0,1
420642,470_15_13,ZIMBABWE,9329,9,eric banda,21,1,2,50,1,1,100,0,1,0,0,0,0,1,4,5,1,3,4,0,0,2
420643,470_15_13,ZIMBABWE,9328,10,duncan shenje,9,0,5,0,0,1,0,0,4,0,0,0,0,1,1,2,0,1,1,1,0,0
420644,470_15_13,ZIMBABWE,11891,11,vitalis chikoko,26,6,6,100,6,6,100,0,0,0,5,10,50,4,6,10,0,4,1,0,2,17
420645,470_15_13,ZIMBABWE,11885,12,tatenda maturure,31,3,14,21.4,3,10,30,0,4,0,2,3,66.7,0,6,6,3,3,6,1,0,8
420646,470_15_13,ZIMBABWE,28145,13,everisto pasipamire,15,0,1,0,0,1,0,0,0,0,0,0,0,1,2,3,0,2,4,0,1,0
420647,470_15_13,ZIMBABWE,28146,14,brian hore,15,0,3,0,0,3,0,0,0,0,2,4,50,0,2,2,1,0,0,0,0,2
420648,470_15_13,ZIMBABWE,28147,15,neville chivanganye,2,0,0,0,0,0,0,0,0,0,0,0,0,0,2,2,0,0,0,0,0,0
420649,470_15_13,ZIMBABWE,0,TOTALS,ZIMBABWE,200,18,56,32.1,13,33,39.4,5,23,21.7,11,23,47.8,15,29,44,9,20,21,4,3,52
420650,470_15_14,MOZAMBIQUE,28131,4,hugo martins,5,1,2,50,1,2,50,0,0,0,0,0,0,0,0,0,1,2,1,0,0,2
420651,470_15_14,MOZAMBIQUE,9320,5,armando baptista,14,1,1,100,1,1,100,0,0,0,1,2,50,0,2,2,1,2,0,0,0,3
420652,470_15_14,MOZAMBIQUE,7042,6,david canivete,30,2,10,20,1,6,16.7,1,4,25,5,6,83.3,2,2,4,1,3,2,1,1,10
420653,470_15_14,MOZAMBIQUE,11728,7,ermelindo novela,0,0,0,0,0,0,0,0,0,0,0,0,0,0,0,0,0,0,0,0,0,0
420654,470_15_14,MOZAMBIQUE,18509,8,augusto matos,29,5,20,25,4,13,30.8,1,7,14.3,6,8,75,0,1,1,0,2,1,0,0,17
420655,470_15_14,MOZAMBIQUE,28132,9,helton ubisse,14,2,3,66.7,2,3,66.7,0,0,0,1,2,50,0,1,1,0,3,1,0,0,5
420656,470_15_14,MOZAMBIQUE,28133,10,elton mazive,0,0,0,0,0,0,0,0,0,0,0,0,0,0,0,0,0,0,0,0,0,0
420657,470_15_14,MOZAMBIQUE,3628,11,custodio muchate,28,3,10,30,3,8,37.5,0,2,0,1,4,25,3,2,5,0,4,0,0,0,7
420658,470_15_14,MOZAMBIQUE,3629,12,octavio magolico,34,6,10,60,4,4,100,2,6,33.3,0,1,0,1,2,3,0,1,0,1,0,14
420659,470_15_14,MOZAMBIQUE,11896,13,pio matos,35,5,11,45.5,3,7,42.9,2,4,50,6,6,100,0,4,4,5,0,2,4,0,18
420660,470_15_14,MOZAMBIQUE,28134,14,luis barros,6,0,0,0,0,0,0,0,0,0,0,0,0,0,0,0,1,1,0,0,0,0
420661,470_15_14,MOZAMBIQUE,28135,15,baggio chimonzo,5,0,1,0,0,0,0,0,1,0,0,0,0,0,0,0,1,2,0,1,0,0
420662,470_15_14,MOZAMBIQUE,0,TOTALS,MOZAMBIQUE,200,25,68,36.8,19,44,43.2,6,24,25,20,29,69,9,17,26,10,20,7,7,1,76
420663,470_15_14,SENEGAL,11764,4,thierno niang,7,0,0,0,0,0,0,0,0,0,0,0,0,0,0,0,1,1,2,0,0,0
420664,470_15_14,SENEGAL,18541,5,xane dalmeida,31,3,6,50,3,4,75,0,2,0,2,2,100,2,0,2,8,3,1,0,1,8
420665,470_15_14,SENEGAL,23085,6,ibrahima thomas,6,1,1,100,1,1,100,0,0,0,1,2,50,0,0,0,0,1,0,0,0,3
420666,470_15_14,SENEGAL,18543,7,mohamet diop,14,0,3,0,0,2,0,0,1,0,0,0,0,0,3,3,0,3,1,0,0,0
420667,470_15_14,SENEGAL,13966,8,antoine mendy,30,4,10,40,2,4,50,2,6,33.3,0,0,0,0,4,4,3,2,5,0,0,10
420668,470_15_14,SENEGAL,3592,9,maleye ndoye,36,6,11,54.5,2,4,50,4,7,57.1,0,0,0,1,2,3,0,3,0,0,0,16
420669,470_15_14,SENEGAL,13963,10,ibrahima mbengue,1,0,0,0,0,0,0,0,0,0,0,0,0,0,0,0,0,0,1,0,0,0
420670,470_15_14,SENEGAL,9148,11,mouhammad faye,0,0,0,0,0,0,0,0,0,0,0,0,0,0,0,0,0,0,0,0,0,0
420671,470_15_14,SENEGAL,23090,12,saer sene,9,2,3,66.7,2,3,66.7,0,0,0,0,0,0,1,3,4,0,1,2,0,1,4
420672,470_15_14,SENEGAL,28148,13,cheikh tidiane mbodj,14,1,2,50,1,2,50,0,0,0,3,4,75,0,1,1,0,4,3,0,1,5
420673,470_15_14,SENEGAL,25450,14,gorgui dieng,34,11,18,61.1,9,12,75,2,6,33.3,4,6,66.7,3,15,18,7,4,4,2,0,28
420674,470_15_14,SENEGAL,23091,15,pape abdou badji,18,5,7,71.4,5,7,71.4,0,0,0,2,2,100,1,3,4,2,3,2,1,0,12
420675,470_15_14,SENEGAL,0,TOTALS,SENEGAL,200,33,61,54.1,25,39,64.1,8,22,36.4,12,16,75,11,34,45,21,25,22,3,3,86
420676,470_15_15,CAPE VERDE,23105,4,dimitry coronel,31,3,10,30,2,5,40,1,5,20,2,2,100,2,2,4,0,0,2,4,1,9
420677,470_15_15,CAPE VERDE,11659,5,jeff xavier,30,9,22,40.9,5,8,62.5,4,14,28.6,2,2,100,0,4,4,4,2,3,2,0,24
420678,470_15_15,CAPE VERDE,13950,6,ivan almeida,39,9,17,52.9,7,12,58.3,2,5,40,5,6,83.3,1,6,7,2,5,3,4,2,25
420679,470_15_15,CAPE VERDE,23107,7,braima freire,2,0,0,0,0,0,0,0,0,0,0,0,0,0,0,0,1,1,0,0,0,0
420680,470_15_15,CAPE VERDE,28127,8,mario correia,21,1,7,14.3,0,2,0,1,5,20,1,2,50,0,3,3,3,3,0,0,1,4
420681,470_15_15,CAPE VERDE,13951,9,joel almeida,20,2,9,22.2,0,1,0,2,8,25,0,0,0,1,2,3,0,2,0,2,0,6
420682,470_15_15,CAPE VERDE,28128,10,michael mendes,0,0,0,0,0,0,0,0,0,0,0,0,0,0,0,0,0,0,0,0,0,0
420683,470_15_15,CAPE VERDE,28129,11,fidel mendonca,0,0,0,0,0,0,0,0,0,0,0,0,0,0,0,0,0,0,0,0,0,0
420684,470_15_15,CAPE VERDE,28130,12,keven gomes,0,0,0,0,0,0,0,0,0,0,0,0,0,0,0,0,0,0,0,0,0,0
420685,470_15_15,CAPE VERDE,23112,13,brian rudolph,7,1,1,100,1,1,100,0,0,0,0,0,0,0,0,0,2,1,0,0,0,2
420686,470_15_15,CAPE VERDE,23113,14,kevin coronel,10,0,0,0,0,0,0,0,0,0,0,0,0,0,2,2,0,0,0,0,0,0
420687,470_15_15,CAPE VERDE,9139,15,rodrigo mascarenhas,40,4,7,57.1,4,7,57.1,0,0,0,0,0,0,3,6,9,1,3,2,2,1,8
420688,470_15_15,CAPE VERDE,0,TOTALS,CAPE VERDE,200,29,73,39.7,19,36,52.8,10,37,27,10,12,83.3,7,26,33,13,17,10,14,5,78
420689,470_15_15,ALGERIA,28136,4,yanis mostefat,0,0,0,0,0,0,0,0,0,0,0,0,0,0,0,0,0,0,0,0,0,0
420690,470_15_15,ALGERIA,23100,5,abdesslem dekkiche,31,6,16,37.5,6,12,50,0,4,0,4,5,80,4,3,7,2,5,4,0,0,16
420691,470_15_15,ALGERIA,28137,6,faycal ramdane sahraoui,6,0,1,0,0,1,0,0,0,0,2,2,100,0,3,3,0,0,1,0,0,2
420692,470_15_15,ALGERIA,28138,7,samir mekdad,22,1,5,20,0,2,0,1,3,33.3,0,0,0,1,4,5,1,4,1,0,0,3
420693,470_15_15,ALGERIA,28139,8,mounir benzegala,34,1,5,20,0,1,0,1,4,25,0,0,0,2,5,7,5,4,0,1,0,3
420694,470_15_15,ALGERIA,11747,9,mohamed harat,15,3,3,100,3,3,100,0,0,0,3,6,50,0,4,4,2,2,3,0,0,9
420695,470_15_15,ALGERIA,11758,10,mohamed zerouali,12,3,5,60,3,5,60,0,0,0,1,2,50,0,2,2,2,0,0,1,0,7
420696,470_15_15,ALGERIA,28140,11,touhami ghezzoul,10,1,4,25,1,4,25,0,0,0,0,0,0,0,1,1,0,0,2,0,1,2
420697,470_15_15,ALGERIA,28141,12,kamel abdel-magid ammour,7,2,3,66.7,2,2,100,0,1,0,2,2,100,2,1,3,0,1,0,1,0,6
420698,470_15_15,ALGERIA,23102,13,hocine gaham,26,1,7,14.3,1,4,25,0,3,0,0,0,0,2,6,8,1,2,3,2,0,2
420699,470_15_15,ALGERIA,10431,14,mehdi cheriet,36,8,12,66.7,7,11,63.6,1,1,100,2,2,100,0,3,3,0,1,6,0,0,19
420700,470_15_15,ALGERIA,23103,15,mohamed sedik touati,2,0,1,0,0,1,0,0,0,0,0,0,0,0,0,0,0,0,1,0,0,0
420701,470_15_15,ALGERIA,0,TOTALS,ALGERIA,200,26,62,41.9,23,46,50,3,16,18.8,14,19,73.7,12,36,48,13,19,23,5,1,69
420702,470_15_16,ANGOLA,13818,4,edson ndoniema,12,3,5,60,1,3,33.3,2,2,100,3,3,100,1,0,1,1,2,1,1,0,11
420703,470_15_16,ANGOLA,3574,5,armando costa,17,3,4,75,2,2,100,1,2,50,0,0,0,0,3,3,1,4,3,0,0,7
420704,470_15_16,ANGOLA,3420,6,carlos morais,24,1,7,14.3,1,3,33.3,0,4,0,7,11,63.6,2,1,3,0,3,0,1,0,9
420705,470_15_16,ANGOLA,16597,7,roberto fortes,17,1,5,20,1,3,33.3,0,2,0,4,4,100,2,2,4,1,1,2,0,0,6
420706,470_15_16,ANGOLA,11834,8,hermenegildo santos,4,0,0,0,0,0,0,0,0,0,0,0,0,0,0,0,1,2,0,0,0,0
420707,470_15_16,ANGOLA,11630,9,leonel paulo,28,3,3,100,3,3,100,0,0,0,0,1,0,0,2,2,1,3,1,5,0,6
420708,470_15_16,ANGOLA,7039,10,valdelicio macanga maia joaquim,8,1,5,20,1,4,25,0,1,0,2,2,100,0,0,0,0,1,0,0,0,4
420709,470_15_16,ANGOLA,23104,11,reggie moore,13,1,1,100,0,0,0,1,1,100,2,2,100,0,2,2,1,1,1,0,0,5
420710,470_15_16,ANGOLA,9123,12,felizardo ambrosio,16,1,4,25,1,2,50,0,2,0,2,3,66.7,0,1,1,0,1,2,0,0,4
420711,470_15_16,ANGOLA,11831,13,yanick moreira,19,2,8,25,1,7,14.3,1,1,100,0,0,0,2,3,5,0,3,4,1,1,5
420712,470_15_16,ANGOLA,13819,14,braulio morais,19,0,2,0,0,0,0,0,2,0,2,2,100,0,2,2,1,3,2,0,0,2
420713,470_15_16,ANGOLA,12,15,eduardo mingas,25,4,8,50,4,5,80,0,3,0,1,2,50,3,3,6,1,2,2,0,0,9
420714,470_15_16,ANGOLA,0,TOTALS,ANGOLA,200,20,52,38.5,15,32,46.9,5,20,25,23,30,76.7,15,20,35,8,27,19,8,1,68
420715,470_15_16,MOROCCO,18539,4,reda ali harras,24,4,9,44.4,3,6,50,1,3,33.3,4,6,66.7,1,2,3,0,3,2,2,0,13
420716,470_15_16,MOROCCO,11820,5,zakaria ait fatah,0,0,0,0,0,0,0,0,0,0,0,0,0,0,0,0,0,0,0,0,0,0
420717,470_15_16,MOROCCO,9124,6,soufiane kourodu,27,4,6,66.7,4,6,66.7,0,0,0,2,2,100,0,3,3,2,4,2,0,0,10
420718,470_15_16,MOROCCO,23152,7,abdelali lahrichi,0,0,0,0,0,0,0,0,0,0,0,0,0,0,0,0,0,0,0,0,0,0
420719,470_15_16,MOROCCO,3576,8,mustapha khalfi,35,0,5,0,0,1,0,0,4,0,3,3,100,1,3,4,4,3,3,1,0,3
420720,470_15_16,MOROCCO,18538,9,omar laanani,21,2,3,66.7,1,2,50,1,1,100,2,2,100,1,1,2,0,4,0,2,0,7
420721,470_15_16,MOROCCO,28149,10,mohamed choua,16,1,2,50,1,2,50,0,0,0,0,0,0,0,0,0,2,5,2,1,0,2
420722,470_15_16,MOROCCO,14004,11,abdelhakim zouita,29,4,7,57.1,4,6,66.7,0,1,0,3,5,60,1,4,5,3,3,3,0,0,11
420723,470_15_16,MOROCCO,14002,12,walid dahmani,0,0,0,0,0,0,0,0,0,0,0,0,0,0,0,0,0,0,0,0,0,0
420724,470_15_16,MOROCCO,28150,13,adil el makssoud,32,2,11,18.2,2,7,28.6,0,4,0,3,7,42.9,1,2,3,1,1,1,0,0,7
420725,470_15_16,MOROCCO,11818,14,hamza zehouani,0,0,0,0,0,0,0,0,0,0,0,0,0,0,0,0,0,0,0,0,0,0
420726,470_15_16,MOROCCO,9126,15,abderrahim najah,17,5,6,83.3,4,5,80,1,1,100,3,3,100,3,3,6,1,5,3,1,0,14
420727,470_15_16,MOROCCO,0,TOTALS,MOROCCO,200,22,49,44.9,19,35,54.3,3,14,21.4,20,28,71.4,10,20,30,13,28,16,7,0,67
420728,470_15_17,CAMEROON,28107,4,arnaud adala moto,26,4,8,50,2,5,40,2,3,66.7,4,4,100,4,3,7,6,2,3,3,0,14
420729,470_15_17,CAMEROON,28108,5,aldo curti,21,1,7,14.3,0,2,0,1,5,20,1,2,50,0,1,1,1,2,4,2,0,4
420730,470_15_17,CAMEROON,9200,6,parfait bitee,13,1,6,16.7,0,2,0,1,4,25,1,2,50,0,0,0,2,2,1,0,1,4
420731,470_15_17,CAMEROON,28109,7,kenneth kadji,10,0,2,0,0,1,0,0,1,0,2,2,100,0,3,3,0,2,1,0,0,2
420732,470_15_17,CAMEROON,11673,8,harding nana,13,1,3,33.3,0,2,0,1,1,100,2,2,100,0,6,6,0,1,1,0,0,5
420733,470_15_17,CAMEROON,23129,9,jeremy nzeulie,31,8,13,61.5,3,5,60,5,8,62.5,4,5,80,0,4,4,3,3,2,1,0,25
420734,470_15_17,CAMEROON,28110,10,seidou njoya,0,0,0,0,0,0,0,0,0,0,0,0,0,0,0,0,0,0,0,0,0,0
420735,470_15_17,CAMEROON,11960,11,frank tchoubaye,17,3,7,42.9,1,4,25,2,3,66.7,7,8,87.5,0,5,5,2,4,3,4,1,15
420736,470_15_17,CAMEROON,11676,12,alexis wangmene,16,3,3,100,3,3,100,0,0,0,3,7,42.9,3,4,7,0,3,0,1,0,9
420737,470_15_17,CAMEROON,28111,13,boris siakam,20,1,2,50,1,2,50,0,0,0,3,5,60,0,2,2,0,3,3,1,0,5
420738,470_15_17,CAMEROON,23130,14,steve moundou missi,21,2,4,50,2,3,66.7,0,1,0,4,8,50,2,3,5,2,5,4,2,0,8
420739,470_15_17,CAMEROON,9206,15,gaston essengue,13,0,2,0,0,1,0,0,1,0,2,2,100,0,1,1,0,2,2,0,1,2
420740,470_15_17,CAMEROON,0,TOTALS,CAMEROON,200,24,57,42.1,12,30,40,12,27,44.4,33,47,70.2,11,33,44,16,29,24,14,3,93
420741,470_15_17,GABON,28084,4,samuel styve ndong,30,1,4,25,1,4,25,0,0,0,0,0,0,1,0,1,2,1,3,0,0,2
420742,470_15_17,GABON,28085,5,rodrigue mouckaga atsu,18,2,6,33.3,2,2,100,0,4,0,1,2,50,0,2,2,2,4,1,2,0,5
420743,470_15_17,GABON,28086,6,gyll therence mayimba,15,2,8,25,1,3,33.3,1,5,20,0,0,0,3,4,7,1,5,2,0,0,5
420744,470_15_17,GABON,28087,7,lerry rostand essono mve,20,4,4,100,4,4,100,0,0,0,1,2,50,0,3,3,1,4,1,2,0,9
420745,470_15_17,GABON,28088,8,aymar-kabrel boundou,21,3,11,27.3,2,5,40,1,6,16.7,3,3,100,0,2,2,1,4,7,3,0,10
420746,470_15_17,GABON,9385,9,silvere abessolo toung,0,0,0,0,0,0,0,0,0,0,0,0,0,0,0,0,0,0,0,0,0,0
420747,470_15_17,GABON,28089,10,lin francis kobangoye ikinda,29,5,11,45.5,1,1,100,4,10,40,4,4,100,0,1,1,0,3,3,4,0,18
420748,470_15_17,GABON,28090,11,marvin joy mapaga,7,0,4,0,0,3,0,0,1,0,0,0,0,0,2,2,0,5,2,1,1,0
420749,470_15_17,GABON,28091,12,jason reteno,3,0,0,0,0,0,0,0,0,0,0,0,0,0,0,0,0,3,1,0,0,0
420750,470_15_17,GABON,28092,13,stephane lasme,32,4,10,40,4,9,44.4,0,1,0,6,6,100,2,4,6,1,3,2,1,3,14
420751,470_15_17,GABON,28093,14,freddy obame obame,19,1,6,16.7,1,5,20,0,1,0,1,1,100,1,4,5,0,2,2,0,0,3
420752,470_15_17,GABON,28094,15,lionel fabre,6,0,1,0,0,1,0,0,0,0,1,2,50,0,0,0,0,2,0,0,0,1
420753,470_15_17,GABON,0,TOTALS,GABON,200,22,65,33.8,16,37,43.2,6,28,21.4,17,20,85,9,26,35,8,36,27,13,4,67
420754,470_15_18,CAF,3641,4,destin damachoua,35,4,13,30.8,2,7,28.6,2,6,33.3,4,7,57.1,0,3,3,0,4,4,4,0,14
420755,470_15_18,CAF,28097,5,joseph madozein,5,0,0,0,0,0,0,0,0,0,0,0,0,0,0,0,1,1,1,0,0,0
420756,470_15_18,CAF,28098,6,junior pehoua,29,2,9,22.2,0,3,0,2,6,33.3,0,0,0,0,0,0,1,2,2,0,0,6
420757,470_15_18,CAF,28099,7,freddy-glenn feidanga-temodea,5,0,2,0,0,2,0,0,0,0,1,2,50,1,0,1,0,4,1,0,0,1
420758,470_15_18,CAF,28100,8,johan roy stanley grebongo,26,3,9,33.3,3,7,42.9,0,2,0,1,1,100,3,10,13,1,3,2,0,0,7
420759,470_15_18,CAF,28101,9,dimitri kongbo,13,1,3,33.3,1,2,50,0,1,0,0,0,0,0,4,4,0,4,1,0,0,2
420760,470_15_18,CAF,28102,10,sydney pehoua,6,1,1,100,1,1,100,0,0,0,1,2,50,1,1,2,0,1,0,0,0,3
420761,470_15_18,CAF,13988,11,yannick zachee,9,1,2,50,1,2,50,0,0,0,0,2,0,0,2,2,0,0,2,0,0,2
420762,470_15_18,CAF,9195,12,max severin febou yadapa,3,1,1,100,1,1,100,0,0,0,0,0,0,0,0,0,0,1,0,0,0,2
420763,470_15_18,CAF,13989,13,max kouguere,35,4,13,30.8,3,8,37.5,1,5,20,3,5,60,3,2,5,0,2,0,0,0,12
420764,470_15_18,CAF,28103,14,philippe djada mabada,12,1,2,50,0,0,0,1,2,50,0,0,0,0,2,2,0,2,1,0,0,3
420765,470_15_18,CAF,11782,15,jimmy djimrabaye,22,3,6,50,3,5,60,0,1,0,2,2,100,2,6,8,2,4,1,1,0,8
420766,470_15_18,CAF,0,TOTALS,CAF,200,21,61,34.4,15,38,39.5,6,23,26.1,12,21,57.1,14,35,49,5,28,18,5,0,60
420767,470_15_18,UGANDA,28115,4,stanley ocitti,29,2,10,20,2,9,22.2,0,1,0,1,4,25,2,3,5,0,3,2,0,0,5
420768,470_15_18,UGANDA,28116,5,jimmy enabu,13,1,6,16.7,1,5,20,0,1,0,4,5,80,1,2,3,5,5,0,1,0,6
420769,470_15_18,UGANDA,14035,7,joseph ikong,0,0,0,0,0,0,0,0,0,0,0,0,0,0,0,0,0,0,0,0,0,0
420770,470_15_18,UGANDA,28117,8,josh johnson,16,2,4,50,1,2,50,1,2,50,2,6,33.3,0,2,2,1,2,3,0,0,7
420771,470_15_18,UGANDA,28118,9,samuel mukooza,32,3,15,20,0,5,0,3,10,30,0,0,0,1,3,4,2,1,2,0,0,9
420772,470_15_18,UGANDA,6470,10,kassim nagwere,22,1,5,20,0,2,0,1,3,33.3,0,0,0,2,2,4,2,1,1,2,0,3
420773,470_15_18,UGANDA,28119,11,samuel kalwanyi,13,1,1,100,1,1,100,0,0,0,0,2,0,1,1,2,0,3,0,0,1,2
420774,470_15_18,UGANDA,14033,12,stephen omwony,36,3,16,18.8,1,5,20,2,11,18.2,1,2,50,2,6,8,2,2,2,1,0,9
420775,470_15_18,UGANDA,28120,13,dhal marial,0,0,0,0,0,0,0,0,0,0,0,0,0,0,0,0,0,0,0,0,0,0
420776,470_15_18,UGANDA,14037,14,henry malinga,6,0,0,0,0,0,0,0,0,0,0,2,0,0,1,1,0,0,0,0,0,0
420777,470_15_18,UGANDA,28121,15,brandon sebirumbi,33,5,7,71.4,5,7,71.4,0,0,0,5,11,45.5,5,8,13,3,3,1,0,1,15
420778,470_15_18,UGANDA,0,TOTALS,UGANDA,200,18,64,28.1,11,36,30.6,7,28,25,13,32,40.6,17,31,48,15,20,12,4,2,56
420779,470_15_19,MALI,23144,4,ibrahim saounera,23,2,10,20,2,4,50,0,6,0,2,3,66.7,0,3,3,2,2,1,0,0,6
420780,470_15_19,MALI,11717,5,mahamadou kante,17,1,3,33.3,0,0,0,1,3,33.3,0,0,0,0,4,4,3,2,4,2,0,3
420781,470_15_19,MALI,11718,6,abdrahamane maiga,0,0,0,0,0,0,0,0,0,0,0,0,0,0,0,0,0,0,0,0,0,0
420782,470_15_19,MALI,28104,7,ibrahim djambo,14,1,5,20,1,2,50,0,3,0,0,0,0,1,2,3,0,1,0,0,0,2
420783,470_15_19,MALI,7055,8,waly coulibaly,12,1,1,100,0,0,0,1,1,100,0,0,0,0,1,1,0,0,0,0,0,3
420784,470_15_19,MALI,11976,9,boubacar moungoro,20,3,8,37.5,1,2,50,2,6,33.3,2,4,50,0,1,1,1,3,3,1,0,10
420785,470_15_19,MALI,28105,10,mohamed bah,15,1,2,50,1,2,50,0,0,0,1,2,50,0,2,2,1,4,1,1,0,3
420786,470_15_19,MALI,23146,11,namory boundy,17,0,1,0,0,0,0,0,1,0,1,2,50,2,2,4,2,1,1,0,0,1
420787,470_15_19,MALI,23147,12,boubacar sidibe,13,0,3,0,0,2,0,0,1,0,2,2,100,2,1,3,0,2,1,1,0,2
420788,470_15_19,MALI,1768,13,souarata cisse,23,3,11,27.3,1,5,20,2,6,33.3,2,2,100,0,2,2,1,0,0,0,0,10
420789,470_15_19,MALI,18495,14,mohamed tangara,33,1,4,25,1,4,25,0,0,0,3,3,100,2,3,5,1,3,2,1,0,5
420790,470_15_19,MALI,28106,15,drissa ballo,13,2,2,100,2,2,100,0,0,0,0,0,0,0,3,3,0,1,2,0,0,4
420791,470_15_19,MALI,0,TOTALS,MALI,200,15,50,30,9,23,39.1,6,27,22.2,13,18,72.2,7,28,35,11,20,18,6,0,49
420792,470_15_19,EGYPT,13947,1,kamal khalifa,31,0,4,0,0,2,0,0,2,0,3,6,50,1,2,3,3,2,2,0,1,3
420793,470_15_19,EGYPT,21074,4,ehab amin,16,3,6,50,3,3,100,0,3,0,0,0,0,1,2,3,1,1,3,2,0,6
420794,470_15_19,EGYPT,25438,5,amr gendy,19,3,5,60,2,2,100,1,3,33.3,2,3,66.7,0,1,1,1,3,0,0,0,9
420795,470_15_19,EGYPT,9152,6,ramy gunady,22,3,7,42.9,0,0,0,3,7,42.9,3,3,100,0,1,1,0,2,1,2,0,12
420796,470_15_19,EGYPT,9154,9,ibrahim elgammal,16,2,7,28.6,2,3,66.7,0,4,0,0,0,0,0,0,0,1,2,1,0,0,4
420797,470_15_19,EGYPT,28081,10,ahmed tawfik,17,1,4,25,0,1,0,1,3,33.3,0,2,0,1,1,2,0,1,0,0,0,3
420798,470_15_19,EGYPT,28082,11,aly ahmed,0,0,0,0,0,0,0,0,0,0,0,0,0,0,0,0,0,0,0,0,0,0
420799,470_15_19,EGYPT,16644,12,youssef shousha,20,0,5,0,0,2,0,0,3,0,2,4,50,1,3,4,0,3,2,1,0,2
420800,470_15_19,EGYPT,13949,14,ramy abdallah,15,2,5,40,1,1,100,1,4,25,0,0,0,1,2,3,0,1,2,0,0,5
420801,470_15_19,EGYPT,28083,30,ahmed elmaragi,10,0,2,0,0,1,0,0,1,0,0,0,0,0,1,1,0,2,1,0,0,0
420802,470_15_19,EGYPT,18381,50,assem marei,29,4,7,57.1,4,7,57.1,0,0,0,1,2,50,2,9,11,2,2,0,1,0,9
420803,470_15_19,EGYPT,11817,55,omar oraby,5,1,1,100,1,1,100,0,0,0,0,0,0,1,1,2,0,1,1,0,1,2
420804,470_15_19,EGYPT,0,TOTALS,EGYPT,200,19,53,35.8,13,23,56.5,6,30,20,11,20,55,8,28,36,8,20,15,6,2,55
420805,470_15_20,NIGERIA,23139,4,ben uzoh,27,4,7,57.1,2,5,40,2,2,100,3,4,75,2,3,5,1,3,2,0,1,13
420806,470_15_20,NIGERIA,13976,5,michael umeh,14,1,6,16.7,1,3,33.3,0,3,0,2,2,100,0,1,1,0,1,1,0,0,4
420807,470_15_20,NIGERIA,21026,6,ike diogu,0,0,0,0,0,0,0,0,0,0,0,0,0,0,0,0,0,0,0,0,0,0
420808,470_15_20,NIGERIA,21027,7,al-farouq aminu,27,2,10,20,1,7,14.3,1,3,33.3,2,2,100,2,3,5,1,3,8,0,0,7
420809,470_15_20,NIGERIA,23141,8,jamal olasewere,0,0,0,0,0,0,0,0,0,0,0,0,0,0,0,0,0,0,0,0,0,0
420810,470_15_20,NIGERIA,3647,9,chamberlain oguchi,30,4,9,44.4,1,1,100,3,8,37.5,0,0,0,0,0,0,0,3,1,0,0,11
420811,470_15_20,NIGERIA,23140,10,stan okoye,4,0,0,0,0,0,0,0,0,0,0,0,0,0,1,1,0,0,0,0,0,0
420812,470_15_20,NIGERIA,23143,11,andy ogide,20,2,6,33.3,2,5,40,0,1,0,0,0,0,1,3,4,1,1,2,1,0,4
420813,470_15_20,NIGERIA,28095,12,michael gbinije,23,4,10,40,3,5,60,1,5,20,1,3,33.3,1,0,1,3,0,0,0,0,10
420814,470_15_20,NIGERIA,28096,13,olaseni lawal,27,1,2,50,1,2,50,0,0,0,4,4,100,3,3,6,2,2,5,2,2,6
420815,470_15_20,NIGERIA,21031,14,alade aminu,25,1,3,33.3,1,3,33.3,0,0,0,2,2,100,1,7,8,1,3,2,1,2,4
420816,470_15_20,NIGERIA,3656,15,olumide oyedeji,4,0,0,0,0,0,0,0,0,0,0,0,0,1,2,3,0,0,0,1,0,0
420817,470_15_20,NIGERIA,0,TOTALS,NIGERIA,200,19,53,35.8,12,31,38.7,7,22,31.8,14,17,82.4,13,23,36,9,16,22,5,5,59
420818,470_15_20,TUNISIA,18347,4,omar abada,29,2,5,40,1,1,100,1,4,25,0,0,0,2,1,3,4,4,0,3,0,5
420819,470_15_20,TUNISIA,28112,5,mohamed abbassi,0,0,0,0,0,0,0,0,0,0,0,0,0,0,0,0,0,0,0,0,0,0
420820,470_15_20,TUNISIA,9216,6,nizar knioua,11,0,3,0,0,2,0,0,1,0,0,0,0,0,0,0,1,1,1,0,0,0
420821,470_15_20,TUNISIA,18521,7,mourad el mabrouk,12,1,4,25,0,1,0,1,3,33.3,0,0,0,0,1,1,0,1,1,0,0,3
420822,470_15_20,TUNISIA,28113,8,mehdi seyeh,0,0,0,0,0,0,0,0,0,0,0,0,0,0,0,0,0,0,0,0,0,0
420823,470_15_20,TUNISIA,9278,9,mohamed hadidane,22,2,5,40,1,2,50,1,3,33.3,1,2,50,0,2,2,1,1,2,3,0,6
420824,470_15_20,TUNISIA,28114,10,michael brandon roll,31,6,10,60,3,6,50,3,4,75,1,2,50,0,4,4,3,1,2,0,0,16
420825,470_15_20,TUNISIA,13953,11,mohamed mokhtar ghyaza,8,0,1,0,0,1,0,0,0,0,1,2,50,1,0,1,0,1,0,0,1,1
420826,470_15_20,TUNISIA,13954,12,makram ben romdhane,33,5,16,31.2,3,10,30,2,6,33.3,0,0,0,4,4,8,8,2,2,1,0,12
420827,470_15_20,TUNISIA,9219,13,amine rzig,13,1,4,25,1,1,100,0,3,0,0,0,0,1,1,2,1,4,1,0,0,2
420828,470_15_20,TUNISIA,9220,14,hamdi braa,9,0,2,0,0,1,0,0,1,0,1,2,50,1,1,2,0,1,2,0,0,1
420829,470_15_20,TUNISIA,13956,15,salah mejri,32,8,11,72.7,6,9,66.7,2,2,100,6,8,75,2,5,7,1,3,5,3,3,24
420830,470_15_20,TUNISIA,0,TOTALS,TUNISIA,200,25,61,41,15,34,44.1,10,27,37,10,16,62.5,15,21,36,19,19,16,10,4,70
420831,470_15_21,ZIMBABWE,9324,4,taurai chitsinde,21,0,2,0,0,1,0,0,1,0,9,13,69.2,2,1,3,3,3,3,0,0,9
420832,470_15_21,ZIMBABWE,14048,5,tawanda chitsinde,29,2,9,22.2,0,0,0,2,9,22.2,0,0,0,1,3,4,3,2,2,1,0,6
420833,470_15_21,ZIMBABWE,28142,6,simbarashe mungomezi,25,2,7,28.6,1,4,25,1,3,33.3,2,2,100,1,2,3,1,2,3,1,0,7
420834,470_15_21,ZIMBABWE,28143,7,tinotenda mugabe,11,0,4,0,0,2,0,0,2,0,0,0,0,0,0,0,0,2,3,2,0,0
420835,470_15_21,ZIMBABWE,28144,8,moses muyambo,3,0,0,0,0,0,0,0,0,0,0,0,0,0,0,0,0,0,0,0,0,0
420836,470_15_21,ZIMBABWE,9329,9,eric banda,25,6,10,60,6,8,75,0,2,0,0,0,0,1,4,5,0,5,4,0,0,12
420837,470_15_21,ZIMBABWE,9328,10,duncan shenje,7,2,4,50,1,1,100,1,3,33.3,0,0,0,1,2,3,0,2,0,0,0,5
420838,470_15_21,ZIMBABWE,11891,11,vitalis chikoko,26,4,6,66.7,4,6,66.7,0,0,0,3,3,100,5,6,11,2,5,5,0,2,11
420839,470_15_21,ZIMBABWE,11885,12,tatenda maturure,31,4,13,30.8,4,11,36.4,0,2,0,4,6,66.7,3,6,9,4,1,3,0,1,12
420840,470_15_21,ZIMBABWE,28145,13,everisto pasipamire,8,0,1,0,0,1,0,0,0,0,0,0,0,0,1,1,0,1,1,0,0,0
420841,470_15_21,ZIMBABWE,28146,14,brian hore,4,0,0,0,0,0,0,0,0,0,0,0,0,1,1,2,0,2,0,0,0,0
420842,470_15_21,ZIMBABWE,28147,15,neville chivanganye,10,1,1,100,1,1,100,0,0,0,1,3,33.3,2,1,3,1,2,2,0,0,3
420843,470_15_21,ZIMBABWE,0,TOTALS,ZIMBABWE,200,21,57,36.8,17,35,48.6,4,22,18.2,19,27,70.4,18,29,47,14,28,27,4,3,65
420844,470_15_21,CAPE VERDE,23105,4,dimitry coronel,28,5,10,50,2,5,40,3,5,60,4,8,50,2,1,3,0,2,3,1,1,17
420845,470_15_21,CAPE VERDE,11659,5,jeff xavier,33,4,18,22.2,1,4,25,3,14,21.4,7,9,77.8,2,8,10,4,2,5,2,0,18
420846,470_15_21,CAPE VERDE,13950,6,ivan almeida,28,4,17,23.5,3,8,37.5,1,9,11.1,5,8,62.5,3,2,5,7,4,4,3,2,14
420847,470_15_21,CAPE VERDE,23107,7,braima freire,8,0,1,0,0,0,0,0,1,0,0,0,0,0,0,0,0,1,1,0,0,0
420848,470_15_21,CAPE VERDE,28127,8,mario correia,27,6,15,40,3,6,50,3,9,33.3,3,4,75,2,0,2,2,5,1,3,0,18
420849,470_15_21,CAPE VERDE,13951,9,joel almeida,11,0,4,0,0,0,0,0,4,0,0,0,0,1,2,3,1,1,0,0,0,0
420850,470_15_21,CAPE VERDE,28128,10,michael mendes,1,0,0,0,0,0,0,0,0,0,0,0,0,0,0,0,0,0,1,0,0,0
420851,470_15_21,CAPE VERDE,28129,11,fidel mendonca,0,0,0,0,0,0,0,0,0,0,0,0,0,0,0,0,0,0,0,0,0,0
420852,470_15_21,CAPE VERDE,28130,12,keven gomes,1,0,1,0,0,1,0,0,0,0,0,0,0,0,0,0,0,1,0,0,0,0
420853,470_15_21,CAPE VERDE,23112,13,brian rudolph,0,0,0,0,0,0,0,0,0,0,0,0,0,0,0,0,0,0,0,0,0,0
420854,470_15_21,CAPE VERDE,23113,14,kevin coronel,25,2,4,50,2,4,50,0,0,0,1,2,50,6,6,12,0,3,0,2,0,5
420855,470_15_21,CAPE VERDE,9139,15,rodrigo mascarenhas,39,1,5,20,1,5,20,0,0,0,2,8,25,7,3,10,1,2,1,3,1,4
420856,470_15_21,CAPE VERDE,0,TOTALS,CAPE VERDE,200,22,75,29.3,12,33,36.4,10,42,23.8,22,39,56.4,28,23,51,15,21,17,14,4,76
420857,470_15_22,MOROCCO,18539,4,reda ali harras,23,5,11,45.5,4,5,80,1,6,16.7,0,2,0,3,3,6,2,5,4,0,0,11
420858,470_15_22,MOROCCO,11820,5,zakaria ait fatah,0,0,0,0,0,0,0,0,0,0,0,0,0,0,0,0,0,0,0,0,0,0
420859,470_15_22,MOROCCO,9124,6,soufiane kourodu,27,6,14,42.9,6,13,46.2,0,1,0,9,10,90,6,5,11,0,4,2,2,3,21
420860,470_15_22,MOROCCO,23152,7,abdelali lahrichi,2,0,1,0,0,1,0,0,0,0,0,0,0,0,0,0,1,1,0,0,0,0
420861,470_15_22,MOROCCO,3576,8,mustapha khalfi,36,2,8,25,2,3,66.7,0,5,0,1,1,100,1,2,3,4,3,3,1,0,5
420862,470_15_22,MOROCCO,18538,9,omar laanani,11,0,1,0,0,0,0,0,1,0,0,0,0,0,1,1,0,1,1,0,1,0
420863,470_15_22,MOROCCO,28149,10,mohamed choua,21,5,6,83.3,5,6,83.3,0,0,0,0,1,0,2,3,5,1,2,0,1,0,10
420864,470_15_22,MOROCCO,14004,11,abdelhakim zouita,32,8,11,72.7,8,9,88.9,0,2,0,3,6,50,0,3,3,5,3,5,0,1,19
420865,470_15_22,MOROCCO,14002,12,walid dahmani,0,0,0,0,0,0,0,0,0,0,0,0,0,0,0,0,0,0,0,0,0,0
420866,470_15_22,MOROCCO,28150,13,adil el makssoud,26,1,4,25,1,2,50,0,2,0,1,3,33.3,1,3,4,3,2,1,1,1,3
420867,470_15_22,MOROCCO,11818,14,hamza zehouani,0,0,0,0,0,0,0,0,0,0,0,0,0,0,0,0,0,0,0,0,0,0
420868,470_15_22,MOROCCO,9126,15,abderrahim najah,22,6,10,60,5,8,62.5,1,2,50,0,0,0,2,4,6,3,5,5,2,0,13
420869,470_15_22,MOROCCO,0,TOTALS,MOROCCO,200,33,66,50,31,47,66,2,19,10.5,14,23,60.9,18,25,43,19,27,21,7,6,82
420870,470_15_22,MOZAMBIQUE,28131,4,hugo martins,8,0,0,0,0,0,0,0,0,0,2,2,100,0,0,0,0,3,1,2,0,2
420871,470_15_22,MOZAMBIQUE,9320,5,armando baptista,11,0,0,0,0,0,0,0,0,0,0,0,0,1,1,2,0,3,0,0,0,0
420872,470_15_22,MOZAMBIQUE,7042,6,david canivete,31,6,14,42.9,6,13,46.2,0,1,0,4,6,66.7,4,1,5,2,3,3,3,0,16
420873,470_15_22,MOZAMBIQUE,11728,7,ermelindo novela,0,0,0,0,0,0,0,0,0,0,0,0,0,0,0,0,0,0,0,0,0,0
420874,470_15_22,MOZAMBIQUE,18509,8,augusto matos,33,6,18,33.3,5,9,55.6,1,9,11.1,4,5,80,1,2,3,1,4,2,1,0,17
420875,470_15_22,MOZAMBIQUE,28132,9,helton ubisse,17,3,3,100,3,3,100,0,0,0,0,0,0,0,4,4,1,2,0,0,0,6
420876,470_15_22,MOZAMBIQUE,28133,10,elton mazive,0,0,0,0,0,0,0,0,0,0,0,0,0,0,0,0,0,0,0,0,0,0
420877,470_15_22,MOZAMBIQUE,3628,11,custodio muchate,28,3,8,37.5,2,6,33.3,1,2,50,1,4,25,2,5,7,1,2,0,3,0,8
420878,470_15_22,MOZAMBIQUE,3629,12,octavio magolico,26,3,7,42.9,3,6,50,0,1,0,0,0,0,4,0,4,1,3,0,0,0,6
420879,470_15_22,MOZAMBIQUE,11896,13,pio matos,29,6,13,46.2,4,7,57.1,2,6,33.3,9,10,90,1,3,4,1,0,5,2,0,23
420880,470_15_22,MOZAMBIQUE,28134,14,luis barros,4,0,0,0,0,0,0,0,0,0,0,0,0,0,1,1,0,0,0,0,0,0
420881,470_15_22,MOZAMBIQUE,28135,15,baggio chimonzo,13,2,4,50,1,2,50,1,2,50,2,2,100,0,0,0,2,0,0,0,0,7
420882,470_15_22,MOZAMBIQUE,0,TOTALS,MOZAMBIQUE,200,29,67,43.3,24,46,52.2,5,21,23.8,22,29,75.9,17,18,35,9,21,12,11,0,85
420883,470_15_23,ALGERIA,28136,4,yanis mostefat,12,2,6,33.3,0,0,0,2,6,33.3,2,2,100,0,2,2,1,2,0,0,0,8
420884,470_15_23,ALGERIA,23100,5,abdesslem dekkiche,28,0,3,0,0,2,0,0,1,0,1,2,50,1,1,2,2,2,5,0,0,1
420885,470_15_23,ALGERIA,28137,6,faycal ramdane sahraoui,0,0,0,0,0,0,0,0,0,0,0,0,0,0,0,0,0,0,0,0,0,0
420886,470_15_23,ALGERIA,28138,7,samir mekdad,19,1,7,14.3,1,4,25,0,3,0,3,5,60,0,4,4,0,1,2,0,0,5
420887,470_15_23,ALGERIA,28139,8,mounir benzegala,38,3,10,30,0,1,0,3,9,33.3,0,0,0,1,0,1,4,2,2,0,1,9
420888,470_15_23,ALGERIA,11747,9,mohamed harat,34,12,13,92.3,12,13,92.3,0,0,0,3,5,60,8,6,14,2,3,4,1,2,27
420889,470_15_23,ALGERIA,11758,10,mohamed zerouali,20,3,9,33.3,2,7,28.6,1,2,50,2,5,40,1,3,4,2,0,2,0,0,9
420890,470_15_23,ALGERIA,28140,11,touhami ghezzoul,9,0,0,0,0,0,0,0,0,0,0,0,0,0,2,2,0,2,1,0,0,0
420891,470_15_23,ALGERIA,28141,12,kamel abdel-magid ammour,3,0,2,0,0,1,0,0,1,0,0,0,0,0,0,0,0,0,1,0,0,0
420892,470_15_23,ALGERIA,23102,13,hocine gaham,0,0,0,0,0,0,0,0,0,0,0,0,0,0,0,0,0,0,0,0,0,0
420893,470_15_23,ALGERIA,10431,14,mehdi cheriet,19,6,8,75,4,5,80,2,3,66.7,1,2,50,0,1,1,0,4,2,0,0,15
420894,470_15_23,ALGERIA,23103,15,mohamed sedik touati,18,0,1,0,0,1,0,0,0,0,0,0,0,0,4,4,0,3,1,0,2,0
420895,470_15_23,ALGERIA,0,TOTALS,ALGERIA,200,27,59,45.8,19,34,55.9,8,25,32,12,21,57.1,13,25,38,11,19,20,1,5,74
420896,470_15_23,COTE D'IVOIRE,28122,4,serge asselain,25,2,3,66.7,1,1,100,1,2,50,4,4,100,0,1,1,1,4,0,1,1,9
420897,470_15_23,COTE D'IVOIRE,9166,5,souleyman diabate,39,10,15,66.7,8,8,100,2,7,28.6,4,5,80,0,2,2,6,1,2,1,0,26
420898,470_15_23,COTE D'IVOIRE,28123,7,cedric kouadio,11,1,1,100,1,1,100,0,0,0,0,0,0,0,1,1,1,1,0,0,0,2
420899,470_15_23,COTE D'IVOIRE,28124,8,kehasson oulai,0,0,0,0,0,0,0,0,0,0,0,0,0,0,0,0,0,0,0,0,0,0
420900,470_15_23,COTE D'IVOIRE,3659,9,morlaye bangoura,3,0,0,0,0,0,0,0,0,0,0,0,0,1,0,1,0,1,1,0,0,0
420901,470_15_23,COTE D'IVOIRE,11801,10,alassane meite,23,0,7,0,0,5,0,0,2,0,0,0,0,3,0,3,1,2,0,1,0,0
420902,470_15_23,COTE D'IVOIRE,9162,11,jean-philippe koffi,20,2,11,18.2,2,5,40,0,6,0,0,0,0,0,0,0,1,2,0,0,0,4
420903,470_15_23,COTE D'IVOIRE,28125,12,eudes bahin,28,5,8,62.5,4,6,66.7,1,2,50,3,4,75,2,3,5,2,4,1,1,0,14
420904,470_15_23,COTE D'IVOIRE,9164,13,eric tape,23,6,12,50,6,10,60,0,2,0,3,6,50,3,3,6,4,5,2,2,1,15
420905,470_15_23,COTE D'IVOIRE,13983,14,namori meite,10,0,2,0,0,1,0,0,1,0,0,0,0,1,2,3,1,4,3,0,0,0
420906,470_15_23,COTE D'IVOIRE,28126,15,aboubacar hima,18,5,9,55.6,5,9,55.6,0,0,0,1,1,100,1,3,4,0,1,1,0,0,11
420907,470_15_23,COTE D'IVOIRE,0,TOTALS,COTE D'IVOIRE,200,31,68,45.6,27,46,58.7,4,22,18.2,15,20,75,14,18,32,17,25,10,6,2,81
420908,470_15_24,SENEGAL,11764,4,thierno niang,0,0,0,0,0,0,0,0,0,0,0,0,0,0,0,0,0,0,0,0,0,0
420909,470_15_24,SENEGAL,18541,5,xane dalmeida,36,1,10,10,0,5,0,1,5,20,5,8,62.5,1,4,5,8,0,4,2,0,8
420910,470_15_24,SENEGAL,23085,6,ibrahima thomas,6,1,2,50,1,1,100,0,1,0,1,2,50,1,0,1,0,3,0,0,1,3
420911,470_15_24,SENEGAL,18543,7,mohamet diop,8,1,2,50,1,1,100,0,1,0,0,0,0,0,1,1,0,0,1,0,0,2
420912,470_15_24,SENEGAL,13966,8,antoine mendy,38,7,11,63.6,6,6,100,1,5,20,2,6,33.3,4,2,6,3,3,2,1,0,17
420913,470_15_24,SENEGAL,3592,9,maleye ndoye,34,2,7,28.6,0,3,0,2,4,50,2,2,100,1,2,3,3,4,0,1,0,8
420914,470_15_24,SENEGAL,13963,10,ibrahima mbengue,4,0,0,0,0,0,0,0,0,0,1,2,50,0,0,0,0,0,0,0,0,1
420915,470_15_24,SENEGAL,9148,11,mouhammad faye,0,0,0,0,0,0,0,0,0,0,0,0,0,0,0,0,0,0,0,0,0,0
420916,470_15_24,SENEGAL,23090,12,saer sene,10,1,3,33.3,1,3,33.3,0,0,0,0,0,0,4,0,4,0,3,1,0,1,2
420917,470_15_24,SENEGAL,28148,13,cheikh tidiane mbodj,7,1,3,33.3,1,3,33.3,0,0,0,0,0,0,0,1,1,0,1,0,0,1,2
420918,470_15_24,SENEGAL,25450,14,gorgui dieng,40,5,13,38.5,5,11,45.5,0,2,0,14,17,82.4,3,6,9,1,2,2,1,1,24
420919,470_15_24,SENEGAL,23091,15,pape abdou badji,17,2,4,50,2,4,50,0,0,0,3,4,75,2,3,5,1,1,1,0,0,7
420920,470_15_24,SENEGAL,0,TOTALS,SENEGAL,200,21,55,38.2,17,37,45.9,4,18,22.2,28,41,68.3,17,23,40,16,17,12,5,4,74
420921,470_15_24,ANGOLA,13818,4,edson ndoniema,20,3,6,50,1,2,50,2,4,50,0,0,0,0,0,0,0,5,1,0,0,8
420922,470_15_24,ANGOLA,3574,5,armando costa,23,0,2,0,0,0,0,0,2,0,1,2,50,1,3,4,2,4,1,0,0,1
420923,470_15_24,ANGOLA,3420,6,carlos morais,35,6,21,28.6,1,7,14.3,5,14,35.7,2,2,100,2,3,5,5,1,3,0,0,19
420924,470_15_24,ANGOLA,16597,7,roberto fortes,15,0,1,0,0,1,0,0,0,0,0,0,0,1,0,1,1,0,1,1,0,0
420925,470_15_24,ANGOLA,11834,8,hermenegildo santos,0,0,0,0,0,0,0,0,0,0,0,0,0,0,0,0,0,0,0,0,0,0
420926,470_15_24,ANGOLA,11630,9,leonel paulo,11,3,3,100,2,2,100,1,1,100,0,0,0,1,0,1,0,5,0,0,0,7
420927,470_15_24,ANGOLA,7039,10,valdelicio macanga maia joaquim,0,0,0,0,0,0,0,0,0,0,0,0,0,0,0,0,0,0,0,0,0,0
420928,470_15_24,ANGOLA,23104,11,reggie moore,12,2,6,33.3,1,4,25,1,2,50,2,2,100,1,0,1,0,1,2,1,0,7
420929,470_15_24,ANGOLA,9123,12,felizardo ambrosio,20,2,4,50,2,4,50,0,0,0,0,2,0,3,1,4,0,3,2,0,0,4
420930,470_15_24,ANGOLA,11831,13,yanick moreira,29,5,7,71.4,5,7,71.4,0,0,0,3,3,100,3,4,7,1,4,1,0,3,13
420931,470_15_24,ANGOLA,13819,14,braulio morais,20,5,8,62.5,2,2,100,3,6,50,1,2,50,0,3,3,1,1,1,0,0,14
420932,470_15_24,ANGOLA,12,15,eduardo mingas,15,0,5,0,0,4,0,0,1,0,0,0,0,1,0,1,1,3,0,0,0,0
420933,470_15_24,ANGOLA,0,TOTALS,ANGOLA,200,26,63,41.3,14,33,42.4,12,30,40,9,13,69.2,16,18,34,11,28,12,2,3,73
420934,470_15_25,EGYPT,13947,1,kamal khalifa,18,2,6,33.3,1,2,50,1,4,25,1,2,50,0,7,7,5,2,2,1,0,6
420935,470_15_25,EGYPT,21074,4,ehab amin,18,8,11,72.7,6,7,85.7,2,4,50,0,1,0,0,1,1,2,1,1,2,0,18
420936,470_15_25,EGYPT,25438,5,amr gendy,18,5,8,62.5,3,3,100,2,5,40,0,1,0,2,1,3,2,0,0,3,0,12
420937,470_15_25,EGYPT,9152,6,ramy gunady,18,1,2,50,0,0,0,1,2,50,0,0,0,0,0,0,2,2,0,4,0,3
420938,470_15_25,EGYPT,9154,9,ibrahim elgammal,16,6,12,50,2,3,66.7,4,9,44.4,1,1,100,1,0,1,2,1,1,0,0,17
420939,470_15_25,EGYPT,28081,10,ahmed tawfik,20,1,3,33.3,1,1,100,0,2,0,0,0,0,1,0,1,6,2,0,1,0,2
420940,470_15_25,EGYPT,28082,11,aly ahmed,20,2,7,28.6,2,7,28.6,0,0,0,0,0,0,2,4,6,0,3,0,1,1,4
420941,470_15_25,EGYPT,16644,12,youssef shousha,19,5,9,55.6,2,4,50,3,5,60,3,6,50,3,1,4,0,3,0,0,0,16
420942,470_15_25,EGYPT,13949,14,ramy abdallah,15,3,5,60,0,1,0,3,4,75,2,2,100,1,0,1,0,5,0,0,0,11
420943,470_15_25,EGYPT,28083,30,ahmed elmaragi,14,2,6,33.3,1,3,33.3,1,3,33.3,0,0,0,1,2,3,2,1,1,0,0,5
420944,470_15_25,EGYPT,18381,50,assem marei,15,3,9,33.3,3,9,33.3,0,0,0,2,6,33.3,3,5,8,2,2,0,1,0,8
420945,470_15_25,EGYPT,11817,55,omar oraby,9,0,4,0,0,4,0,0,0,0,0,0,0,2,2,4,0,2,2,0,3,0
420946,470_15_25,EGYPT,0,TOTALS,EGYPT,200,38,82,46.3,21,44,47.7,17,38,44.7,9,19,47.4,21,24,45,23,24,7,13,4,102
420947,470_15_25,ZIMBABWE,9324,4,taurai chitsinde,21,2,2,100,1,1,100,1,1,100,2,2,100,1,1,2,2,3,3,0,0,7
420948,470_15_25,ZIMBABWE,14048,5,tawanda chitsinde,19,1,4,25,0,2,0,1,2,50,2,2,100,0,2,2,0,1,4,1,0,5
420949,470_15_25,ZIMBABWE,28142,6,simbarashe mungomezi,19,1,6,16.7,1,4,25,0,2,0,1,2,50,0,1,1,1,1,1,0,0,3
420950,470_15_25,ZIMBABWE,28143,7,tinotenda mugabe,5,0,1,0,0,1,0,0,0,0,0,0,0,0,1,1,0,0,2,0,0,0
420951,470_15_25,ZIMBABWE,28144,8,moses muyambo,23,1,1,100,1,1,100,0,0,0,1,2,50,1,1,2,1,1,3,1,0,3
420952,470_15_25,ZIMBABWE,9329,9,eric banda,20,4,10,40,4,10,40,0,0,0,1,2,50,1,5,6,1,2,2,1,0,9
420953,470_15_25,ZIMBABWE,9328,10,duncan shenje,19,3,5,60,1,2,50,2,3,66.7,1,2,50,1,3,4,0,3,0,0,0,9
420954,470_15_25,ZIMBABWE,11891,11,vitalis chikoko,37,5,14,35.7,5,12,41.7,0,2,0,7,9,77.8,2,8,10,2,1,4,0,6,17
420955,470_15_25,ZIMBABWE,11885,12,tatenda maturure,15,0,3,0,0,3,0,0,0,0,0,0,0,0,2,2,0,1,1,1,0,0
420956,470_15_25,ZIMBABWE,28145,13,everisto pasipamire,0,0,0,0,0,0,0,0,0,0,0,0,0,0,0,0,0,0,0,0,0,0
420957,470_15_25,ZIMBABWE,28146,14,brian hore,6,1,2,50,1,2,50,0,0,0,1,2,50,0,2,2,0,1,1,0,0,3
420958,470_15_25,ZIMBABWE,28147,15,neville chivanganye,16,3,4,75,3,4,75,0,0,0,0,0,0,1,0,1,0,3,2,0,0,6
420959,470_15_25,ZIMBABWE,0,TOTALS,ZIMBABWE,200,21,52,40.4,17,42,40.5,4,10,40,16,23,69.6,10,28,38,7,17,24,4,6,62
420960,470_15_26,ANGOLA,13818,4,edson ndoniema,16,1,2,50,1,1,100,0,1,0,0,0,0,2,0,2,0,3,1,0,0,2
420961,470_15_26,ANGOLA,3574,5,armando costa,28,2,7,28.6,1,2,50,1,5,20,0,0,0,1,2,3,6,1,2,0,0,5
420962,470_15_26,ANGOLA,3420,6,carlos morais,25,3,8,37.5,1,3,33.3,2,5,40,0,0,0,1,3,4,1,1,5,0,1,8
420963,470_15_26,ANGOLA,16597,7,roberto fortes,14,2,3,66.7,0,0,0,2,3,66.7,0,0,0,1,0,1,0,2,1,2,0,6
420964,470_15_26,ANGOLA,11834,8,hermenegildo santos,0,0,0,0,0,0,0,0,0,0,0,0,0,0,0,0,0,0,0,0,0,0
420965,470_15_26,ANGOLA,11630,9,leonel paulo,24,2,9,22.2,2,7,28.6,0,2,0,2,2,100,2,5,7,1,4,2,0,1,6
420966,470_15_26,ANGOLA,7039,10,valdelicio macanga maia joaquim,3,0,2,0,0,1,0,0,1,0,0,0,0,0,1,1,0,0,0,0,0,0
420967,470_15_26,ANGOLA,23104,11,reggie moore,18,2,7,28.6,1,4,25,1,3,33.3,6,7,85.7,2,1,3,0,1,1,3,0,11
420968,470_15_26,ANGOLA,9123,12,felizardo ambrosio,8,0,1,0,0,1,0,0,0,0,0,0,0,0,0,0,0,2,2,0,0,0
420969,470_15_26,ANGOLA,11831,13,yanick moreira,28,7,11,63.6,7,11,63.6,0,0,0,2,2,100,1,6,7,2,1,2,0,0,16
420970,470_15_26,ANGOLA,13819,14,braulio morais,13,1,5,20,1,2,50,0,3,0,0,0,0,0,1,1,2,2,3,0,0,2
420971,470_15_26,ANGOLA,12,15,eduardo mingas,23,3,5,60,3,4,75,0,1,0,0,2,0,5,3,8,1,1,2,2,0,6
420972,470_15_26,ANGOLA,0,TOTALS,ANGOLA,200,23,60,38.3,17,36,47.2,6,24,25,10,13,76.9,16,25,41,13,18,21,7,2,62
420973,470_15_26,CAF,3641,4,destin damachoua,37,5,11,45.5,2,4,50,3,7,42.9,0,0,0,1,3,4,2,4,5,4,0,13
420974,470_15_26,CAF,28097,5,joseph madozein,1,0,0,0,0,0,0,0,0,0,0,0,0,0,0,0,0,3,1,0,0,0
420975,470_15_26,CAF,28098,6,junior pehoua,35,3,10,30,2,4,50,1,6,16.7,4,4,100,0,1,1,2,2,0,1,0,11
420976,470_15_26,CAF,28099,7,freddy-glenn feidanga-temodea,0,0,0,0,0,0,0,0,0,0,0,0,0,0,0,0,0,0,0,0,0,0
420977,470_15_26,CAF,28100,8,johan roy stanley grebongo,34,2,8,25,2,4,50,0,4,0,1,2,50,2,5,7,0,1,4,2,1,5
420978,470_15_26,CAF,28101,9,dimitri kongbo,12,0,0,0,0,0,0,0,0,0,0,0,0,1,2,3,0,0,0,1,0,0
420979,470_15_26,CAF,28102,10,sydney pehoua,0,0,0,0,0,0,0,0,0,0,0,0,0,0,0,0,0,0,0,0,0,0
420980,470_15_26,CAF,13988,11,yannick zachee,2,0,1,0,0,1,0,0,0,0,0,0,0,0,1,1,0,0,1,0,0,0
420981,470_15_26,CAF,9195,12,max severin febou yadapa,0,0,0,0,0,0,0,0,0,0,0,0,0,0,0,0,0,0,0,0,0,0
420982,470_15_26,CAF,13989,13,max kouguere,38,9,14,64.3,8,11,72.7,1,3,33.3,4,5,80,2,5,7,0,2,1,0,1,23
420983,470_15_26,CAF,28103,14,philippe djada mabada,5,0,2,0,0,1,0,0,1,0,0,0,0,0,1,1,0,1,0,0,1,0
420984,470_15_26,CAF,11782,15,jimmy djimrabaye,36,2,12,16.7,2,12,16.7,0,0,0,5,5,100,1,1,2,2,3,3,0,0,9
420985,470_15_26,CAF,0,TOTALS,CAF,200,21,58,36.2,16,37,43.2,5,21,23.8,14,16,87.5,11,19,30,6,16,15,8,3,61
420986,470_15_27,COTE D'IVOIRE,28122,4,serge asselain,10,1,3,33.3,1,1,100,0,2,0,0,0,0,0,2,2,0,5,1,0,0,2
420987,470_15_27,COTE D'IVOIRE,9166,5,souleyman diabate,36,3,9,33.3,3,5,60,0,4,0,12,16,75,0,4,4,4,1,7,3,0,18
420988,470_15_27,COTE D'IVOIRE,28123,7,cedric kouadio,20,1,4,25,1,2,50,0,2,0,3,4,75,1,1,2,2,2,1,0,0,5
420989,470_15_27,COTE D'IVOIRE,28124,8,kehasson oulai,8,0,3,0,0,3,0,0,0,0,1,2,50,2,0,2,0,0,0,0,0,1
420990,470_15_27,COTE D'IVOIRE,3659,9,morlaye bangoura,0,0,0,0,0,0,0,0,0,0,0,0,0,0,0,0,0,0,0,0,0,0
420991,470_15_27,COTE D'IVOIRE,11801,10,alassane meite,9,0,1,0,0,0,0,0,1,0,0,0,0,0,0,0,0,2,2,0,0,0
420992,470_15_27,COTE D'IVOIRE,9162,11,jean-philippe koffi,33,1,8,12.5,1,2,50,0,6,0,8,9,88.9,1,3,4,0,1,0,1,0,10
420993,470_15_27,COTE D'IVOIRE,28125,12,eudes bahin,21,3,10,30,2,6,33.3,1,4,25,0,0,0,1,3,4,0,0,2,2,0,7
420994,470_15_27,COTE D'IVOIRE,9164,13,eric tape,21,2,8,25,2,6,33.3,0,2,0,2,5,40,0,4,4,0,4,0,1,0,6
420995,470_15_27,COTE D'IVOIRE,13983,14,namori meite,23,1,4,25,1,1,100,0,3,0,1,1,100,1,2,3,2,4,2,2,0,3
420996,470_15_27,COTE D'IVOIRE,28126,15,aboubacar hima,19,2,6,33.3,2,6,33.3,0,0,0,1,3,33.3,2,5,7,0,1,0,0,0,5
420997,470_15_27,COTE D'IVOIRE,0,TOTALS,COTE D'IVOIRE,200,14,56,25,13,32,40.6,1,24,4.2,28,40,70,12,25,37,8,20,16,9,0,57
420998,470_15_27,MALI,23144,4,ibrahim saounera,20,3,5,60,1,1,100,2,4,50,0,0,0,0,2,2,3,5,0,2,0,8
420999,470_15_27,MALI,11717,5,mahamadou kante,20,1,1,100,0,0,0,1,1,100,2,2,100,0,2,2,4,4,3,2,0,5
421000,470_15_27,MALI,11718,6,abdrahamane maiga,5,0,1,0,0,0,0,0,1,0,0,0,0,0,1,1,1,2,1,0,0,0
421001,470_15_27,MALI,28104,7,ibrahim djambo,12,1,4,25,1,3,33.3,0,1,0,4,4,100,0,0,0,1,2,1,0,0,6
421002,470_15_27,MALI,7055,8,waly coulibaly,17,2,6,33.3,2,2,100,0,4,0,2,3,66.7,0,3,3,1,5,0,0,0,6
421003,470_15_27,MALI,11976,9,boubacar moungoro,22,4,9,44.4,1,3,33.3,3,6,50,1,2,50,0,4,4,4,5,4,2,0,12
421004,470_15_27,MALI,28105,10,mohamed bah,7,0,0,0,0,0,0,0,0,0,0,0,0,1,1,2,0,0,0,0,0,0
421005,470_15_27,MALI,23146,11,namory boundy,10,0,3,0,0,2,0,0,1,0,1,2,50,1,2,3,3,4,2,1,0,1
421006,470_15_27,MALI,23147,12,boubacar sidibe,26,7,15,46.7,6,12,50,1,3,33.3,3,5,60,1,4,5,0,1,4,2,0,18
421007,470_15_27,MALI,1768,13,souarata cisse,26,3,6,50,1,2,50,2,4,50,3,4,75,1,4,5,2,1,3,0,0,11
421008,470_15_27,MALI,18495,14,mohamed tangara,18,1,2,50,1,2,50,0,0,0,2,4,50,3,4,7,0,2,2,0,1,4
421009,470_15_27,MALI,28106,15,drissa ballo,18,2,3,66.7,2,3,66.7,0,0,0,1,2,50,3,7,10,0,3,1,0,0,5
421010,470_15_27,MALI,0,TOTALS,MALI,200,24,55,43.6,15,30,50,9,25,36,19,28,67.9,11,35,46,19,34,22,9,1,76
421011,470_15_28,TUNISIA,18347,4,omar abada,22,2,6,33.3,2,3,66.7,0,3,0,0,0,0,0,1,1,1,2,3,4,0,4
421012,470_15_28,TUNISIA,28112,5,mohamed abbassi,6,1,2,50,1,2,50,0,0,0,0,0,0,0,2,2,0,1,0,0,0,2
421013,470_15_28,TUNISIA,9216,6,nizar knioua,16,1,4,25,1,2,50,0,2,0,0,0,0,2,1,3,1,3,1,2,0,2
421014,470_15_28,TUNISIA,18521,7,mourad el mabrouk,18,3,10,30,1,2,50,2,8,25,0,0,0,0,2,2,1,1,2,0,1,8
421015,470_15_28,TUNISIA,28113,8,mehdi seyeh,6,0,1,0,0,0,0,0,1,0,0,0,0,0,1,1,1,0,2,1,0,0
421016,470_15_28,TUNISIA,9278,9,mohamed hadidane,15,0,3,0,0,1,0,0,2,0,0,0,0,0,1,1,1,1,0,3,0,0
421017,470_15_28,TUNISIA,28114,10,michael brandon roll,43,8,19,42.1,6,10,60,2,9,22.2,3,4,75,0,1,1,3,4,2,1,0,21
421018,470_15_28,TUNISIA,13953,11,mohamed mokhtar ghyaza,14,1,4,25,1,4,25,0,0,0,0,0,0,1,0,1,2,1,3,4,0,2
421019,470_15_28,TUNISIA,13954,12,makram ben romdhane,39,8,14,57.1,8,11,72.7,0,3,0,6,13,46.2,4,6,10,1,2,2,0,1,22
421020,470_15_28,TUNISIA,9219,13,amine rzig,13,0,1,0,0,1,0,0,0,0,0,0,0,3,2,5,1,1,1,1,0,0
421021,470_15_28,TUNISIA,9220,14,hamdi braa,2,0,0,0,0,0,0,0,0,0,0,0,0,0,0,0,0,0,1,1,0,0
421022,470_15_28,TUNISIA,13956,15,salah mejri,31,4,8,50,4,7,57.1,0,1,0,0,0,0,4,2,6,1,3,3,2,3,8
421023,470_15_28,TUNISIA,0,TOTALS,TUNISIA,225,28,72,38.9,24,43,55.8,4,29,13.8,9,17,52.9,15,22,37,13,19,20,19,5,69
421024,470_15_28,MOROCCO,18539,4,reda ali harras,26,3,6,50,2,4,50,1,2,50,1,1,100,2,3,5,1,2,4,4,0,8
421025,470_15_28,MOROCCO,11820,5,zakaria ait fatah,0,0,0,0,0,0,0,0,0,0,0,0,0,0,0,0,0,0,0,0,0,0
421026,470_15_28,MOROCCO,9124,6,soufiane kourodu,39,9,13,69.2,8,12,66.7,1,1,100,0,0,0,1,5,6,0,4,5,1,0,19
421027,470_15_28,MOROCCO,23152,7,abdelali lahrichi,0,0,0,0,0,0,0,0,0,0,0,0,0,0,0,0,0,0,0,0,0,0
421028,470_15_28,MOROCCO,3576,8,mustapha khalfi,33,2,8,25,0,2,0,2,6,33.3,2,4,50,0,4,4,5,4,2,2,0,8
421029,470_15_28,MOROCCO,18538,9,omar laanani,6,0,1,0,0,1,0,0,0,0,0,0,0,0,2,2,0,0,1,0,1,0
421030,470_15_28,MOROCCO,28149,10,mohamed choua,3,0,1,0,0,1,0,0,0,0,0,0,0,1,1,2,0,2,1,0,0,0
421031,470_15_28,MOROCCO,14004,11,abdelhakim zouita,42,4,7,57.1,4,5,80,0,2,0,2,4,50,1,6,7,6,1,7,3,1,10
421032,470_15_28,MOROCCO,14002,12,walid dahmani,0,0,0,0,0,0,0,0,0,0,0,0,0,0,0,0,0,0,0,0,0,0
421033,470_15_28,MOROCCO,28150,13,adil el makssoud,37,5,11,45.5,4,6,66.7,1,5,20,1,2,50,2,2,4,3,1,6,2,0,12
421034,470_15_28,MOROCCO,11818,14,hamza zehouani,0,0,0,0,0,0,0,0,0,0,0,0,0,0,0,0,0,0,0,0,0,0
421035,470_15_28,MOROCCO,9126,15,abderrahim najah,39,5,9,55.6,5,9,55.6,0,0,0,1,3,33.3,0,6,6,1,4,3,1,0,11
421036,470_15_28,MOROCCO,0,TOTALS,MOROCCO,225,28,56,50,23,40,57.5,5,16,31.2,7,14,50,7,30,37,16,18,30,13,2,68
421037,470_15_29,SENEGAL,11764,4,thierno niang,9,1,4,25,1,3,33.3,0,1,0,0,0,0,0,0,0,1,1,2,0,0,2
421038,470_15_29,SENEGAL,18541,5,xane dalmeida,30,3,9,33.3,3,6,50,0,3,0,2,3,66.7,2,5,7,8,1,1,2,0,8
421039,470_15_29,SENEGAL,23085,6,ibrahima thomas,10,2,4,50,0,0,0,2,4,50,0,0,0,0,4,4,0,1,0,0,1,6
421040,470_15_29,SENEGAL,18543,7,mohamet diop,13,3,4,75,2,2,100,1,2,50,1,2,50,1,2,3,0,1,0,0,0,8
421041,470_15_29,SENEGAL,13966,8,antoine mendy,28,8,13,61.5,4,7,57.1,4,6,66.7,2,4,50,1,2,3,2,2,2,3,0,22
421042,470_15_29,SENEGAL,3592,9,maleye ndoye,34,1,8,12.5,1,3,33.3,0,5,0,1,3,33.3,0,1,1,1,1,0,2,0,3
421043,470_15_29,SENEGAL,13963,10,ibrahima mbengue,6,0,0,0,0,0,0,0,0,0,0,0,0,0,0,0,0,0,1,1,0,0
421044,470_15_29,SENEGAL,9148,11,mouhammad faye,0,0,0,0,0,0,0,0,0,0,0,0,0,0,0,0,0,0,0,0,0,0
421045,470_15_29,SENEGAL,23090,12,saer sene,7,0,0,0,0,0,0,0,0,0,0,0,0,0,4,4,0,2,0,0,0,0
421046,470_15_29,SENEGAL,28148,13,cheikh tidiane mbodj,17,3,5,60,3,5,60,0,0,0,1,2,50,5,4,9,0,3,1,0,0,7
421047,470_15_29,SENEGAL,25450,14,gorgui dieng,34,9,17,52.9,9,15,60,0,2,0,5,7,71.4,4,13,17,2,2,6,1,3,23
421048,470_15_29,SENEGAL,23091,15,pape abdou badji,12,0,3,0,0,3,0,0,0,0,0,0,0,1,2,3,1,2,1,0,0,0
421049,470_15_29,SENEGAL,0,TOTALS,SENEGAL,200,30,67,44.8,23,44,52.3,7,23,30.4,12,21,57.1,15,41,56,15,16,15,9,4,79
421050,470_15_29,UGANDA,28115,4,stanley ocitti,33,7,26,26.9,6,12,50,1,14,7.1,1,3,33.3,5,6,11,0,4,0,2,1,16
421051,470_15_29,UGANDA,28116,5,jimmy enabu,15,2,7,28.6,1,3,33.3,1,4,25,2,2,100,1,2,3,1,2,2,2,0,7
421052,470_15_29,UGANDA,14035,7,joseph ikong,16,1,5,20,0,1,0,1,4,25,0,0,0,2,0,2,2,0,1,0,0,3
421053,470_15_29,UGANDA,28117,8,josh johnson,0,0,0,0,0,0,0,0,0,0,0,0,0,0,0,0,0,0,0,0,0,0
421054,470_15_29,UGANDA,28118,9,samuel mukooza,33,3,14,21.4,0,6,0,3,8,37.5,0,0,0,1,0,1,3,4,1,0,0,9
421055,470_15_29,UGANDA,6470,10,kassim nagwere,29,0,5,0,0,3,0,0,2,0,0,0,0,1,1,2,3,1,1,1,0,0
421056,470_15_29,UGANDA,28119,11,samuel kalwanyi,15,0,1,0,0,1,0,0,0,0,0,0,0,3,4,7,0,2,1,1,1,0
421057,470_15_29,UGANDA,14033,12,stephen omwony,21,2,7,28.6,1,4,25,1,3,33.3,0,0,0,0,4,4,1,1,4,1,0,5
421058,470_15_29,UGANDA,28120,13,dhal marial,11,0,1,0,0,1,0,0,0,0,1,2,50,2,0,2,0,1,1,0,1,1
421059,470_15_29,UGANDA,14037,14,henry malinga,3,0,0,0,0,0,0,0,0,0,0,0,0,0,0,0,0,0,0,0,0,0
421060,470_15_29,UGANDA,28121,15,brandon sebirumbi,25,2,11,18.2,2,11,18.2,0,0,0,3,3,100,5,7,12,0,5,4,1,0,7
421061,470_15_29,UGANDA,0,TOTALS,UGANDA,200,17,77,22.1,10,42,23.8,7,35,20,7,10,70,22,26,48,10,20,15,8,3,48
421062,470_15_30,CAPE VERDE,23105,4,dimitry coronel,32,3,11,27.3,3,7,42.9,0,4,0,0,0,0,4,1,5,0,5,2,3,0,6
421063,470_15_30,CAPE VERDE,11659,5,jeff xavier,35,7,16,43.8,3,6,50,4,10,40,0,0,0,1,0,1,7,2,7,3,0,18
421064,470_15_30,CAPE VERDE,13950,6,ivan almeida,29,2,12,16.7,2,9,22.2,0,3,0,0,0,0,3,7,10,1,2,3,3,0,4
421065,470_15_30,CAPE VERDE,23107,7,braima freire,8,1,2,50,1,2,50,0,0,0,2,4,50,0,0,0,1,0,1,0,0,4
421066,470_15_30,CAPE VERDE,28127,8,mario correia,37,9,19,47.4,4,9,44.4,5,10,50,0,0,0,3,4,7,0,3,2,3,0,23
421067,470_15_30,CAPE VERDE,13951,9,joel almeida,7,0,2,0,0,0,0,0,2,0,0,0,0,0,2,2,0,2,2,0,0,0
421068,470_15_30,CAPE VERDE,28128,10,michael mendes,0,0,0,0,0,0,0,0,0,0,0,0,0,0,0,0,0,0,0,0,0,0
421069,470_15_30,CAPE VERDE,28129,11,fidel mendonca,0,0,0,0,0,0,0,0,0,0,0,0,0,0,0,0,0,0,0,0,0,0
421070,470_15_30,CAPE VERDE,28130,12,keven gomes,0,0,0,0,0,0,0,0,0,0,0,0,0,0,0,0,0,0,0,0,0,0
421071,470_15_30,CAPE VERDE,23112,13,brian rudolph,0,0,0,0,0,0,0,0,0,0,0,0,0,0,0,0,0,0,0,0,0,0
421072,470_15_30,CAPE VERDE,23113,14,kevin coronel,14,1,3,33.3,1,3,33.3,0,0,0,0,0,0,0,1,1,0,2,0,0,0,2
421073,470_15_30,CAPE VERDE,9139,15,rodrigo mascarenhas,38,4,9,44.4,4,9,44.4,0,0,0,2,4,50,5,4,9,4,3,2,3,2,10
421074,470_15_30,CAPE VERDE,0,TOTALS,CAPE VERDE,200,27,74,36.5,18,45,40,9,29,31,4,8,50,18,20,38,13,19,19,15,2,67
421075,470_15_30,GABON,28084,4,samuel styve ndong,19,0,2,0,0,1,0,0,1,0,0,0,0,1,1,2,3,1,1,0,0,0
421076,470_15_30,GABON,28085,5,rodrigue mouckaga atsu,3,0,1,0,0,0,0,0,1,0,0,0,0,0,0,0,0,0,1,0,0,0
421077,470_15_30,GABON,28086,6,gyll therence mayimba,31,6,10,60,4,5,80,2,5,40,3,4,75,1,5,6,2,3,1,4,1,17
421078,470_15_30,GABON,28087,7,lerry rostand essono mve,33,7,13,53.8,7,12,58.3,0,1,0,2,10,20,4,6,10,3,0,1,3,2,16
421079,470_15_30,GABON,28088,8,aymar-kabrel boundou,21,2,5,40,0,0,0,2,5,40,3,4,75,0,2,2,1,3,7,0,0,9
421080,470_15_30,GABON,9385,9,silvere abessolo toung,0,0,0,0,0,0,0,0,0,0,0,0,0,0,0,0,0,0,0,0,0,0
421081,470_15_30,GABON,28089,10,lin francis kobangoye ikinda,34,3,3,100,2,2,100,1,1,100,2,4,50,0,4,4,4,2,1,0,0,9
421082,470_15_30,GABON,28090,11,marvin joy mapaga,9,0,2,0,0,1,0,0,1,0,0,0,0,1,1,2,0,0,2,0,0,0
421083,470_15_30,GABON,28091,12,jason reteno,3,0,0,0,0,0,0,0,0,0,0,0,0,0,0,0,0,1,0,0,0,0
421084,470_15_30,GABON,28092,13,stephane lasme,22,7,11,63.6,7,11,63.6,0,0,0,1,2,50,0,4,4,1,4,3,2,0,15
421085,470_15_30,GABON,28093,14,freddy obame obame,23,5,8,62.5,4,5,80,1,3,33.3,0,0,0,0,4,4,1,2,6,0,0,11
421086,470_15_30,GABON,28094,15,lionel fabre,2,0,0,0,0,0,0,0,0,0,0,0,0,0,0,0,0,0,0,0,0,0
421087,470_15_30,GABON,0,TOTALS,GABON,200,30,55,54.5,24,37,64.9,6,18,33.3,11,24,45.8,12,30,42,15,16,24,9,3,77
421088,470_15_31,NIGERIA,23139,4,ben uzoh,23,2,6,33.3,1,4,25,1,2,50,2,4,50,1,0,1,2,0,3,3,0,7
421089,470_15_31,NIGERIA,13976,5,michael umeh,18,1,7,14.3,0,4,0,1,3,33.3,5,6,83.3,0,4,4,4,0,2,0,1,8
421090,470_15_31,NIGERIA,21026,6,ike diogu,0,0,0,0,0,0,0,0,0,0,0,0,0,0,0,0,0,0,0,0,0,0
421091,470_15_31,NIGERIA,21027,7,al-farouq aminu,20,3,6,50,2,4,50,1,2,50,3,4,75,0,3,3,1,0,2,0,2,10
421092,470_15_31,NIGERIA,23141,8,jamal olasewere,5,3,4,75,3,3,100,0,1,0,2,2,100,1,1,2,1,3,1,2,0,8
421093,470_15_31,NIGERIA,3647,9,chamberlain oguchi,20,2,9,22.2,0,1,0,2,8,25,0,0,0,0,4,4,2,0,1,2,0,6
421094,470_15_31,NIGERIA,23140,10,stan okoye,16,2,9,22.2,1,4,25,1,5,20,0,0,0,1,3,4,1,2,3,1,0,5
421095,470_15_31,NIGERIA,23143,11,andy ogide,17,3,5,60,3,3,100,0,2,0,0,0,0,2,1,3,4,0,0,1,0,6
421096,470_15_31,NIGERIA,28095,12,michael gbinije,25,3,8,37.5,2,3,66.7,1,5,20,0,0,0,0,5,5,1,0,0,1,1,7
421097,470_15_31,NIGERIA,28096,13,olaseni lawal,18,3,5,60,3,5,60,0,0,0,4,4,100,7,5,12,0,2,1,0,1,10
421098,470_15_31,NIGERIA,21031,14,alade aminu,23,6,10,60,6,10,60,0,0,0,2,3,66.7,1,2,3,1,1,1,0,0,14
421099,470_15_31,NIGERIA,3656,15,olumide oyedeji,15,0,1,0,0,1,0,0,0,0,2,4,50,2,6,8,0,3,0,0,0,2
421100,470_15_31,NIGERIA,0,TOTALS,NIGERIA,200,28,70,40,21,42,50,7,28,25,20,27,74.1,20,35,55,17,11,14,10,5,83
421101,470_15_31,MOZAMBIQUE,28131,4,hugo martins,12,1,4,25,0,2,0,1,2,50,0,0,0,1,3,4,0,0,3,0,0,3
421102,470_15_31,MOZAMBIQUE,9320,5,armando baptista,15,1,1,100,1,1,100,0,0,0,1,1,100,0,2,2,0,2,0,1,0,3
421103,470_15_31,MOZAMBIQUE,7042,6,david canivete,26,2,8,25,2,6,33.3,0,2,0,1,2,50,0,2,2,1,3,1,0,0,5
421104,470_15_31,MOZAMBIQUE,11728,7,ermelindo novela,0,0,0,0,0,0,0,0,0,0,0,0,0,0,0,0,0,0,0,0,0,0
421105,470_15_31,MOZAMBIQUE,18509,8,augusto matos,27,4,10,40,1,3,33.3,3,7,42.9,3,3,100,0,2,2,0,0,3,0,0,14
421106,470_15_31,MOZAMBIQUE,28132,9,helton ubisse,27,3,9,33.3,3,8,37.5,0,1,0,0,0,0,0,3,3,1,3,0,0,0,6
421107,470_15_31,MOZAMBIQUE,28133,10,elton mazive,7,0,0,0,0,0,0,0,0,0,2,2,100,0,0,0,0,2,0,1,0,2
421108,470_15_31,MOZAMBIQUE,3628,11,custodio muchate,22,3,9,33.3,3,7,42.9,0,2,0,0,0,0,0,4,4,2,4,3,2,0,6
421109,470_15_31,MOZAMBIQUE,3629,12,octavio magolico,19,1,4,25,1,1,100,0,3,0,0,0,0,0,0,0,1,3,1,1,0,2
421110,470_15_31,MOZAMBIQUE,11896,13,pio matos,32,3,9,33.3,3,5,60,0,4,0,0,0,0,0,4,4,4,3,4,5,0,6
421111,470_15_31,MOZAMBIQUE,28134,14,luis barros,5,0,1,0,0,1,0,0,0,0,0,0,0,0,0,0,0,1,3,0,0,0
421112,470_15_31,MOZAMBIQUE,28135,15,baggio chimonzo,8,0,2,0,0,0,0,0,2,0,0,0,0,0,3,3,0,0,1,0,0,0
421113,470_15_31,MOZAMBIQUE,0,TOTALS,MOZAMBIQUE,200,18,57,31.6,14,34,41.2,4,23,17.4,7,8,87.5,3,26,29,9,21,20,10,0,47
421114,470_15_32,CAMEROON,28107,4,arnaud adala moto,24,4,14,28.6,3,8,37.5,1,6,16.7,4,8,50,3,7,10,1,3,1,3,0,13
421115,470_15_32,CAMEROON,28108,5,aldo curti,11,0,3,0,0,0,0,0,3,0,0,0,0,0,1,1,2,1,0,1,0,0
421116,470_15_32,CAMEROON,9200,6,parfait bitee,27,2,8,25,0,0,0,2,8,25,1,2,50,3,2,5,3,2,0,0,0,7
421117,470_15_32,CAMEROON,28109,7,kenneth kadji,24,1,9,11.1,1,5,20,0,4,0,0,0,0,2,0,2,2,5,5,1,3,2
421118,470_15_32,CAMEROON,11673,8,harding nana,8,1,3,33.3,0,0,0,1,3,33.3,0,0,0,0,0,0,0,0,2,0,1,3
421119,470_15_32,CAMEROON,23129,9,jeremy nzeulie,30,4,16,25,2,4,50,2,12,16.7,2,4,50,0,6,6,3,4,2,1,0,12
421120,470_15_32,CAMEROON,28110,10,seidou njoya,0,0,0,0,0,0,0,0,0,0,0,0,0,0,0,0,0,0,0,0,0,0
421121,470_15_32,CAMEROON,11960,11,frank tchoubaye,26,7,16,43.8,2,5,40,5,11,45.5,3,5,60,0,4,4,1,5,0,3,0,22
421122,470_15_32,CAMEROON,11676,12,alexis wangmene,6,0,1,0,0,1,0,0,0,0,0,0,0,0,1,1,0,3,0,0,0,0
421123,470_15_32,CAMEROON,28111,13,boris siakam,5,0,1,0,0,1,0,0,0,0,0,0,0,0,1,1,0,0,0,0,0,0
421124,470_15_32,CAMEROON,23130,14,steve moundou missi,25,4,8,50,4,8,50,0,0,0,2,2,100,4,5,9,1,4,2,2,0,10
421125,470_15_32,CAMEROON,9206,15,gaston essengue,15,1,1,100,1,1,100,0,0,0,0,0,0,0,2,2,1,5,1,0,0,2
421126,470_15_32,CAMEROON,0,TOTALS,CAMEROON,200,24,80,30,13,33,39.4,11,47,23.4,12,21,57.1,15,30,45,14,32,13,11,4,71
421127,470_15_32,ALGERIA,28136,4,yanis mostefat,0,0,0,0,0,0,0,0,0,0,0,0,0,0,0,0,0,0,0,0,0,0
421128,470_15_32,ALGERIA,23100,5,abdesslem dekkiche,10,1,1,100,1,1,100,0,0,0,1,4,25,0,3,3,0,3,1,0,0,3
421129,470_15_32,ALGERIA,28137,6,faycal ramdane sahraoui,0,0,0,0,0,0,0,0,0,0,0,0,0,0,0,0,0,0,0,0,0,0
421130,470_15_32,ALGERIA,28138,7,samir mekdad,26,1,6,16.7,0,2,0,1,4,25,3,6,50,0,7,7,3,3,3,1,0,6
421131,470_15_32,ALGERIA,28139,8,mounir benzegala,33,2,9,22.2,0,3,0,2,6,33.3,1,2,50,0,6,6,8,2,6,0,0,7
421132,470_15_32,ALGERIA,11747,9,mohamed harat,26,7,12,58.3,7,12,58.3,0,0,0,9,13,69.2,0,6,6,1,2,3,1,0,23
421133,470_15_32,ALGERIA,11758,10,mohamed zerouali,4,0,1,0,0,0,0,0,1,0,0,0,0,0,0,0,0,1,3,0,0,0
421134,470_15_32,ALGERIA,28140,11,touhami ghezzoul,21,2,3,66.7,2,3,66.7,0,0,0,2,2,100,0,1,1,0,3,1,0,0,6
421135,470_15_32,ALGERIA,28141,12,kamel abdel-magid ammour,9,0,0,0,0,0,0,0,0,0,0,0,0,0,1,1,0,2,1,1,0,0
421136,470_15_32,ALGERIA,23102,13,hocine gaham,37,5,9,55.6,3,5,60,2,4,50,3,4,75,0,5,5,3,3,4,2,0,15
421137,470_15_32,ALGERIA,10431,14,mehdi cheriet,24,4,7,57.1,4,5,80,0,2,0,3,3,100,1,6,7,3,3,3,1,0,11
421138,470_15_32,ALGERIA,23103,15,mohamed sedik touati,10,1,2,50,1,2,50,0,0,0,0,0,0,0,2,2,0,1,0,0,0,2
421139,470_15_32,ALGERIA,0,TOTALS,ALGERIA,200,23,50,46,18,33,54.5,5,17,29.4,22,34,64.7,2,40,42,18,23,25,6,0,73
421140,470_15_33,ZIMBABWE,9324,4,taurai chitsinde,21,0,1,0,0,0,0,0,1,0,2,2,100,0,1,1,0,2,3,2,0,2
421141,470_15_33,ZIMBABWE,14048,5,tawanda chitsinde,38,5,19,26.3,1,6,16.7,4,13,30.8,0,0,0,1,7,8,3,1,4,1,0,14
421142,470_15_33,ZIMBABWE,28142,6,simbarashe mungomezi,8,0,0,0,0,0,0,0,0,0,0,0,0,0,0,0,0,1,1,0,0,0
421143,470_15_33,ZIMBABWE,28143,7,tinotenda mugabe,0,0,0,0,0,0,0,0,0,0,0,0,0,0,0,0,0,0,0,0,0,0
421144,470_15_33,ZIMBABWE,28144,8,moses muyambo,5,0,0,0,0,0,0,0,0,0,0,0,0,0,2,2,0,0,3,0,0,0
421145,470_15_33,ZIMBABWE,9329,9,eric banda,24,1,4,25,1,3,33.3,0,1,0,2,2,100,2,4,6,2,3,3,1,0,4
421146,470_15_33,ZIMBABWE,9328,10,duncan shenje,17,3,8,37.5,1,4,25,2,4,50,0,0,0,0,3,3,0,1,0,0,0,8
421147,470_15_33,ZIMBABWE,11891,11,vitalis chikoko,33,2,7,28.6,1,5,20,1,2,50,3,4,75,1,4,5,2,4,3,1,3,8
421148,470_15_33,ZIMBABWE,11885,12,tatenda maturure,26,8,15,53.3,8,14,57.1,0,1,0,4,4,100,1,1,2,1,5,4,5,1,20
421149,470_15_33,ZIMBABWE,28145,13,everisto pasipamire,7,0,0,0,0,0,0,0,0,0,0,0,0,1,2,3,0,1,1,0,0,0
421150,470_15_33,ZIMBABWE,28146,14,brian hore,6,0,1,0,0,1,0,0,0,0,1,2,50,0,0,0,1,2,0,0,0,1
421151,470_15_33,ZIMBABWE,28147,15,neville chivanganye,15,3,5,60,3,5,60,0,0,0,1,3,33.3,1,0,1,0,1,0,0,0,7
421152,470_15_33,ZIMBABWE,0,TOTALS,ZIMBABWE,200,22,60,36.7,15,38,39.5,7,22,31.8,13,17,76.5,12,25,37,9,21,23,10,4,64
421153,470_15_33,UGANDA,28115,4,stanley ocitti,38,10,19,52.6,5,10,50,5,9,55.6,2,2,100,3,5,8,2,3,3,2,1,27
421154,470_15_33,UGANDA,28116,5,jimmy enabu,15,0,3,0,0,1,0,0,2,0,2,2,100,1,1,2,3,1,3,0,0,2
421155,470_15_33,UGANDA,14035,7,joseph ikong,10,0,1,0,0,0,0,0,1,0,0,0,0,1,1,2,0,0,0,0,0,0
421156,470_15_33,UGANDA,28117,8,josh johnson,24,1,3,33.3,0,1,0,1,2,50,2,4,50,0,6,6,0,1,7,0,1,5
421157,470_15_33,UGANDA,28118,9,samuel mukooza,37,1,11,9.1,0,3,0,1,8,12.5,4,4,100,0,1,1,7,1,3,2,0,7
421158,470_15_33,UGANDA,6470,10,kassim nagwere,24,3,13,23.1,2,5,40,1,8,12.5,4,5,80,0,0,0,3,1,1,3,0,11
421159,470_15_33,UGANDA,28119,11,samuel kalwanyi,7,2,2,100,2,2,100,0,0,0,0,0,0,0,2,2,0,3,0,0,0,4
421160,470_15_33,UGANDA,14033,12,stephen omwony,0,0,0,0,0,0,0,0,0,0,0,0,0,0,0,0,0,0,0,0,0,0
421161,470_15_33,UGANDA,28120,13,dhal marial,7,0,0,0,0,0,0,0,0,0,0,0,0,0,5,5,0,0,1,0,0,0
421162,470_15_33,UGANDA,14037,14,henry malinga,10,0,1,0,0,1,0,0,0,0,0,0,0,2,0,2,0,2,0,0,0,0
421163,470_15_33,UGANDA,28121,15,brandon sebirumbi,28,6,8,75,6,8,75,0,0,0,4,5,80,0,6,6,0,5,1,3,1,16
421164,470_15_33,UGANDA,0,TOTALS,UGANDA,200,23,61,37.7,15,31,48.4,8,30,26.7,18,22,81.8,12,28,40,15,17,20,10,3,72
421165,470_15_34,GABON,28084,4,samuel styve ndong,7,0,0,0,0,0,0,0,0,0,0,0,0,0,0,0,0,0,1,0,0,0
421166,470_15_34,GABON,28085,5,rodrigue mouckaga atsu,2,0,0,0,0,0,0,0,0,0,0,0,0,0,0,0,0,1,0,0,0,0
421167,470_15_34,GABON,28086,6,gyll therence mayimba,27,7,17,41.2,2,4,50,5,13,38.5,2,2,100,3,4,7,1,3,6,0,0,21
421168,470_15_34,GABON,28087,7,lerry rostand essono mve,26,1,8,12.5,1,5,20,0,3,0,0,0,0,2,3,5,1,3,5,0,2,2
421169,470_15_34,GABON,28088,8,aymar-kabrel boundou,35,5,17,29.4,1,5,20,4,12,33.3,2,2,100,1,5,6,3,2,2,3,0,16
421170,470_15_34,GABON,9385,9,silvere abessolo toung,0,0,0,0,0,0,0,0,0,0,0,0,0,0,0,0,0,0,0,0,0,0
421171,470_15_34,GABON,28089,10,lin francis kobangoye ikinda,35,1,9,11.1,1,4,25,0,5,0,4,6,66.7,0,3,3,2,4,3,1,0,6
421172,470_15_34,GABON,28090,11,marvin joy mapaga,3,0,0,0,0,0,0,0,0,0,0,0,0,0,1,1,0,1,1,0,0,0
421173,470_15_34,GABON,28091,12,jason reteno,4,0,0,0,0,0,0,0,0,0,0,2,0,1,0,1,0,3,2,0,0,0
421174,470_15_34,GABON,28092,13,stephane lasme,24,4,10,40,3,8,37.5,1,2,50,1,1,100,3,6,9,0,3,1,3,1,10
421175,470_15_34,GABON,28093,14,freddy obame obame,26,1,6,16.7,1,4,25,0,2,0,5,7,71.4,1,2,3,1,3,2,3,0,7
421176,470_15_34,GABON,28094,15,lionel fabre,11,0,0,0,0,0,0,0,0,0,2,2,100,0,0,0,0,0,0,0,0,2
421177,470_15_34,GABON,0,TOTALS,GABON,200,19,67,28.4,9,30,30,10,37,27,16,22,72.7,16,26,42,8,24,23,10,3,64
421178,470_15_34,NIGERIA,23139,4,ben uzoh,20,3,8,37.5,3,7,42.9,0,1,0,0,1,0,1,2,3,6,2,2,5,0,6
421179,470_15_34,NIGERIA,13976,5,michael umeh,20,3,4,75,2,2,100,1,2,50,4,5,80,1,2,3,0,4,1,3,0,11
421180,470_15_34,NIGERIA,21026,6,ike diogu,0,0,0,0,0,0,0,0,0,0,0,0,0,0,0,0,0,0,0,0,0,0
421181,470_15_34,NIGERIA,21027,7,al-farouq aminu,23,5,11,45.5,5,7,71.4,0,4,0,7,9,77.8,2,3,5,3,1,3,1,2,17
421182,470_15_34,NIGERIA,23141,8,jamal olasewere,6,0,0,0,0,0,0,0,0,0,2,2,100,0,0,0,0,1,1,0,0,2
421183,470_15_34,NIGERIA,3647,9,chamberlain oguchi,19,2,11,18.2,0,3,0,2,8,25,2,2,100,1,3,4,2,1,2,1,0,8
421184,470_15_34,NIGERIA,23140,10,stan okoye,17,3,9,33.3,3,6,50,0,3,0,0,0,0,2,1,3,0,0,1,0,1,6
421185,470_15_34,NIGERIA,23143,11,andy ogide,17,2,3,66.7,1,1,100,1,2,50,0,0,0,0,2,2,2,1,2,0,0,5
421186,470_15_34,NIGERIA,28095,12,michael gbinije,22,5,8,62.5,3,5,60,2,3,66.7,3,7,42.9,0,1,1,3,3,3,5,0,15
421187,470_15_34,NIGERIA,28096,13,olaseni lawal,18,3,3,100,3,3,100,0,0,0,0,2,0,1,4,5,4,2,1,1,0,6
421188,470_15_34,NIGERIA,21031,14,alade aminu,22,3,4,75,3,4,75,0,0,0,3,4,75,1,9,10,1,3,3,0,2,9
421189,470_15_34,NIGERIA,3656,15,olumide oyedeji,16,1,1,100,1,1,100,0,0,0,1,2,50,1,4,5,2,2,1,1,0,3
421190,470_15_34,NIGERIA,0,TOTALS,NIGERIA,200,30,62,48.4,24,39,61.5,6,23,26.1,22,34,64.7,12,33,45,23,20,20,17,5,88
421191,470_15_35,EGYPT,13947,1,kamal khalifa,28,2,6,33.3,2,4,50,0,2,0,2,4,50,2,6,8,4,2,4,1,2,6
421192,470_15_35,EGYPT,21074,4,ehab amin,28,7,13,53.8,3,5,60,4,8,50,0,0,0,2,1,3,3,3,2,3,0,18
421193,470_15_35,EGYPT,25438,5,amr gendy,12,0,4,0,0,2,0,0,2,0,0,0,0,2,1,3,0,1,0,0,0,0
421194,470_15_35,EGYPT,9152,6,ramy gunady,19,0,5,0,0,1,0,0,4,0,1,2,50,0,3,3,1,3,2,1,0,1
421195,470_15_35,EGYPT,9154,9,ibrahim elgammal,15,1,7,14.3,0,4,0,1,3,33.3,0,0,0,0,0,0,1,1,2,0,0,3
421196,470_15_35,EGYPT,28081,10,ahmed tawfik,12,1,2,50,0,0,0,1,2,50,0,0,0,0,0,0,1,5,1,0,0,3
421197,470_15_35,EGYPT,28082,11,aly ahmed,6,2,3,66.7,2,3,66.7,0,0,0,0,0,0,0,1,1,0,1,1,0,0,4
421198,470_15_35,EGYPT,16644,12,youssef shousha,26,1,5,20,0,2,0,1,3,33.3,0,0,0,1,0,1,1,2,3,2,0,3
421199,470_15_35,EGYPT,13949,14,ramy abdallah,16,3,5,60,0,1,0,3,4,75,3,4,75,1,1,2,1,1,0,0,0,12
421200,470_15_35,EGYPT,28083,30,ahmed elmaragi,9,1,3,33.3,0,1,0,1,2,50,0,0,0,0,0,0,1,2,2,0,0,3
421201,470_15_35,EGYPT,18381,50,assem marei,22,2,7,28.6,2,7,28.6,0,0,0,3,4,75,4,3,7,1,4,3,0,1,7
421202,470_15_35,EGYPT,11817,55,omar oraby,8,1,4,25,1,4,25,0,0,0,1,1,100,1,1,2,0,0,1,0,1,3
421203,470_15_35,EGYPT,0,TOTALS,EGYPT,200,21,64,32.8,10,34,29.4,11,30,36.7,10,15,66.7,17,20,37,14,27,21,7,4,63
421204,470_15_35,ANGOLA,13818,4,edson ndoniema,16,2,6,33.3,2,4,50,0,2,0,0,0,0,2,2,4,2,1,1,1,0,4
421205,470_15_35,ANGOLA,3574,5,armando costa,31,2,4,50,1,1,100,1,3,33.3,7,8,87.5,0,4,4,6,4,1,2,0,12
421206,470_15_35,ANGOLA,3420,6,carlos morais,32,6,12,50,2,2,100,4,10,40,3,4,75,0,4,4,3,1,3,3,0,19
421207,470_15_35,ANGOLA,16597,7,roberto fortes,11,2,4,50,0,1,0,2,3,66.7,1,2,50,0,0,0,1,1,1,1,0,7
421208,470_15_35,ANGOLA,11834,8,hermenegildo santos,0,0,0,0,0,0,0,0,0,0,0,0,0,0,0,0,0,0,0,0,0,0
421209,470_15_35,ANGOLA,11630,9,leonel paulo,19,2,5,40,2,4,50,0,1,0,2,3,66.7,1,3,4,0,2,4,0,2,6
421210,470_15_35,ANGOLA,7039,10,valdelicio macanga maia joaquim,2,0,0,0,0,0,0,0,0,0,0,0,0,0,0,0,0,1,1,1,0,0
421211,470_15_35,ANGOLA,23104,11,reggie moore,16,3,6,50,3,3,100,0,3,0,3,3,100,0,0,0,0,1,1,1,0,9
421212,470_15_35,ANGOLA,9123,12,felizardo ambrosio,15,1,2,50,1,2,50,0,0,0,0,0,0,0,5,5,0,1,1,1,0,2
421213,470_15_35,ANGOLA,11831,13,yanick moreira,26,4,8,50,4,8,50,0,0,0,0,0,0,1,4,5,1,3,2,0,2,8
421214,470_15_35,ANGOLA,13819,14,braulio morais,12,2,3,66.7,1,1,100,1,2,50,1,2,50,0,2,2,2,2,2,0,0,6
421215,470_15_35,ANGOLA,12,15,eduardo mingas,21,4,5,80,4,5,80,0,0,0,2,2,100,1,1,2,2,1,2,0,0,10
421216,470_15_35,ANGOLA,0,TOTALS,ANGOLA,200,28,55,50.9,20,31,64.5,8,24,33.3,19,24,79.2,10,28,38,17,18,19,10,4,83
421217,470_15_36,SENEGAL,11764,4,thierno niang,2,1,1,100,1,1,100,0,0,0,0,0,0,0,0,0,0,1,1,0,0,2
421218,470_15_36,SENEGAL,18541,5,xane dalmeida,34,6,9,66.7,3,3,100,3,6,50,0,0,0,1,0,1,3,3,2,0,0,15
421219,470_15_36,SENEGAL,23085,6,ibrahima thomas,14,2,4,50,0,1,0,2,3,66.7,1,4,25,0,2,2,0,2,0,1,1,7
421220,470_15_36,SENEGAL,18543,7,mohamet diop,14,1,5,20,1,2,50,0,3,0,0,0,0,1,1,2,0,2,1,0,0,2
421221,470_15_36,SENEGAL,13966,8,antoine mendy,38,4,8,50,2,2,100,2,6,33.3,0,0,0,1,2,3,2,1,3,0,1,10
421222,470_15_36,SENEGAL,3592,9,maleye ndoye,26,4,9,44.4,1,2,50,3,7,42.9,2,2,100,1,4,5,0,2,1,0,0,13
421223,470_15_36,SENEGAL,13963,10,ibrahima mbengue,6,0,1,0,0,0,0,0,1,0,0,0,0,0,0,0,0,0,1,0,0,0
421224,470_15_36,SENEGAL,9148,11,mouhammad faye,0,0,0,0,0,0,0,0,0,0,0,0,0,0,0,0,0,0,0,0,0,0
421225,470_15_36,SENEGAL,23090,12,saer sene,11,0,2,0,0,2,0,0,0,0,0,0,0,2,2,4,0,0,1,0,2,0
421226,470_15_36,SENEGAL,28148,13,cheikh tidiane mbodj,10,1,2,50,1,2,50,0,0,0,0,0,0,1,1,2,0,1,1,0,0,2
421227,470_15_36,SENEGAL,25450,14,gorgui dieng,37,6,15,40,6,13,46.2,0,2,0,8,10,80,1,16,17,8,2,0,2,1,20
421228,470_15_36,SENEGAL,23091,15,pape abdou badji,8,2,2,100,2,2,100,0,0,0,0,0,0,1,0,1,0,3,1,0,0,4
421229,470_15_36,SENEGAL,0,TOTALS,SENEGAL,200,27,58,46.6,17,30,56.7,10,28,35.7,11,16,68.8,10,32,42,13,17,13,3,5,75
421230,470_15_36,ALGERIA,28136,4,yanis mostefat,0,0,0,0,0,0,0,0,0,0,0,0,0,0,0,0,0,0,0,0,0,0
421231,470_15_36,ALGERIA,23100,5,abdesslem dekkiche,23,2,7,28.6,1,6,16.7,1,1,100,2,3,66.7,0,1,1,0,3,1,0,0,7
421232,470_15_36,ALGERIA,28137,6,faycal ramdane sahraoui,0,0,0,0,0,0,0,0,0,0,0,0,0,0,0,0,0,0,0,0,0,0
421233,470_15_36,ALGERIA,28138,7,samir mekdad,20,1,8,12.5,1,4,25,0,4,0,0,0,0,1,4,5,1,1,1,0,0,2
421234,470_15_36,ALGERIA,28139,8,mounir benzegala,32,4,10,40,0,1,0,4,9,44.4,0,0,0,1,1,2,0,1,2,1,0,12
421235,470_15_36,ALGERIA,11747,9,mohamed harat,20,4,9,44.4,4,9,44.4,0,0,0,4,5,80,1,0,1,0,1,2,0,0,12
421236,470_15_36,ALGERIA,11758,10,mohamed zerouali,15,1,3,33.3,1,2,50,0,1,0,0,2,0,0,2,2,0,1,0,0,0,2
421237,470_15_36,ALGERIA,28140,11,touhami ghezzoul,9,0,5,0,0,5,0,0,0,0,0,0,0,1,2,3,0,3,0,0,0,0
421238,470_15_36,ALGERIA,28141,12,kamel abdel-magid ammour,11,0,2,0,0,1,0,0,1,0,0,0,0,0,0,0,1,0,0,0,0,0
421239,470_15_36,ALGERIA,23102,13,hocine gaham,20,3,5,60,2,2,100,1,3,33.3,0,0,0,2,2,4,0,2,1,1,0,7
421240,470_15_36,ALGERIA,10431,14,mehdi cheriet,29,5,14,35.7,4,9,44.4,1,5,20,0,0,0,1,4,5,1,2,4,0,0,11
421241,470_15_36,ALGERIA,23103,15,mohamed sedik touati,21,2,7,28.6,2,7,28.6,0,0,0,1,2,50,4,3,7,1,3,1,0,0,5
421242,470_15_36,ALGERIA,0,TOTALS,ALGERIA,200,22,70,31.4,15,46,32.6,7,24,29.2,7,12,58.3,17,22,39,4,17,13,2,0,58
421243,470_15_37,TUNISIA,18347,4,omar abada,20,3,7,42.9,3,4,75,0,3,0,2,2,100,0,2,2,5,4,1,1,1,8
421244,470_15_37,TUNISIA,28112,5,mohamed abbassi,5,0,2,0,0,2,0,0,0,0,0,0,0,0,1,1,0,0,0,0,0,0
421245,470_15_37,TUNISIA,9216,6,nizar knioua,15,2,2,100,0,0,0,2,2,100,3,4,75,1,1,2,1,1,0,1,0,9
421246,470_15_37,TUNISIA,18521,7,mourad el mabrouk,33,5,11,45.5,1,2,50,4,9,44.4,2,2,100,0,0,0,4,2,2,1,0,16
421247,470_15_37,TUNISIA,28113,8,mehdi seyeh,0,0,0,0,0,0,0,0,0,0,0,0,0,0,0,0,0,0,0,0,0,0
421248,470_15_37,TUNISIA,9278,9,mohamed hadidane,19,0,1,0,0,0,0,0,1,0,1,2,50,0,3,3,1,3,1,0,0,1
421249,470_15_37,TUNISIA,28114,10,michael brandon roll,24,3,3,100,2,2,100,1,1,100,2,2,100,1,1,2,2,3,0,2,0,9
421250,470_15_37,TUNISIA,13953,11,mohamed mokhtar ghyaza,18,1,3,33.3,1,3,33.3,0,0,0,1,1,100,0,0,0,1,3,0,0,0,3
421251,470_15_37,TUNISIA,13954,12,makram ben romdhane,32,5,13,38.5,5,11,45.5,0,2,0,2,8,25,2,5,7,0,4,2,2,1,12
421252,470_15_37,TUNISIA,9219,13,amine rzig,10,1,3,33.3,0,0,0,1,3,33.3,0,0,0,0,2,2,0,0,0,0,0,3
421253,470_15_37,TUNISIA,9220,14,hamdi braa,7,0,1,0,0,1,0,0,0,0,2,4,50,1,0,1,0,0,0,0,0,2
421254,470_15_37,TUNISIA,13956,15,salah mejri,17,2,7,28.6,2,7,28.6,0,0,0,0,0,0,2,2,4,0,5,2,1,2,4
421255,470_15_37,TUNISIA,0,TOTALS,TUNISIA,200,22,53,41.5,14,32,43.8,8,21,38.1,15,25,60,9,22,31,14,25,9,8,4,67
421256,470_15_37,MALI,23144,4,ibrahim saounera,26,2,9,22.2,2,7,28.6,0,2,0,2,2,100,0,2,2,0,2,0,0,0,6
421257,470_15_37,MALI,11717,5,mahamadou kante,14,0,0,0,0,0,0,0,0,0,2,2,100,0,2,2,3,4,1,0,0,2
421258,470_15_37,MALI,11718,6,abdrahamane maiga,0,0,0,0,0,0,0,0,0,0,0,0,0,0,0,0,0,0,0,0,0,0
421259,470_15_37,MALI,28104,7,ibrahim djambo,31,3,10,30,3,8,37.5,0,2,0,2,2,100,5,3,8,1,4,1,0,0,8
421260,470_15_37,MALI,7055,8,waly coulibaly,27,5,8,62.5,1,1,100,4,7,57.1,0,0,0,1,2,3,2,5,3,0,0,14
421261,470_15_37,MALI,11976,9,boubacar moungoro,11,1,6,16.7,1,2,50,0,4,0,0,0,0,1,0,1,0,1,1,0,0,2
421262,470_15_37,MALI,28105,10,mohamed bah,14,3,4,75,3,4,75,0,0,0,0,0,0,0,3,3,0,1,0,0,0,6
421263,470_15_37,MALI,23146,11,namory boundy,13,0,0,0,0,0,0,0,0,0,0,0,0,1,2,3,0,0,0,0,0,0
421264,470_15_37,MALI,23147,12,boubacar sidibe,4,1,1,100,1,1,100,0,0,0,0,0,0,1,0,1,0,0,1,0,0,2
421265,470_15_37,MALI,1768,13,souarata cisse,28,6,11,54.5,4,6,66.7,2,5,40,0,3,0,0,2,2,0,4,3,1,0,14
421266,470_15_37,MALI,18495,14,mohamed tangara,21,1,4,25,1,4,25,0,0,0,3,6,50,3,4,7,1,5,1,0,1,5
421267,470_15_37,MALI,28106,15,drissa ballo,11,0,1,0,0,1,0,0,0,0,1,2,50,1,5,6,1,0,2,0,0,1
421268,470_15_37,MALI,0,TOTALS,MALI,200,22,54,40.7,16,34,47.1,6,20,30,10,17,58.8,14,26,40,8,26,15,1,1,60
421269,470_15_38,CAF,3641,4,destin damachoua,36,5,12,41.7,2,5,40,3,7,42.9,1,2,50,3,1,4,4,3,2,2,0,14
421270,470_15_38,CAF,28097,5,joseph madozein,0,0,0,0,0,0,0,0,0,0,0,0,0,0,0,0,0,0,0,0,0,0
421271,470_15_38,CAF,28098,6,junior pehoua,24,2,8,25,2,4,50,0,4,0,0,0,0,2,1,3,3,4,0,0,0,4
421272,470_15_38,CAF,28099,7,freddy-glenn feidanga-temodea,0,0,0,0,0,0,0,0,0,0,0,0,0,0,0,0,0,0,0,0,0,0
421273,470_15_38,CAF,28100,8,johan roy stanley grebongo,30,4,10,40,3,7,42.9,1,3,33.3,1,3,33.3,0,7,7,3,4,2,0,0,10
421274,470_15_38,CAF,28101,9,dimitri kongbo,13,1,2,50,1,2,50,0,0,0,2,2,100,0,0,0,0,3,2,0,0,4
421275,470_15_38,CAF,28102,10,sydney pehoua,0,0,0,0,0,0,0,0,0,0,0,0,0,0,0,0,0,0,0,0,0,0
421276,470_15_38,CAF,13988,11,yannick zachee,5,0,0,0,0,0,0,0,0,0,0,2,0,0,2,2,1,0,0,0,0,0
421277,470_15_38,CAF,9195,12,max severin febou yadapa,7,0,0,0,0,0,0,0,0,0,0,0,0,0,1,1,0,0,1,0,0,0
421278,470_15_38,CAF,13989,13,max kouguere,37,9,16,56.2,6,8,75,3,8,37.5,1,2,50,0,2,2,1,3,3,0,0,22
421279,470_15_38,CAF,28103,14,philippe djada mabada,12,2,5,40,2,3,66.7,0,2,0,0,0,0,1,0,1,0,4,1,1,0,4
421280,470_15_38,CAF,11782,15,jimmy djimrabaye,37,7,12,58.3,7,10,70,0,2,0,2,3,66.7,2,5,7,3,3,3,2,1,16
421281,470_15_38,CAF,0,TOTALS,CAF,200,30,65,46.2,23,39,59,7,26,26.9,7,14,50,10,20,30,15,24,14,5,1,74
421282,470_15_38,MOROCCO,18539,4,reda ali harras,30,7,11,63.6,5,7,71.4,2,4,50,1,3,33.3,1,3,4,1,0,2,4,0,17
421283,470_15_38,MOROCCO,11820,5,zakaria ait fatah,6,0,1,0,0,1,0,0,0,0,0,0,0,0,0,0,0,1,1,0,0,0
421284,470_15_38,MOROCCO,9124,6,soufiane kourodu,26,9,13,69.2,9,13,69.2,0,0,0,3,4,75,0,4,4,0,3,3,1,0,21
421285,470_15_38,MOROCCO,23152,7,abdelali lahrichi,6,0,0,0,0,0,0,0,0,0,0,0,0,0,1,1,0,0,1,0,0,0
421286,470_15_38,MOROCCO,3576,8,mustapha khalfi,34,4,5,80,2,2,100,2,3,66.7,2,2,100,0,1,1,9,2,0,1,0,12
421287,470_15_38,MOROCCO,18538,9,omar laanani,0,0,0,0,0,0,0,0,0,0,0,0,0,0,0,0,0,0,0,0,0,0
421288,470_15_38,MOROCCO,28149,10,mohamed choua,14,2,4,50,2,3,66.7,0,1,0,2,2,100,2,4,6,1,1,1,1,0,6
421289,470_15_38,MOROCCO,14004,11,abdelhakim zouita,27,4,10,40,4,7,57.1,0,3,0,4,6,66.7,1,6,7,1,3,3,1,2,12
421290,470_15_38,MOROCCO,14002,12,walid dahmani,0,0,0,0,0,0,0,0,0,0,0,0,0,0,0,0,0,0,0,0,0,0
421291,470_15_38,MOROCCO,28150,13,adil el makssoud,30,2,7,28.6,2,4,50,0,3,0,2,4,50,2,3,5,4,0,2,1,1,6
421292,470_15_38,MOROCCO,11818,14,hamza zehouani,0,0,0,0,0,0,0,0,0,0,0,0,0,0,0,0,0,0,0,0,0,0
421293,470_15_38,MOROCCO,9126,15,abderrahim najah,27,4,6,66.7,3,4,75,1,2,50,3,6,50,2,3,5,3,2,2,0,0,12
421294,470_15_38,MOROCCO,0,TOTALS,MOROCCO,200,32,57,56.1,27,41,65.9,5,16,31.2,17,27,63,10,29,39,19,12,15,9,3,86
421295,470_15_39,COTE D'IVOIRE,28122,4,serge asselain,17,1,5,20,1,1,100,0,4,0,1,2,50,1,1,2,0,1,0,0,1,3
421296,470_15_39,COTE D'IVOIRE,9166,5,souleyman diabate,40,7,12,58.3,5,7,71.4,2,5,40,3,3,100,1,4,5,8,0,4,4,0,19
421297,470_15_39,COTE D'IVOIRE,28123,7,cedric kouadio,19,1,6,16.7,1,4,25,0,2,0,1,2,50,1,1,2,0,4,2,0,0,3
421298,470_15_39,COTE D'IVOIRE,28124,8,kehasson oulai,9,0,3,0,0,0,0,0,3,0,1,2,50,0,0,0,0,2,1,0,0,1
421299,470_15_39,COTE D'IVOIRE,3659,9,morlaye bangoura,0,0,0,0,0,0,0,0,0,0,0,0,0,0,0,0,0,0,0,0,0,0
421300,470_15_39,COTE D'IVOIRE,11801,10,alassane meite,20,0,4,0,0,2,0,0,2,0,0,0,0,1,1,2,3,0,1,1,0,0
421301,470_15_39,COTE D'IVOIRE,9162,11,jean-philippe koffi,19,1,5,20,1,2,50,0,3,0,2,2,100,0,3,3,0,1,1,2,0,4
421302,470_15_39,COTE D'IVOIRE,28125,12,eudes bahin,13,2,4,50,2,2,100,0,2,0,0,0,0,0,0,0,0,1,1,1,0,4
421303,470_15_39,COTE D'IVOIRE,9164,13,eric tape,25,6,10,60,5,9,55.6,1,1,100,1,3,33.3,2,3,5,0,3,0,0,1,14
421304,470_15_39,COTE D'IVOIRE,13983,14,namori meite,25,3,6,50,3,4,75,0,2,0,2,3,66.7,2,5,7,1,4,2,1,1,8
421305,470_15_39,COTE D'IVOIRE,28126,15,aboubacar hima,13,2,3,66.7,2,3,66.7,0,0,0,3,3,100,0,1,1,0,3,1,0,0,7
421306,470_15_39,COTE D'IVOIRE,0,TOTALS,COTE D'IVOIRE,200,23,58,39.7,20,34,58.8,3,24,12.5,14,20,70,9,24,33,12,19,15,9,3,63
421307,470_15_39,MOZAMBIQUE,28131,4,hugo martins,13,1,5,20,1,4,25,0,1,0,0,0,0,2,1,3,2,1,1,1,0,2
421308,470_15_39,MOZAMBIQUE,9320,5,armando baptista,16,1,2,50,1,2,50,0,0,0,0,0,0,1,0,1,1,4,0,0,1,2
421309,470_15_39,MOZAMBIQUE,7042,6,david canivete,36,5,13,38.5,5,10,50,0,3,0,3,6,50,2,6,8,2,1,1,2,1,13
421310,470_15_39,MOZAMBIQUE,11728,7,ermelindo novela,0,0,0,0,0,0,0,0,0,0,0,0,0,0,0,0,0,0,0,0,0,0
421311,470_15_39,MOZAMBIQUE,18509,8,augusto matos,32,7,17,41.2,7,11,63.6,0,6,0,7,7,100,0,1,1,1,2,0,1,0,21
421312,470_15_39,MOZAMBIQUE,28132,9,helton ubisse,30,1,4,25,1,4,25,0,0,0,5,8,62.5,4,6,10,0,3,2,0,0,7
421313,470_15_39,MOZAMBIQUE,28133,10,elton mazive,0,0,0,0,0,0,0,0,0,0,0,0,0,0,0,0,0,0,0,0,0,0
421314,470_15_39,MOZAMBIQUE,3628,11,custodio muchate,27,1,3,33.3,1,2,50,0,1,0,2,2,100,0,2,2,2,4,7,1,0,4
421315,470_15_39,MOZAMBIQUE,3629,12,octavio magolico,0,0,0,0,0,0,0,0,0,0,0,0,0,0,0,0,0,0,0,0,0,0
421316,470_15_39,MOZAMBIQUE,11896,13,pio matos,32,5,11,45.5,2,5,40,3,6,50,2,2,100,0,5,5,4,2,4,1,0,15
421317,470_15_39,MOZAMBIQUE,28134,14,luis barros,3,0,1,0,0,0,0,0,1,0,0,0,0,0,0,0,0,1,0,0,0,0
421318,470_15_39,MOZAMBIQUE,28135,15,baggio chimonzo,11,2,2,100,0,0,0,2,2,100,0,0,0,0,1,1,1,1,1,0,0,6
421319,470_15_39,MOZAMBIQUE,0,TOTALS,MOZAMBIQUE,200,23,58,39.7,18,38,47.4,5,20,25,19,25,76,12,29,41,13,19,16,6,2,70
421320,470_15_40,CAPE VERDE,23105,4,dimitry coronel,29,2,6,33.3,2,5,40,0,1,0,3,4,75,3,4,7,2,0,0,0,0,7
421321,470_15_40,CAPE VERDE,11659,5,jeff xavier,32,6,16,37.5,1,5,20,5,11,45.5,2,3,66.7,0,3,3,1,1,4,0,0,19
421322,470_15_40,CAPE VERDE,13950,6,ivan almeida,33,5,16,31.2,4,10,40,1,6,16.7,2,4,50,2,9,11,8,4,2,2,0,13
421323,470_15_40,CAPE VERDE,23107,7,braima freire,8,0,1,0,0,0,0,0,1,0,0,0,0,0,3,3,0,1,1,0,0,0
421324,470_15_40,CAPE VERDE,28127,8,mario correia,24,5,12,41.7,1,2,50,4,10,40,0,1,0,0,2,2,0,1,2,0,0,14
421325,470_15_40,CAPE VERDE,13951,9,joel almeida,6,0,4,0,0,3,0,0,1,0,2,2,100,2,1,3,0,1,0,1,0,2
421326,470_15_40,CAPE VERDE,28128,10,michael mendes,4,1,2,50,1,1,100,0,1,0,0,0,0,2,0,2,0,0,0,0,0,2
421327,470_15_40,CAPE VERDE,28129,11,fidel mendonca,15,1,4,25,0,0,0,1,4,25,0,0,0,0,0,0,1,1,0,0,0,3
421328,470_15_40,CAPE VERDE,28130,12,keven gomes,3,0,1,0,0,1,0,0,0,0,0,0,0,0,1,1,0,0,0,0,0,0
421329,470_15_40,CAPE VERDE,23112,13,brian rudolph,0,0,0,0,0,0,0,0,0,0,0,0,0,0,0,0,0,0,0,0,0,0
421330,470_15_40,CAPE VERDE,23113,14,kevin coronel,10,1,3,33.3,1,3,33.3,0,0,0,0,0,0,1,1,2,0,4,1,0,0,2
421331,470_15_40,CAPE VERDE,9139,15,rodrigo mascarenhas,36,2,3,66.7,2,3,66.7,0,0,0,0,0,0,4,4,8,2,3,0,0,1,4
421332,470_15_40,CAPE VERDE,0,TOTALS,CAPE VERDE,200,23,68,33.8,12,33,36.4,11,35,31.4,9,14,64.3,15,29,44,14,17,13,3,1,66
421333,470_15_40,CAMEROON,28107,4,arnaud adala moto,28,6,13,46.2,5,8,62.5,1,5,20,2,2,100,2,6,8,1,4,2,1,0,15
421334,470_15_40,CAMEROON,28108,5,aldo curti,7,0,0,0,0,0,0,0,0,0,1,2,50,0,0,0,1,1,0,0,0,1
421335,470_15_40,CAMEROON,9200,6,parfait bitee,33,5,11,45.5,3,7,42.9,2,4,50,0,0,0,0,2,2,3,4,1,1,0,12
421336,470_15_40,CAMEROON,28109,7,kenneth kadji,25,6,10,60,5,8,62.5,1,2,50,0,0,0,0,3,3,2,2,3,1,0,13
421337,470_15_40,CAMEROON,11673,8,harding nana,0,0,0,0,0,0,0,0,0,0,0,0,0,0,0,0,0,0,0,0,0,0
421338,470_15_40,CAMEROON,23129,9,jeremy nzeulie,21,3,9,33.3,1,1,100,2,8,25,2,3,66.7,0,4,4,1,0,0,0,0,10
421339,470_15_40,CAMEROON,28110,10,seidou njoya,0,0,0,0,0,0,0,0,0,0,0,0,0,0,0,0,0,0,0,0,0,0
421340,470_15_40,CAMEROON,11960,11,frank tchoubaye,33,3,7,42.9,0,1,0,3,6,50,3,5,60,1,4,5,1,3,2,1,0,12
421341,470_15_40,CAMEROON,11676,12,alexis wangmene,8,0,3,0,0,3,0,0,0,0,0,0,0,2,1,3,0,1,0,0,0,0
421342,470_15_40,CAMEROON,28111,13,boris siakam,17,4,5,80,4,5,80,0,0,0,1,1,100,1,3,4,2,0,0,0,0,9
421343,470_15_40,CAMEROON,23130,14,steve moundou missi,28,7,13,53.8,7,11,63.6,0,2,0,2,2,100,1,5,6,2,3,0,1,0,16
421344,470_15_40,CAMEROON,9206,15,gaston essengue,0,0,0,0,0,0,0,0,0,0,0,0,0,0,0,0,0,0,0,0,0,0
421345,470_15_40,CAMEROON,0,TOTALS,CAMEROON,200,34,71,47.9,25,44,56.8,9,27,33.3,11,15,73.3,9,31,40,13,18,9,5,0,88
421346,470_15_41,MALI,23144,4,ibrahim saounera,17,0,6,0,0,4,0,0,2,0,0,0,0,0,3,3,0,0,1,0,0,0
421347,470_15_41,MALI,11717,5,mahamadou kante,23,1,4,25,1,3,33.3,0,1,0,0,0,0,1,5,6,0,2,0,0,0,2
421348,470_15_41,MALI,11718,6,abdrahamane maiga,10,0,0,0,0,0,0,0,0,0,1,2,50,0,0,0,0,1,0,0,0,1
421349,470_15_41,MALI,28104,7,ibrahim djambo,15,1,2,50,1,2,50,0,0,0,1,2,50,2,3,5,0,4,3,1,0,3
421350,470_15_41,MALI,7055,8,waly coulibaly,19,1,6,16.7,1,2,50,0,4,0,3,4,75,1,0,1,0,1,2,0,0,5
421351,470_15_41,MALI,11976,9,boubacar moungoro,20,4,9,44.4,2,3,66.7,2,6,33.3,4,6,66.7,2,1,3,1,1,2,1,0,14
421352,470_15_41,MALI,28105,10,mohamed bah,14,2,5,40,2,5,40,0,0,0,1,2,50,1,2,3,0,4,2,1,0,5
421353,470_15_41,MALI,23146,11,namory boundy,16,0,4,0,0,3,0,0,1,0,0,0,0,0,1,1,0,1,0,0,0,0
421354,470_15_41,MALI,23147,12,boubacar sidibe,0,0,0,0,0,0,0,0,0,0,0,0,0,0,0,0,0,0,0,0,0,0
421355,470_15_41,MALI,1768,13,souarata cisse,23,1,4,25,1,3,33.3,0,1,0,2,2,100,0,3,3,1,4,3,1,0,4
421356,470_15_41,MALI,18495,14,mohamed tangara,22,0,4,0,0,4,0,0,0,0,9,11,81.8,1,3,4,0,2,2,0,0,9
421357,470_15_41,MALI,28106,15,drissa ballo,21,3,3,100,3,3,100,0,0,0,2,7,28.6,1,0,1,0,3,1,0,0,8
421358,470_15_41,MALI,0,TOTALS,MALI,200,13,47,27.7,11,32,34.4,2,15,13.3,23,36,63.9,9,22,31,2,23,17,4,0,51
421359,470_15_41,EGYPT,13947,1,kamal khalifa,29,4,9,44.4,4,7,57.1,0,2,0,1,1,100,5,5,10,3,1,1,0,2,9
421360,470_15_41,EGYPT,21074,4,ehab amin,20,3,7,42.9,3,4,75,0,3,0,0,0,0,3,1,4,1,3,1,3,0,6
421361,470_15_41,EGYPT,25438,5,amr gendy,5,3,6,50,2,3,66.7,1,3,33.3,0,0,0,1,2,3,0,1,0,1,0,7
421362,470_15_41,EGYPT,9152,6,ramy gunady,17,2,6,33.3,0,1,0,2,5,40,2,2,100,1,3,4,3,3,1,2,1,8
421363,470_15_41,EGYPT,9154,9,ibrahim elgammal,27,3,9,33.3,1,1,100,2,8,25,1,1,100,1,1,2,0,2,1,2,0,9
421364,470_15_41,EGYPT,28081,10,ahmed tawfik,20,1,4,25,0,2,0,1,2,50,0,0,0,0,0,0,0,0,0,0,1,3
421365,470_15_41,EGYPT,28082,11,aly ahmed,13,2,3,66.7,2,3,66.7,0,0,0,1,1,100,1,4,5,0,5,0,0,0,5
421366,470_15_41,EGYPT,16644,12,youssef shousha,26,4,7,57.1,4,5,80,0,2,0,0,0,0,0,2,2,0,4,4,0,0,8
421367,470_15_41,EGYPT,13949,14,ramy abdallah,15,2,4,50,0,0,0,2,4,50,3,4,75,1,3,4,2,5,1,0,1,9
421368,470_15_41,EGYPT,28083,30,ahmed elmaragi,8,1,2,50,0,0,0,1,2,50,0,2,0,1,0,1,0,1,2,0,0,3
421369,470_15_41,EGYPT,18381,50,assem marei,20,3,8,37.5,3,8,37.5,0,0,0,1,5,20,3,5,8,4,4,4,0,0,7
421370,470_15_41,EGYPT,11817,55,omar oraby,0,0,0,0,0,0,0,0,0,0,0,0,0,0,0,0,0,0,0,0,0,0
421371,470_15_41,EGYPT,0,TOTALS,EGYPT,200,28,65,43.1,19,34,55.9,9,31,29,9,16,56.2,18,30,48,13,29,17,8,5,74
421372,470_15_42,ALGERIA,28136,4,yanis mostefat,20,3,6,50,1,1,100,2,5,40,4,4,100,0,1,1,0,1,3,1,0,12
421373,470_15_42,ALGERIA,23100,5,abdesslem dekkiche,31,4,7,57.1,4,6,66.7,0,1,0,5,7,71.4,1,5,6,1,5,3,1,0,13
421374,470_15_42,ALGERIA,28137,6,faycal ramdane sahraoui,0,0,0,0,0,0,0,0,0,0,0,0,0,0,0,0,0,0,0,0,0,0
421375,470_15_42,ALGERIA,28138,7,samir mekdad,16,0,3,0,0,1,0,0,2,0,2,2,100,1,3,4,1,0,0,0,0,2
421376,470_15_42,ALGERIA,28139,8,mounir benzegala,2,0,0,0,0,0,0,0,0,0,0,0,0,0,1,1,0,0,0,0,0,0
421377,470_15_42,ALGERIA,11747,9,mohamed harat,24,5,11,45.5,5,11,45.5,0,0,0,13,17,76.5,2,3,5,1,2,1,2,0,23
421378,470_15_42,ALGERIA,11758,10,mohamed zerouali,12,0,2,0,0,1,0,0,1,0,0,0,0,0,4,4,0,4,4,1,0,0
421379,470_15_42,ALGERIA,28140,11,touhami ghezzoul,2,0,0,0,0,0,0,0,0,0,0,0,0,0,0,0,0,4,0,0,0,0
421380,470_15_42,ALGERIA,28141,12,kamel abdel-magid ammour,24,3,5,60,2,3,66.7,1,2,50,3,4,75,0,5,5,3,1,2,1,0,10
421381,470_15_42,ALGERIA,23102,13,hocine gaham,30,2,7,28.6,2,3,66.7,0,4,0,0,0,0,1,2,3,1,5,1,0,0,4
421382,470_15_42,ALGERIA,10431,14,mehdi cheriet,21,4,8,50,4,8,50,0,0,0,0,0,0,1,3,4,2,4,3,1,0,8
421383,470_15_42,ALGERIA,23103,15,mohamed sedik touati,20,5,8,62.5,5,8,62.5,0,0,0,2,2,100,2,4,6,0,5,1,1,1,12
421384,470_15_42,ALGERIA,0,TOTALS,ALGERIA,200,26,57,45.6,23,42,54.8,3,15,20,29,36,80.6,9,34,43,9,31,20,8,1,84
421385,470_15_42,GABON,28084,4,samuel styve ndong,36,5,11,45.5,5,10,50,0,1,0,7,7,100,0,4,4,2,4,6,1,0,17
421386,470_15_42,GABON,28085,5,rodrigue mouckaga atsu,7,0,1,0,0,0,0,0,1,0,0,0,0,0,1,1,0,1,0,0,0,0
421387,470_15_42,GABON,28086,6,gyll therence mayimba,35,5,17,29.4,3,7,42.9,2,10,20,6,6,100,4,2,6,1,3,4,1,0,18
421388,470_15_42,GABON,28087,7,lerry rostand essono mve,34,2,8,25,2,7,28.6,0,1,0,2,2,100,1,2,3,1,3,1,3,0,6
421389,470_15_42,GABON,28088,8,aymar-kabrel boundou,5,1,3,33.3,1,2,50,0,1,0,0,0,0,0,0,0,1,1,1,0,0,2
421390,470_15_42,GABON,9385,9,silvere abessolo toung,0,0,0,0,0,0,0,0,0,0,0,0,0,0,0,0,0,0,0,0,0,0
421391,470_15_42,GABON,28089,10,lin francis kobangoye ikinda,33,4,7,57.1,2,2,100,2,5,40,7,8,87.5,2,5,7,2,5,2,0,0,17
421392,470_15_42,GABON,28090,11,marvin joy mapaga,9,0,0,0,0,0,0,0,0,0,4,10,40,0,1,1,0,1,0,0,0,4
421393,470_15_42,GABON,28091,12,jason reteno,5,0,2,0,0,2,0,0,0,0,0,0,0,0,0,0,0,1,0,0,1,0
421394,470_15_42,GABON,28092,13,stephane lasme,24,5,10,50,5,7,71.4,0,3,0,2,4,50,3,5,8,0,4,2,4,3,12
421395,470_15_42,GABON,28093,14,freddy obame obame,7,0,3,0,0,2,0,0,1,0,0,0,0,0,0,0,0,3,0,0,0,0
421396,470_15_42,GABON,28094,15,lionel fabre,6,0,0,0,0,0,0,0,0,0,0,0,0,0,2,2,0,3,0,0,0,0
421397,470_15_42,GABON,0,TOTALS,GABON,200,22,62,35.5,18,39,46.2,4,23,17.4,28,37,75.7,11,23,34,7,31,16,9,4,76
421398,470_15_43,MALI,23144,4,ibrahim saounera,18,3,8,37.5,2,5,40,1,3,33.3,11,11,100,0,1,1,1,3,1,0,0,18
421399,470_15_43,MALI,11717,5,mahamadou kante,25,0,7,0,0,6,0,0,1,0,0,0,0,1,3,4,8,4,5,4,0,0
421400,470_15_43,MALI,11718,6,abdrahamane maiga,0,0,0,0,0,0,0,0,0,0,0,0,0,0,0,0,0,0,0,0,0,0
421401,470_15_43,MALI,28104,7,ibrahim djambo,15,1,5,20,1,4,25,0,1,0,0,0,0,0,1,1,0,4,4,0,1,2
421402,470_15_43,MALI,7055,8,waly coulibaly,24,5,8,62.5,3,3,100,2,5,40,1,1,100,1,0,1,1,4,1,1,0,13
421403,470_15_43,MALI,11976,9,boubacar moungoro,16,6,10,60,1,1,100,5,9,55.6,0,0,0,1,2,3,1,0,2,0,0,17
421404,470_15_43,MALI,28105,10,mohamed bah,10,1,3,33.3,1,2,50,0,1,0,0,0,0,1,1,2,0,4,0,0,0,2
421405,470_15_43,MALI,23146,11,namory boundy,26,1,4,25,1,2,50,0,2,0,2,2,100,0,3,3,2,3,0,2,0,4
421406,470_15_43,MALI,23147,12,boubacar sidibe,0,0,0,0,0,0,0,0,0,0,0,0,0,0,0,0,0,0,0,0,0,0
421407,470_15_43,MALI,1768,13,souarata cisse,27,4,9,44.4,1,4,25,3,5,60,3,4,75,0,3,3,2,2,2,0,0,14
421408,470_15_43,MALI,18495,14,mohamed tangara,34,6,7,85.7,6,7,85.7,0,0,0,8,10,80,4,13,17,2,2,1,1,1,20
421409,470_15_43,MALI,28106,15,drissa ballo,6,1,2,50,1,2,50,0,0,0,2,2,100,1,1,2,0,2,0,0,0,4
421410,470_15_43,MALI,0,TOTALS,MALI,200,28,63,44.4,17,36,47.2,11,27,40.7,27,30,90,14,30,44,17,28,18,8,2,94
421411,470_15_43,GABON,28084,4,samuel styve ndong,30,0,4,0,0,2,0,0,2,0,1,2,50,0,0,0,2,4,2,1,0,1
421412,470_15_43,GABON,28085,5,rodrigue mouckaga atsu,16,4,5,80,2,3,66.7,2,2,100,0,0,0,0,1,1,0,4,0,0,0,10
421413,470_15_43,GABON,28086,6,gyll therence mayimba,34,6,12,50,2,4,50,4,8,50,2,3,66.7,1,8,9,1,3,3,2,0,18
421414,470_15_43,GABON,28087,7,lerry rostand essono mve,36,5,15,33.3,5,12,41.7,0,3,0,6,11,54.5,0,7,7,6,5,7,3,2,16
421415,470_15_43,GABON,28088,8,aymar-kabrel boundou,0,0,0,0,0,0,0,0,0,0,0,0,0,0,0,0,0,0,0,0,0,0
421416,470_15_43,GABON,9385,9,silvere abessolo toung,0,0,0,0,0,0,0,0,0,0,0,0,0,0,0,0,0,0,0,0,0,0
421417,470_15_43,GABON,28089,10,lin francis kobangoye ikinda,33,3,6,50,1,3,33.3,2,3,66.7,4,9,44.4,1,2,3,0,3,1,1,0,12
421418,470_15_43,GABON,28090,11,marvin joy mapaga,11,2,4,50,2,3,66.7,0,1,0,2,2,100,1,1,2,0,1,3,0,2,6
421419,470_15_43,GABON,28091,12,jason reteno,17,2,5,40,2,5,40,0,0,0,0,0,0,0,1,1,0,4,0,0,0,4
421420,470_15_43,GABON,28092,13,stephane lasme,0,0,0,0,0,0,0,0,0,0,0,0,0,0,0,0,0,0,0,0,0,0
421421,470_15_43,GABON,28093,14,freddy obame obame,21,6,9,66.7,5,8,62.5,1,1,100,2,2,100,2,1,3,1,4,1,2,1,15
421422,470_15_43,GABON,28094,15,lionel fabre,2,0,0,0,0,0,0,0,0,0,0,0,0,1,0,1,1,0,0,0,0,0
421423,470_15_43,GABON,0,TOTALS,GABON,200,28,60,46.7,19,40,47.5,9,20,45,17,29,58.6,7,22,29,11,28,17,9,5,82
421424,470_15_44,EGYPT,13947,1,kamal khalifa,25,5,12,41.7,4,8,50,1,4,25,4,4,100,2,3,5,4,1,0,0,1,15
421425,470_15_44,EGYPT,21074,4,ehab amin,18,2,7,28.6,2,2,100,0,5,0,5,7,71.4,2,3,5,0,1,2,3,0,9
421426,470_15_44,EGYPT,25438,5,amr gendy,13,3,6,50,3,5,60,0,1,0,1,3,33.3,0,2,2,1,4,1,0,0,7
421427,470_15_44,EGYPT,9152,6,ramy gunady,24,0,6,0,0,3,0,0,3,0,0,0,0,1,1,2,1,1,1,0,0,0
421428,470_15_44,EGYPT,9154,9,ibrahim elgammal,18,0,2,0,0,1,0,0,1,0,0,0,0,0,2,2,1,0,2,0,0,0
421429,470_15_44,EGYPT,28081,10,ahmed tawfik,18,1,4,25,1,1,100,0,3,0,1,2,50,1,1,2,2,1,0,1,1,3
421430,470_15_44,EGYPT,28082,11,aly ahmed,9,2,5,40,2,4,50,0,1,0,0,0,0,1,1,2,0,3,1,0,0,4
421431,470_15_44,EGYPT,16644,12,youssef shousha,26,3,5,60,1,2,50,2,3,66.7,0,0,0,3,0,3,1,3,1,0,0,8
421432,470_15_44,EGYPT,13949,14,ramy abdallah,12,1,4,25,0,2,0,1,2,50,0,0,0,0,3,3,0,2,1,1,0,3
421433,470_15_44,EGYPT,28083,30,ahmed elmaragi,3,0,2,0,0,1,0,0,1,0,1,2,50,0,1,1,0,0,0,0,0,1
421434,470_15_44,EGYPT,18381,50,assem marei,29,7,13,53.8,7,13,53.8,0,0,0,3,6,50,4,7,11,2,2,2,1,0,17
421435,470_15_44,EGYPT,11817,55,omar oraby,5,1,1,100,1,1,100,0,0,0,0,2,0,2,1,3,0,3,1,0,0,2
421436,470_15_44,EGYPT,0,TOTALS,EGYPT,200,25,67,37.3,21,43,48.8,4,24,16.7,15,26,57.7,18,28,46,12,21,12,6,2,69
421437,470_15_44,ALGERIA,28136,4,yanis mostefat,30,4,8,50,0,2,0,4,6,66.7,0,0,0,1,1,2,4,5,0,1,0,12
421438,470_15_44,ALGERIA,23100,5,abdesslem dekkiche,9,1,5,20,1,2,50,0,3,0,0,0,0,0,1,1,0,4,2,0,0,2
421439,470_15_44,ALGERIA,28137,6,faycal ramdane sahraoui,0,0,0,0,0,0,0,0,0,0,0,0,0,0,0,0,0,0,0,0,0,0
421440,470_15_44,ALGERIA,28138,7,samir mekdad,12,0,3,0,0,2,0,0,1,0,0,0,0,2,2,4,0,1,1,0,0,0
421441,470_15_44,ALGERIA,28139,8,mounir benzegala,25,3,9,33.3,2,4,50,1,5,20,0,0,0,0,0,0,3,1,1,1,0,7
421442,470_15_44,ALGERIA,11747,9,mohamed harat,12,0,4,0,0,4,0,0,0,0,3,4,75,1,0,1,1,1,1,0,1,3
421443,470_15_44,ALGERIA,11758,10,mohamed zerouali,18,1,2,50,1,1,100,0,1,0,2,2,100,0,4,4,0,0,2,1,0,4
421444,470_15_44,ALGERIA,28140,11,touhami ghezzoul,6,2,4,50,2,4,50,0,0,0,0,0,0,1,1,2,0,2,1,0,0,4
421445,470_15_44,ALGERIA,28141,12,kamel abdel-magid ammour,25,2,4,50,1,1,100,1,3,33.3,0,1,0,1,4,5,1,3,2,0,0,5
421446,470_15_44,ALGERIA,23102,13,hocine gaham,0,0,0,0,0,0,0,0,0,0,0,0,0,0,0,0,0,0,0,0,0,0
421447,470_15_44,ALGERIA,10431,14,mehdi cheriet,34,3,12,25,2,7,28.6,1,5,20,4,5,80,2,3,5,1,2,3,0,0,11
421448,470_15_44,ALGERIA,23103,15,mohamed sedik touati,29,7,10,70,7,10,70,0,0,0,1,2,50,2,8,10,1,3,2,2,1,15
421449,470_15_44,ALGERIA,0,TOTALS,ALGERIA,200,23,61,37.7,16,37,43.2,7,24,29.2,10,14,71.4,11,28,39,11,22,15,5,2,63
421450,470_15_45,SENEGAL,11764,4,thierno niang,1,0,0,0,0,0,0,0,0,0,0,0,0,0,0,0,0,0,0,0,0,0
421451,470_15_45,SENEGAL,18541,5,xane dalmeida,44,5,11,45.5,3,4,75,2,7,28.6,2,2,100,4,1,5,11,2,4,2,0,14
421452,470_15_45,SENEGAL,23085,6,ibrahima thomas,26,4,10,40,1,4,25,3,6,50,0,0,0,1,3,4,1,4,0,0,1,11
421453,470_15_45,SENEGAL,18543,7,mohamet diop,0,0,0,0,0,0,0,0,0,0,0,0,0,0,0,0,0,0,0,0,0,0
421454,470_15_45,SENEGAL,13966,8,antoine mendy,45,6,17,35.3,2,6,33.3,4,11,36.4,3,4,75,2,3,5,0,5,0,1,0,19
421455,470_15_45,SENEGAL,3592,9,maleye ndoye,45,4,13,30.8,4,5,80,0,8,0,1,1,100,0,3,3,2,3,1,1,0,9
421456,470_15_45,SENEGAL,13963,10,ibrahima mbengue,0,0,0,0,0,0,0,0,0,0,0,0,0,0,0,0,0,0,0,0,0,0
421457,470_15_45,SENEGAL,9148,11,mouhammad faye,0,0,0,0,0,0,0,0,0,0,0,0,0,0,0,0,0,0,0,0,0,0
421458,470_15_45,SENEGAL,23090,12,saer sene,0,0,0,0,0,0,0,0,0,0,0,0,0,0,0,0,0,0,0,0,0,0
421459,470_15_45,SENEGAL,28148,13,cheikh tidiane mbodj,12,0,2,0,0,2,0,0,0,0,2,2,100,0,0,0,0,2,1,0,0,2
421460,470_15_45,SENEGAL,25450,14,gorgui dieng,45,7,20,35,5,13,38.5,2,7,28.6,4,4,100,3,13,16,4,4,4,0,2,20
421461,470_15_45,SENEGAL,23091,15,pape abdou badji,8,2,4,50,2,4,50,0,0,0,0,0,0,0,2,2,0,0,0,0,0,4
421462,470_15_45,SENEGAL,0,TOTALS,SENEGAL,225,28,77,36.4,17,38,44.7,11,39,28.2,12,13,92.3,12,29,41,18,20,10,4,3,79
421463,470_15_45,NIGERIA,23139,4,ben uzoh,28,4,9,44.4,4,8,50,0,1,0,4,5,80,1,4,5,1,3,1,0,0,12
421464,470_15_45,NIGERIA,13976,5,michael umeh,21,1,7,14.3,1,3,33.3,0,4,0,1,2,50,1,1,2,3,1,0,0,0,3
421465,470_15_45,NIGERIA,21026,6,ike diogu,0,0,0,0,0,0,0,0,0,0,0,0,0,0,0,0,0,0,0,0,0,0
421466,470_15_45,NIGERIA,21027,7,al-farouq aminu,36,4,12,33.3,2,5,40,2,7,28.6,0,0,0,1,9,10,4,3,3,4,0,10
421467,470_15_45,NIGERIA,23141,8,jamal olasewere,0,0,0,0,0,0,0,0,0,0,0,0,0,0,0,0,0,0,0,0,0,0
421468,470_15_45,NIGERIA,3647,9,chamberlain oguchi,31,9,15,60,1,2,50,8,13,61.5,2,4,50,0,4,4,1,0,0,0,0,28
421469,470_15_45,NIGERIA,23140,10,stan okoye,4,1,2,50,1,2,50,0,0,0,0,0,0,0,0,0,0,1,0,0,0,2
421470,470_15_45,NIGERIA,23143,11,andy ogide,19,0,6,0,0,2,0,0,4,0,0,0,0,0,3,3,1,2,2,0,0,0
421471,470_15_45,NIGERIA,28095,12,michael gbinije,24,3,5,60,3,3,100,0,2,0,1,4,25,0,1,1,1,0,1,0,0,7
421472,470_15_45,NIGERIA,28096,13,olaseni lawal,35,6,7,85.7,6,7,85.7,0,0,0,5,5,100,4,7,11,3,3,2,0,1,17
421473,470_15_45,NIGERIA,21031,14,alade aminu,24,2,5,40,2,5,40,0,0,0,5,6,83.3,1,8,9,1,4,1,0,1,9
421474,470_15_45,NIGERIA,3656,15,olumide oyedeji,4,0,1,0,0,1,0,0,0,0,0,0,0,0,0,0,0,0,0,0,0,0
421475,470_15_45,NIGERIA,0,TOTALS,NIGERIA,225,30,69,43.5,20,38,52.6,10,31,32.3,18,26,69.2,10,38,48,15,17,12,4,2,88
421476,470_15_46,TUNISIA,18347,4,omar abada,18,1,3,33.3,1,2,50,0,1,0,0,0,0,2,2,4,4,1,1,0,0,2
421477,470_15_46,TUNISIA,28112,5,mohamed abbassi,0,0,0,0,0,0,0,0,0,0,0,0,0,0,0,0,0,0,0,0,0,0
421478,470_15_46,TUNISIA,9216,6,nizar knioua,18,1,5,20,1,4,25,0,1,0,2,2,100,2,1,3,0,0,4,0,0,4
421479,470_15_46,TUNISIA,18521,7,mourad el mabrouk,30,3,9,33.3,2,3,66.7,1,6,16.7,1,1,100,1,4,5,2,2,0,3,0,8
421480,470_15_46,TUNISIA,28113,8,mehdi seyeh,4,0,1,0,0,1,0,0,0,0,0,0,0,0,0,0,0,2,2,1,0,0
421481,470_15_46,TUNISIA,9278,9,mohamed hadidane,16,2,9,22.2,1,3,33.3,1,6,16.7,2,2,100,0,1,1,0,1,1,0,0,7
421482,470_15_46,TUNISIA,28114,10,michael brandon roll,33,4,11,36.4,2,7,28.6,2,4,50,0,0,0,0,2,2,1,3,2,0,0,10
421483,470_15_46,TUNISIA,13953,11,mohamed mokhtar ghyaza,14,2,3,66.7,2,3,66.7,0,0,0,0,0,0,1,0,1,0,3,1,2,0,4
421484,470_15_46,TUNISIA,13954,12,makram ben romdhane,32,5,10,50,5,7,71.4,0,3,0,2,4,50,2,5,7,1,5,3,1,0,12
421485,470_15_46,TUNISIA,9219,13,amine rzig,4,0,0,0,0,0,0,0,0,0,2,2,100,1,1,2,0,0,0,0,0,2
421486,470_15_46,TUNISIA,9220,14,hamdi braa,4,0,1,0,0,1,0,0,0,0,0,0,0,0,0,0,0,0,1,0,0,0
421487,470_15_46,TUNISIA,13956,15,salah mejri,27,1,8,12.5,1,5,20,0,3,0,0,0,0,4,5,9,0,4,2,0,2,2
421488,470_15_46,TUNISIA,0,TOTALS,TUNISIA,200,19,60,31.7,15,36,41.7,4,24,16.7,9,11,81.8,17,22,39,8,21,20,7,2,51
421489,470_15_46,ANGOLA,13818,4,edson ndoniema,16,1,2,50,1,1,100,0,1,0,0,0,0,1,0,1,2,2,2,2,0,2
421490,470_15_46,ANGOLA,3574,5,armando costa,25,0,2,0,0,0,0,0,2,0,1,2,50,2,6,8,0,3,2,3,0,1
421491,470_15_46,ANGOLA,3420,6,carlos morais,34,3,12,25,1,3,33.3,2,9,22.2,6,7,85.7,0,4,4,3,4,5,0,0,14
421492,470_15_46,ANGOLA,16597,7,roberto fortes,11,1,3,33.3,0,0,0,1,3,33.3,0,0,0,0,4,4,0,1,0,0,0,3
421493,470_15_46,ANGOLA,11834,8,hermenegildo santos,0,0,0,0,0,0,0,0,0,0,0,0,0,0,0,0,0,0,0,0,0,0
421494,470_15_46,ANGOLA,11630,9,leonel paulo,19,1,2,50,1,2,50,0,0,0,3,3,100,1,1,2,0,4,2,1,1,5
421495,470_15_46,ANGOLA,7039,10,valdelicio macanga maia joaquim,0,0,0,0,0,0,0,0,0,0,0,0,0,0,0,0,0,0,0,0,0,0
421496,470_15_46,ANGOLA,23104,11,reggie moore,12,1,3,33.3,0,1,0,1,2,50,0,0,0,0,1,1,0,1,0,0,0,3
421497,470_15_46,ANGOLA,9123,12,felizardo ambrosio,14,1,3,33.3,1,2,50,0,1,0,0,0,0,1,0,1,0,1,1,0,0,2
421498,470_15_46,ANGOLA,11831,13,yanick moreira,29,3,10,30,3,10,30,0,0,0,4,4,100,1,1,2,1,0,4,2,1,10
421499,470_15_46,ANGOLA,13819,14,braulio morais,15,1,4,25,1,2,50,0,2,0,2,4,50,0,1,1,0,1,1,1,0,4
421500,470_15_46,ANGOLA,12,15,eduardo mingas,25,7,11,63.6,7,10,70,0,1,0,0,0,0,1,2,3,0,0,2,2,1,14
421501,470_15_46,ANGOLA,0,TOTALS,ANGOLA,200,19,52,36.5,15,31,48.4,4,21,19,16,20,80,11,25,36,6,17,19,11,3,58
421502,470_15_47,TUNISIA,18347,4,omar abada,10,2,2,100,0,0,0,2,2,100,0,0,0,2,0,2,3,0,0,0,0,6
421503,470_15_47,TUNISIA,28112,5,mohamed abbassi,20,5,11,45.5,5,11,45.5,0,0,0,0,0,0,1,2,3,0,4,0,1,0,10
421504,470_15_47,TUNISIA,9216,6,nizar knioua,10,3,5,60,1,2,50,2,3,66.7,0,0,0,2,1,3,1,0,0,1,0,8
421505,470_15_47,TUNISIA,18521,7,mourad el mabrouk,28,3,11,27.3,1,5,20,2,6,33.3,5,6,83.3,0,1,1,3,2,2,0,0,13
421506,470_15_47,TUNISIA,28113,8,mehdi seyeh,2,0,0,0,0,0,0,0,0,0,0,0,0,0,1,1,1,1,1,0,0,0
421507,470_15_47,TUNISIA,9278,9,mohamed hadidane,21,0,7,0,0,4,0,0,3,0,0,0,0,2,2,4,0,2,0,0,0,0
421508,470_15_47,TUNISIA,28114,10,michael brandon roll,30,9,16,56.2,5,8,62.5,4,8,50,3,3,100,0,3,3,5,4,2,1,0,25
421509,470_15_47,TUNISIA,13953,11,mohamed mokhtar ghyaza,23,3,6,50,3,6,50,0,0,0,0,0,0,1,0,1,0,4,1,1,2,6
421510,470_15_47,TUNISIA,13954,12,makram ben romdhane,13,3,4,75,3,3,100,0,1,0,1,1,100,0,2,2,1,3,3,1,0,7
421511,470_15_47,TUNISIA,9219,13,amine rzig,16,0,1,0,0,1,0,0,0,0,0,0,0,1,4,5,0,1,1,1,0,0
421512,470_15_47,TUNISIA,9220,14,hamdi braa,27,0,1,0,0,1,0,0,0,0,7,8,87.5,3,6,9,2,4,0,0,2,7
421513,470_15_47,TUNISIA,13956,15,salah mejri,0,0,0,0,0,0,0,0,0,0,0,0,0,0,0,0,0,0,0,0,0,0
421514,470_15_47,TUNISIA,0,TOTALS,TUNISIA,200,28,64,43.8,18,41,43.9,10,23,43.5,16,18,88.9,12,22,34,16,25,10,6,4,82
421515,470_15_47,SENEGAL,11764,4,thierno niang,0,0,0,0,0,0,0,0,0,0,0,0,0,0,0,0,0,0,0,0,0,0
421516,470_15_47,SENEGAL,18541,5,xane dalmeida,40,1,5,20,1,2,50,0,3,0,6,9,66.7,1,0,1,9,4,2,0,1,8
421517,470_15_47,SENEGAL,23085,6,ibrahima thomas,13,3,5,60,1,1,100,2,4,50,2,4,50,1,1,2,1,1,2,0,0,10
421518,470_15_47,SENEGAL,18543,7,mohamet diop,17,1,5,20,1,3,33.3,0,2,0,0,0,0,1,1,2,1,2,1,0,0,2
421519,470_15_47,SENEGAL,13966,8,antoine mendy,36,7,15,46.7,4,5,80,3,10,30,2,3,66.7,6,4,10,2,4,5,1,0,19
421520,470_15_47,SENEGAL,3592,9,maleye ndoye,28,3,11,27.3,2,4,50,1,7,14.3,0,0,0,0,2,2,0,4,1,0,0,7
421521,470_15_47,SENEGAL,13963,10,ibrahima mbengue,0,0,0,0,0,0,0,0,0,0,0,0,0,0,0,0,0,0,0,0,0,0
421522,470_15_47,SENEGAL,9148,11,mouhammad faye,0,0,0,0,0,0,0,0,0,0,0,0,0,0,0,0,0,0,0,0,0,0
421523,470_15_47,SENEGAL,23090,12,saer sene,8,1,1,100,1,1,100,0,0,0,0,0,0,0,0,0,0,0,0,0,2,2
421524,470_15_47,SENEGAL,28148,13,cheikh tidiane mbodj,0,0,0,0,0,0,0,0,0,0,0,0,0,0,0,0,0,0,0,0,0,0
421525,470_15_47,SENEGAL,25450,14,gorgui dieng,40,7,13,53.8,6,10,60,1,3,33.3,4,5,80,3,9,12,1,3,3,2,2,19
421526,470_15_47,SENEGAL,23091,15,pape abdou badji,19,1,3,33.3,1,3,33.3,0,0,0,4,6,66.7,2,5,7,0,4,2,0,0,6
421527,470_15_47,SENEGAL,0,TOTALS,SENEGAL,200,24,58,41.4,17,29,58.6,7,29,24.1,18,27,66.7,17,23,40,14,22,17,3,5,73
421528,470_15_48,ANGOLA,13818,4,edson ndoniema,19,3,6,50,0,1,0,3,5,60,0,0,0,1,3,4,1,3,0,0,0,9
421529,470_15_48,ANGOLA,3574,5,armando costa,28,1,7,14.3,1,2,50,0,5,0,0,0,0,1,4,5,4,3,2,3,0,2
421530,470_15_48,ANGOLA,3420,6,carlos morais,35,4,20,20,1,8,12.5,3,12,25,4,5,80,0,2,2,2,2,2,2,0,15
421531,470_15_48,ANGOLA,16597,7,roberto fortes,8,1,2,50,0,0,0,1,2,50,0,0,0,1,1,2,0,2,0,0,0,3
421532,470_15_48,ANGOLA,11834,8,hermenegildo santos,0,0,0,0,0,0,0,0,0,0,0,0,0,0,0,0,0,0,0,0,0,0
421533,470_15_48,ANGOLA,11630,9,leonel paulo,12,0,3,0,0,2,0,0,1,0,0,2,0,1,2,3,0,2,2,2,1,0
421534,470_15_48,ANGOLA,7039,10,valdelicio macanga maia joaquim,4,1,3,33.3,1,2,50,0,1,0,0,0,0,2,0,2,0,1,2,0,0,2
421535,470_15_48,ANGOLA,23104,11,reggie moore,11,0,2,0,0,1,0,0,1,0,1,3,33.3,0,2,2,2,3,1,0,0,1
421536,470_15_48,ANGOLA,9123,12,felizardo ambrosio,13,0,0,0,0,0,0,0,0,0,0,2,0,0,0,0,0,4,2,0,0,0
421537,470_15_48,ANGOLA,11831,13,yanick moreira,27,5,7,71.4,5,7,71.4,0,0,0,3,4,75,1,5,6,0,4,1,0,2,13
421538,470_15_48,ANGOLA,13819,14,braulio morais,18,5,11,45.5,3,6,50,2,5,40,0,0,0,0,0,0,2,5,2,0,0,12
421539,470_15_48,ANGOLA,12,15,eduardo mingas,25,3,7,42.9,1,3,33.3,2,4,50,0,0,0,2,6,8,2,4,0,1,0,8
421540,470_15_48,ANGOLA,0,TOTALS,ANGOLA,200,23,68,33.8,12,32,37.5,11,36,30.6,8,16,50,10,27,37,13,33,15,8,3,65
421541,470_15_48,NIGERIA,23139,4,ben uzoh,23,3,7,42.9,3,7,42.9,0,0,0,4,6,66.7,3,0,3,3,2,3,0,0,10
421542,470_15_48,NIGERIA,13976,5,michael umeh,25,1,7,14.3,1,4,25,0,3,0,1,3,33.3,1,2,3,0,1,2,1,0,3
421543,470_15_48,NIGERIA,21026,6,ike diogu,0,0,0,0,0,0,0,0,0,0,0,0,0,0,0,0,0,0,0,0,0,0
421544,470_15_48,NIGERIA,21027,7,al-farouq aminu,25,2,10,20,2,8,25,0,2,0,7,11,63.6,1,4,5,1,2,3,3,1,11
421545,470_15_48,NIGERIA,23141,8,jamal olasewere,0,0,0,0,0,0,0,0,0,0,0,0,0,0,0,0,0,0,0,0,0,0
421546,470_15_48,NIGERIA,3647,9,chamberlain oguchi,31,3,11,27.3,0,1,0,3,10,30,10,15,66.7,0,7,7,0,1,1,0,0,19
421547,470_15_48,NIGERIA,23140,10,stan okoye,5,0,1,0,0,1,0,0,0,0,0,0,0,0,2,2,0,0,0,0,0,0
421548,470_15_48,NIGERIA,23143,11,andy ogide,25,3,11,27.3,2,5,40,1,6,16.7,3,4,75,5,3,8,0,1,1,0,0,10
421549,470_15_48,NIGERIA,28095,12,michael gbinije,15,1,2,50,0,1,0,1,1,100,2,2,100,0,3,3,0,0,1,1,0,5
421550,470_15_48,NIGERIA,28096,13,olaseni lawal,25,3,6,50,3,5,60,0,1,0,6,6,100,5,3,8,2,4,2,1,3,12
421551,470_15_48,NIGERIA,21031,14,alade aminu,23,2,8,25,2,8,25,0,0,0,0,0,0,4,8,12,1,2,3,1,0,4
421552,470_15_48,NIGERIA,3656,15,olumide oyedeji,4,0,0,0,0,0,0,0,0,0,0,0,0,0,0,0,0,1,0,0,0,0
421553,470_15_48,NIGERIA,0,TOTALS,NIGERIA,200,18,63,28.6,13,40,32.5,5,23,21.7,33,47,70.2,24,36,60,7,14,17,7,4,74
423437,476_15_01,KUWAIT,28310,1,yousiff borhamah,16,2,5,40,2,4,50,0,1,0,0,2,0,3,2,5,1,2,2,0,0,4
423438,476_15_01,KUWAIT,28311,4,mashari abu dhom,19,6,10,60,3,5,60,3,5,60,0,0,0,0,1,1,1,0,2,2,0,15
423439,476_15_01,KUWAIT,28312,5,hamad hasan,24,2,7,28.6,1,4,25,1,3,33.3,0,0,0,0,4,4,2,5,5,0,0,5
423440,476_15_01,KUWAIT,14244,12,abdulaziz alhamidi,25,1,4,25,0,1,0,1,3,33.3,0,0,0,0,1,1,2,4,6,0,0,3
423441,476_15_01,KUWAIT,28313,13,mashari alshammari,10,1,4,25,1,4,25,0,0,0,2,3,66.7,1,0,1,0,1,2,2,0,4
423442,476_15_01,KUWAIT,28314,15,mohammad marzouq,6,1,2,50,1,2,50,0,0,0,0,0,0,1,0,1,0,1,0,0,0,2
423443,476_15_01,KUWAIT,28315,16,naser alzafiri,16,2,4,50,2,4,50,0,0,0,0,0,0,0,1,1,0,1,0,0,0,4
423444,476_15_01,KUWAIT,14458,21,abdulrahman alshammari,24,0,10,0,0,10,0,0,0,0,2,2,100,4,2,6,0,0,0,1,2,2
423445,476_15_01,KUWAIT,28316,28,abdulrahman aljuma'h,33,1,5,20,1,4,25,0,1,0,0,2,0,2,6,8,2,5,1,1,2,2
423446,476_15_01,KUWAIT,14243,30,abdullah alsaeid,28,3,7,42.9,1,3,33.3,2,4,50,1,4,25,0,4,4,1,3,2,0,0,9
423447,476_15_01,KUWAIT,0,TOTALS,KUWAIT,200,19,58,32.8,12,41,29.3,7,17,41.2,5,13,38.5,11,22,33,9,22,22,6,4,50
423448,476_15_01,HONG KONG,28317,4,sheung ying so,2,1,1,100,1,1,100,0,0,0,0,0,0,0,0,0,0,1,0,0,0,2
423449,476_15_01,HONG KONG,28318,5,hoi to lau,2,0,2,0,0,2,0,0,0,0,0,2,0,0,0,0,0,0,1,0,0,0
423450,476_15_01,HONG KONG,28319,6,wai kong au-yeung,18,0,3,0,0,2,0,0,1,0,0,0,0,0,1,1,5,0,4,2,0,0
423451,476_15_01,HONG KONG,23387,7,ki lee,28,5,15,33.3,1,2,50,4,13,30.8,1,1,100,1,2,3,1,0,1,4,0,15
423452,476_15_01,HONG KONG,23388,8,siu wing chan,30,2,5,40,2,2,100,0,3,0,0,0,0,0,1,1,2,2,1,3,0,4
423453,476_15_01,HONG KONG,28320,9,shiu wah leung,6,4,4,100,1,1,100,3,3,100,1,1,100,0,1,1,0,0,0,0,0,12
423454,476_15_01,HONG KONG,28321,10,adam xu,14,1,2,50,1,2,50,0,0,0,1,2,50,1,1,2,0,2,2,1,2,3
423455,476_15_01,HONG KONG,3830,11,kam hing cheng,24,5,9,55.6,5,8,62.5,0,1,0,4,9,44.4,1,3,4,5,1,1,2,0,14
423456,476_15_01,HONG KONG,28322,12,ho chun lin,15,4,6,66.7,3,4,75,1,2,50,1,1,100,0,1,1,2,3,1,1,0,10
423457,476_15_01,HONG KONG,3834,13,chun wai wong,18,2,9,22.2,2,6,33.3,0,3,0,2,3,66.7,3,3,6,1,4,0,0,0,6
423458,476_15_01,HONG KONG,23391,14,duncan overbeck reid,24,5,7,71.4,5,7,71.4,0,0,0,3,3,100,5,8,13,1,3,4,2,1,13
423459,476_15_01,HONG KONG,3833,15,wai kit szeto,19,3,4,75,3,4,75,0,0,0,2,4,50,5,4,9,0,0,2,0,2,8
423460,476_15_01,HONG KONG,0,TOTALS,HONG KONG,200,32,67,47.8,24,41,58.5,8,26,30.8,15,26,57.7,20,29,49,17,16,17,15,5,87
423461,476_15_02,PHILIPPINES,25433,1,andray blatche,28,7,18,38.9,6,11,54.5,1,7,14.3,6,8,75,4,8,12,2,2,3,0,1,21
423462,476_15_02,PHILIPPINES,9700,5,gabriel norwood,16,1,2,50,1,2,50,0,0,0,1,2,50,2,2,4,1,0,1,1,0,3
423463,476_15_02,PHILIPPINES,23361,7,jayson william,19,3,8,37.5,3,6,50,0,2,0,4,4,100,0,2,2,1,2,0,0,0,10
423464,476_15_02,PHILIPPINES,28323,8,calvin abueva,20,1,3,33.3,1,3,33.3,0,0,0,3,4,75,1,7,8,1,3,2,2,0,5
423465,476_15_02,PHILIPPINES,28324,9,john intal,17,2,6,33.3,0,2,0,2,4,50,0,0,0,1,1,2,2,0,2,0,0,6
423466,476_15_02,PHILIPPINES,28325,11,terrence romeo,22,4,13,30.8,1,5,20,3,8,37.5,0,0,0,1,1,2,0,3,1,1,0,11
423467,476_15_02,PHILIPPINES,23365,15,jean marc pingris,7,1,1,100,1,1,100,0,0,0,0,0,0,0,0,0,0,4,1,0,0,2
423468,476_15_02,PHILIPPINES,28326,22,matthew ganuelas,6,1,3,33.3,1,3,33.3,0,0,0,0,0,0,1,2,3,0,1,1,0,1,2
423469,476_15_02,PHILIPPINES,14183,23,joachim gunther thoss,17,2,6,33.3,2,6,33.3,0,0,0,0,0,0,3,3,6,0,3,1,0,0,4
423470,476_15_02,PHILIPPINES,9697,25,donaldo hontiveros,19,1,6,16.7,0,0,0,1,6,16.7,0,0,0,0,0,0,0,3,1,0,0,3
423471,476_15_02,PHILIPPINES,18657,33,ranidel de ocampo,20,3,9,33.3,3,6,50,0,3,0,0,0,0,2,3,5,0,1,1,0,0,6
423472,476_15_02,PHILIPPINES,9698,88,pauliasi taulava,11,0,2,0,0,2,0,0,0,0,0,0,0,0,4,4,1,1,1,0,0,0
423473,476_15_02,PHILIPPINES,0,TOTALS,PHILIPPINES,200,26,77,33.8,19,47,40.4,7,30,23.3,14,18,77.8,17,36,53,8,23,15,4,2,73
423474,476_15_02,PALESTINE,28327,4,ahmed haroon,31,0,7,0,0,4,0,0,3,0,0,0,0,0,3,3,1,2,1,1,0,0
423475,476_15_02,PALESTINE,28328,5,shadi khatib,0,0,0,0,0,0,0,0,0,0,0,0,0,0,0,0,0,0,0,0,0,0
423476,476_15_02,PALESTINE,28329,6,jamal abu shamala,40,10,23,43.5,4,13,30.8,6,10,60,0,1,0,2,13,15,3,3,2,1,0,26
423477,476_15_02,PALESTINE,28330,7,ahmed younis,9,0,1,0,0,0,0,0,1,0,0,0,0,0,0,0,1,2,1,0,0,0
423478,476_15_02,PALESTINE,28331,8,jehad othman b. yaghmour,0,0,0,0,0,0,0,0,0,0,0,0,0,0,0,0,0,0,0,0,0,0
423479,476_15_02,PALESTINE,28332,9,amin salman,0,0,0,0,0,0,0,0,0,0,0,0,0,0,0,0,0,0,0,0,0,0
423480,476_15_02,PALESTINE,28333,10,imad qahwash,40,5,20,25,5,13,38.5,0,7,0,7,8,87.5,1,1,2,3,3,5,1,0,17
423481,476_15_02,PALESTINE,28334,11,enar odeh,0,0,0,0,0,0,0,0,0,0,0,0,0,0,0,0,0,0,0,0,0,0
423482,476_15_02,PALESTINE,28335,12,sami owda,0,0,0,0,0,0,0,0,0,0,0,0,0,0,0,0,0,0,0,0,0,0
423483,476_15_02,PALESTINE,28336,13,sani sakakini,40,9,23,39.1,7,16,43.8,2,7,28.6,2,3,66.7,6,8,14,3,4,5,2,1,22
423484,476_15_02,PALESTINE,28337,14,hamza yousef,17,0,2,0,0,2,0,0,0,0,0,0,0,3,2,5,0,3,0,1,0,0
423485,476_15_02,PALESTINE,28338,15,salim sakakini,23,3,7,42.9,3,7,42.9,0,0,0,4,6,66.7,6,5,11,0,3,0,0,0,10
423486,476_15_02,PALESTINE,0,TOTALS,PALESTINE,200,27,83,32.5,19,55,34.5,8,28,28.6,13,18,72.2,23,35,58,11,20,14,6,1,75
423487,476_15_03,IRAN,14400,4,sajjad mashayekhi,14,2,3,66.7,2,3,66.7,0,0,0,4,4,100,0,1,1,1,0,1,1,0,8
423488,476_15_03,IRAN,22994,5,behnam yakhchalidehkordi,10,1,2,50,0,0,0,1,2,50,2,2,100,1,3,4,2,0,0,0,0,5
423489,476_15_03,IRAN,9684,6,javad davari,4,0,1,0,0,0,0,0,1,0,2,2,100,0,1,1,0,2,0,0,0,2
423490,476_15_03,IRAN,9685,7,mahdi kamrani,16,1,4,25,1,4,25,0,0,0,0,0,0,0,0,0,0,3,0,3,0,2
423491,476_15_03,IRAN,28339,8,saeid karekani,23,4,8,50,3,4,75,1,4,25,0,0,0,0,3,3,1,1,1,1,0,9
423492,476_15_03,IRAN,13743,9,mohammad hassanzadeh saberi a,24,5,7,71.4,5,7,71.4,0,0,0,3,5,60,5,4,9,0,3,2,2,0,13
423493,476_15_03,IRAN,9688,10,hamed afagh,18,2,8,25,1,5,20,1,3,33.3,2,3,66.7,1,1,2,3,2,0,2,0,7
423494,476_15_03,IRAN,9690,11,oshin sahakian,23,6,9,66.7,4,5,80,2,4,50,1,2,50,3,3,6,2,2,0,1,0,15
423495,476_15_03,IRAN,28340,12,asghar kardoustpoustinsaraei,6,0,1,0,0,1,0,0,0,0,3,6,50,3,0,3,0,1,0,0,0,3
423496,476_15_03,IRAN,13739,13,mohammad jamshidijafarabadi,20,2,5,40,0,2,0,2,3,66.7,0,0,0,0,3,3,1,4,1,0,0,6
423497,476_15_03,IRAN,11627,14,mohammadsamad nik,26,2,13,15.4,1,6,16.7,1,7,14.3,2,2,100,4,5,9,1,3,1,2,0,7
423498,476_15_03,IRAN,9693,15,hamed ehadadi,16,4,6,66.7,4,6,66.7,0,0,0,1,1,100,1,1,2,2,1,0,1,1,9
423499,476_15_03,IRAN,0,TOTALS,IRAN,200,29,67,43.3,21,43,48.8,8,24,33.3,20,27,74.1,19,26,45,13,22,7,13,1,86
423500,476_15_03,JAPAN,28341,0,yuta tabuse,14,2,6,33.3,1,4,25,1,2,50,0,0,0,0,1,1,1,2,1,0,0,5
423501,476_15_03,JAPAN,23322,6,makoto hiejima,28,4,10,40,3,9,33.3,1,1,100,0,0,0,0,0,0,2,3,2,0,0,9
423502,476_15_03,JAPAN,18625,8,atsuya ota,10,1,1,100,1,1,100,0,0,0,0,0,0,1,1,2,0,5,1,1,0,2
423503,476_15_03,JAPAN,28342,10,ryoma hashimoto,6,0,1,0,0,1,0,0,0,0,2,2,100,0,0,0,0,1,1,0,0,2
423504,476_15_03,JAPAN,3875,15,joji takeuchi,33,3,3,100,3,3,100,0,0,0,4,7,57.1,1,10,11,0,2,5,1,0,10
423505,476_15_03,JAPAN,18621,16,keijuro matsui,13,1,4,25,0,0,0,1,4,25,0,0,0,1,0,1,0,1,0,0,0,3
423506,476_15_03,JAPAN,28343,17,gaku arao,15,1,1,100,1,1,100,0,0,0,0,0,0,0,1,1,0,2,0,0,0,2
423507,476_15_03,JAPAN,23321,24,daiki tanaka,20,2,2,100,1,1,100,1,1,100,0,0,0,0,1,1,0,1,0,1,0,5
423508,476_15_03,JAPAN,28344,25,takatoshi furukawa,27,2,12,16.7,2,7,28.6,0,5,0,3,4,75,2,3,5,0,4,2,0,0,7
423509,476_15_03,JAPAN,25620,34,ryumo ono,22,1,8,12.5,1,7,14.3,0,1,0,0,2,0,1,2,3,1,2,6,0,0,2
423510,476_15_03,JAPAN,18623,42,kenta hirose,11,0,1,0,0,1,0,0,0,0,1,2,50,1,0,1,0,2,1,0,0,1
423511,476_15_03,JAPAN,0,TOTALS,JAPAN,200,17,49,34.7,13,35,37.1,4,14,28.6,10,17,58.8,9,20,29,4,25,19,3,0,48
423512,476_15_04,KOREA,11667,1,taesul kim,9,0,0,0,0,0,0,0,0,0,0,0,0,0,1,1,1,0,3,0,0,0
423513,476_15_04,KOREA,28345,3,junghyun lee,22,3,7,42.9,0,1,0,3,6,50,1,2,50,0,3,3,4,2,1,0,0,10
423514,476_15_04,KOREA,16672,4,seonggon moon,9,3,3,100,2,2,100,1,1,100,2,2,100,1,4,5,1,0,1,0,0,9
423515,476_15_04,KOREA,22972,5,junyong choi,6,1,1,100,1,1,100,0,0,0,0,2,0,0,0,0,1,1,0,0,0,2
423516,476_15_04,KOREA,9631,6,donggeun yang,31,6,8,75,1,2,50,5,6,83.3,0,0,0,0,7,7,9,3,2,1,0,17
423517,476_15_04,KOREA,18640,7,chan hee park,0,0,0,0,0,0,0,0,0,0,0,0,0,0,0,0,0,0,0,0,0,0
423518,476_15_04,KOREA,18643,10,sungmin cho,30,5,8,62.5,0,1,0,5,7,71.4,4,5,80,0,0,0,3,2,1,2,0,19
423519,476_15_04,KOREA,22971,11,sangjae kang,14,3,3,100,3,3,100,0,0,0,0,0,0,1,3,4,1,2,3,0,0,6
423520,476_15_04,KOREA,18644,15,jongkyu kim,17,3,5,60,3,5,60,0,0,0,0,2,0,2,2,4,0,2,1,2,0,6
423521,476_15_04,KOREA,28346,22,taeyoung moon,12,0,4,0,0,4,0,0,0,0,0,0,0,1,1,2,1,1,2,0,0,0
423522,476_15_04,KOREA,14338,32,jonghyun lee,21,4,6,66.7,4,6,66.7,0,0,0,1,2,50,1,3,4,2,2,2,1,0,9
423523,476_15_04,KOREA,18395,33,seounghyun lee,28,4,9,44.4,3,5,60,1,4,25,0,0,0,3,0,3,1,2,0,0,0,9
423524,476_15_04,KOREA,0,TOTALS,KOREA,200,32,54,59.3,17,30,56.7,15,24,62.5,8,15,53.3,13,27,40,24,17,17,6,0,87
423525,476_15_04,JORDAN,18616,0,mah'd n.j. abdeen,19,1,3,33.3,1,1,100,0,2,0,2,2,100,2,1,3,2,1,0,0,0,4
423526,476_15_04,JORDAN,14432,4,malek kanaan,0,0,0,0,0,0,0,0,0,0,0,0,0,0,0,0,0,0,0,0,0,0
423527,476_15_04,JORDAN,28347,6,alex legion,22,1,12,8.3,0,5,0,1,7,14.3,2,2,100,0,1,1,1,1,2,0,0,5
423528,476_15_04,JORDAN,23313,7,ahmad f.l. alhamarsheh,22,0,2,0,0,2,0,0,0,0,1,2,50,4,0,4,0,1,0,1,0,1
423529,476_15_04,JORDAN,23312,9,hani alfaraj,4,0,0,0,0,0,0,0,0,0,0,0,0,0,0,0,0,0,0,0,0,0
423530,476_15_04,JORDAN,9626,10,osama daghles,21,2,8,25,1,3,33.3,1,5,20,0,0,0,1,1,2,4,3,3,0,0,5
423531,476_15_04,JORDAN,16589,13,mohammad hussein,18,5,12,41.7,5,12,41.7,0,0,0,0,1,0,4,3,7,1,3,0,0,1,10
423532,476_15_04,JORDAN,28348,20,ahmad mahmoud obeid,0,0,0,0,0,0,0,0,0,0,0,0,0,0,0,0,0,0,0,0,0,0
423533,476_15_04,JORDAN,3885,21,zaid abbas,25,5,12,41.7,4,9,44.4,1,3,33.3,1,2,50,7,2,9,2,3,2,1,0,12
423534,476_15_04,JORDAN,9623,23,mousa alawadi,32,5,12,41.7,1,5,20,4,7,57.1,0,0,0,1,1,2,0,3,1,1,0,14
423535,476_15_04,JORDAN,9627,33,wesam al-sous,23,1,6,16.7,0,2,0,1,4,25,2,2,100,0,1,1,1,2,3,1,0,5
423536,476_15_04,JORDAN,16588,41,ali jamal zaghab,14,2,7,28.6,2,7,28.6,0,0,0,0,0,0,2,1,3,0,1,1,2,0,4
423537,476_15_04,JORDAN,0,TOTALS,JORDAN,200,22,74,29.7,14,46,30.4,8,28,28.6,8,11,72.7,25,12,37,11,18,13,6,1,60
423538,476_15_05,MALAYSIA,23307,0,wen keong tong,19,1,4,25,1,4,25,0,0,0,2,2,100,0,1,1,2,0,3,0,0,4
423539,476_15_05,MALAYSIA,28349,1,chee huei liaw,0,0,0,0,0,0,0,0,0,0,0,0,0,0,0,0,0,0,0,0,0,0
423540,476_15_05,MALAYSIA,3927,3,eng heng soo,18,1,2,50,0,0,0,1,2,50,1,2,50,0,2,2,1,2,0,0,0,4
423541,476_15_05,MALAYSIA,23306,8,wei hong choo,19,3,7,42.9,2,4,50,1,3,33.3,0,0,0,0,2,2,0,5,2,0,0,7
423542,476_15_05,MALAYSIA,23533,10,liang chuan yek,13,3,5,60,2,2,100,1,3,33.3,3,4,75,1,1,2,0,0,2,1,0,10
423543,476_15_05,MALAYSIA,18639,13,yoong jing kwaan,14,1,4,25,1,4,25,0,0,0,0,0,0,0,3,3,0,5,2,0,0,2
423544,476_15_05,MALAYSIA,28350,17,kok hou teo,22,1,5,20,0,3,0,1,2,50,0,0,0,0,0,0,1,1,0,1,0,3
423545,476_15_05,MALAYSIA,28351,20,chee kheun ma,14,2,4,50,1,2,50,1,2,50,0,0,0,0,3,3,0,1,1,0,0,5
423546,476_15_05,MALAYSIA,23310,21,lok seng mak,15,3,5,60,3,5,60,0,0,0,0,0,0,1,0,1,3,1,0,0,0,6
423547,476_15_05,MALAYSIA,28352,37,siik yang william soon,8,1,3,33.3,1,3,33.3,0,0,0,2,3,66.7,2,0,2,0,1,2,0,0,4
423548,476_15_05,MALAYSIA,28353,41,ivan yeo,30,7,12,58.3,6,11,54.5,1,1,100,3,3,100,2,6,8,1,1,3,0,0,18
423549,476_15_05,MALAYSIA,18638,55,tian yuan kuek,29,3,11,27.3,1,2,50,2,9,22.2,2,2,100,1,5,6,0,5,1,0,1,10
423550,476_15_05,MALAYSIA,0,TOTALS,MALAYSIA,200,26,62,41.9,18,40,45,8,22,36.4,13,16,81.2,9,26,35,8,22,19,2,1,73
423551,476_15_05,INDIA,23335,3,vinay kaushik,17,1,8,12.5,0,3,0,1,5,20,0,0,0,1,3,4,2,1,1,0,0,3
423552,476_15_05,INDIA,28354,4,rajesh prakash uppar,12,0,1,0,0,0,0,0,1,0,0,0,0,1,1,2,1,1,2,1,0,0
423553,476_15_05,INDIA,28355,7,siddhant sanjay shinde,3,1,1,100,0,0,0,1,1,100,0,0,0,0,0,0,0,0,0,0,0,3
423554,476_15_05,INDIA,14219,9,vishesh bhriguvanshi,35,3,9,33.3,2,3,66.7,1,6,16.7,2,4,50,1,2,3,6,1,1,3,0,9
423555,476_15_05,INDIA,18673,10,amritpal singh ,26,4,10,40,4,10,40,0,0,0,4,9,44.4,4,5,9,0,1,0,0,0,12
423556,476_15_05,INDIA,28356,13,vikas kumar ,4,0,2,0,0,2,0,0,0,0,0,0,0,0,0,0,1,1,1,0,0,0
423557,476_15_05,INDIA,18675,14,yadwinder singh,26,7,11,63.6,5,9,55.6,2,2,100,0,0,0,2,5,7,0,1,0,1,0,16
423558,476_15_05,INDIA,28357,15,arvind arumugam,7,6,9,66.7,6,9,66.7,0,0,0,1,1,100,3,2,5,0,1,0,1,0,13
423559,476_15_05,INDIA,18670,22,amjyot singh ,30,8,16,50,6,11,54.5,2,5,40,6,8,75,4,6,10,2,4,2,0,2,24
423560,476_15_05,INDIA,25645,66,akilan pari,28,6,8,75,2,2,100,4,6,66.7,2,2,100,3,3,6,4,3,1,2,0,18
423561,476_15_05,INDIA,28358,69,akashdeep hazra,10,1,3,33.3,1,3,33.3,0,0,0,0,0,0,1,2,3,0,1,0,0,1,2
423562,476_15_05,INDIA,28359,96,gurvinder singh gill,3,1,1,100,1,1,100,0,0,0,0,1,0,0,0,0,0,2,0,0,0,2
423563,476_15_05,INDIA,0,TOTALS,INDIA,200,38,79,48.1,27,53,50.9,11,26,42.3,15,25,60,21,29,50,16,17,9,8,3,102
423564,476_15_06,SINGAPORE,25656,1,shi yang ng,0,0,0,0,0,0,0,0,0,0,0,0,0,0,0,0,0,0,0,0,0,0
423565,476_15_06,SINGAPORE,25653,2,wei jie desmond oh,28,1,4,25,1,4,25,0,0,0,1,2,50,1,1,2,1,3,1,1,0,3
423566,476_15_06,SINGAPORE,14339,4,mingrong jabez su,0,0,0,0,0,0,0,0,0,0,0,0,0,0,0,0,0,0,0,0,0,0
423567,476_15_06,SINGAPORE,25650,5,wei long wong,28,5,16,31.2,2,10,20,3,6,50,2,2,100,0,0,0,0,3,3,3,0,15
423568,476_15_06,SINGAPORE,25649,8,qing huang toh,10,0,1,0,0,0,0,0,1,0,0,0,0,1,2,3,0,1,1,0,0,0
423569,476_15_06,SINGAPORE,25659,9,john jing lun ng,16,0,2,0,0,1,0,0,1,0,0,2,0,0,1,1,0,2,2,0,0,0
423570,476_15_06,SINGAPORE,28360,10,wei meng leon kwek,23,1,2,50,1,2,50,0,0,0,0,0,0,1,3,4,0,4,3,0,0,2
423571,476_15_06,SINGAPORE,25657,12,shengyu lim,27,2,10,20,2,7,28.6,0,3,0,0,0,0,0,0,0,0,4,1,3,0,4
423572,476_15_06,SINGAPORE,25651,17,hanbin ng,26,4,9,44.4,3,4,75,1,5,20,1,2,50,1,1,2,0,2,1,0,0,10
423573,476_15_06,SINGAPORE,28361,22,kelvin hong da lim,2,1,1,100,1,1,100,0,0,0,0,0,0,0,0,0,0,0,0,0,0,2
423574,476_15_06,SINGAPORE,14341,23,kok chiang delvin goh,32,3,12,25,3,11,27.3,0,1,0,0,0,0,3,3,6,0,4,1,1,0,6
423575,476_15_06,SINGAPORE,28362,83,chin hong tan,9,0,1,0,0,1,0,0,0,0,0,0,0,0,3,3,0,0,0,0,0,0
423576,476_15_06,SINGAPORE,0,TOTALS,SINGAPORE,200,17,58,29.3,13,41,31.7,4,17,23.5,4,8,50,9,14,23,1,23,17,8,0,42
423577,476_15_06,CHINA,18850,4,ji wei zhao,18,2,5,40,1,1,100,1,4,25,0,0,0,0,0,0,1,2,0,0,0,5
423578,476_15_06,CHINA,50,5,wei liu,15,1,2,50,1,2,50,0,0,0,1,1,100,1,2,3,3,0,3,0,0,3
423579,476_15_06,CHINA,14374,6,ailun guo,19,2,5,40,2,4,50,0,1,0,0,0,0,0,4,4,6,3,1,0,1,4
423580,476_15_06,CHINA,28363,7,tailong zhao,19,0,4,0,0,0,0,0,4,0,0,0,0,0,2,2,2,0,1,0,1,0
423581,476_15_06,CHINA,14377,8,yanyuhang ding,24,4,7,57.1,4,6,66.7,0,1,0,2,2,100,3,4,7,0,3,2,1,0,10
423582,476_15_06,CHINA,14378,9,xiaochuan zhai,22,6,10,60,5,7,71.4,1,3,33.3,0,0,0,4,5,9,0,3,1,2,0,13
423583,476_15_06,CHINA,16587,10,peng zhou,18,2,4,50,0,1,0,2,3,66.7,2,4,50,1,1,2,0,4,1,3,1,8
423584,476_15_06,CHINA,56,11,jianlian yi,18,3,7,42.9,3,7,42.9,0,0,0,6,7,85.7,4,4,8,1,1,2,1,0,12
423585,476_15_06,CHINA,28364,12,gen li,17,4,4,100,0,0,0,4,4,100,0,0,0,0,0,0,0,1,1,1,1,12
423586,476_15_06,CHINA,18361,13,muhao li,10,1,2,50,1,2,50,0,0,0,1,2,50,0,0,0,0,1,0,0,3,3
423587,476_15_06,CHINA,16635,14,zhelin wang,12,3,5,60,3,5,60,0,0,0,6,8,75,3,2,5,0,1,1,0,0,12
423588,476_15_06,CHINA,18858,15,qi zhou,9,3,4,75,3,4,75,0,0,0,3,4,75,0,1,1,0,1,0,0,1,9
423589,476_15_06,CHINA,0,TOTALS,CHINA,200,31,59,52.5,23,39,59,8,20,40,21,28,75,17,29,46,13,20,13,8,8,91
423590,476_15_07,CHINESE TAIPEI,3841,1,lei tien,19,2,5,40,2,3,66.7,0,2,0,0,1,0,0,3,3,1,1,2,0,1,4
423591,476_15_07,CHINESE TAIPEI,25616,5,cheng liu,9,1,2,50,1,1,100,0,1,0,0,0,0,1,0,1,0,2,3,0,0,2
423592,476_15_07,CHINESE TAIPEI,23316,8,shih-chieh chen,9,2,5,40,2,5,40,0,0,0,0,0,0,0,1,1,1,0,1,1,0,4
423593,476_15_07,CHINESE TAIPEI,9656,9,shih-nien chen,5,0,0,0,0,0,0,0,0,0,0,0,0,0,0,0,1,0,1,0,0,0
423594,476_15_07,CHINESE TAIPEI,9665,13,cheng-ju lu,25,5,8,62.5,1,1,100,4,7,57.1,0,0,0,0,2,2,0,4,1,0,0,14
423595,476_15_07,CHINESE TAIPEI,23319,14,wen-cheng tsai,18,2,6,33.3,2,5,40,0,1,0,2,4,50,0,2,2,1,2,1,0,0,6
423596,476_15_07,CHINESE TAIPEI,23315,15,quincy spencer davis iii,32,11,13,84.6,11,13,84.6,0,0,0,1,4,25,5,1,6,1,4,2,1,2,23
423597,476_15_07,CHINESE TAIPEI,23317,24,chih-shan hung,25,3,6,50,0,0,0,3,6,50,0,2,0,0,1,1,1,3,2,2,0,9
423598,476_15_07,CHINESE TAIPEI,9663,27,chih-chieh lin,28,7,16,43.8,7,10,70,0,6,0,7,9,77.8,1,6,7,3,2,1,0,0,21
423599,476_15_07,CHINESE TAIPEI,3839,41,tai-hao wu,6,0,0,0,0,0,0,0,0,0,0,0,0,1,0,1,1,1,0,0,0,0
423600,476_15_07,CHINESE TAIPEI,28365,49,shun-hsiang chen,0,0,0,0,0,0,0,0,0,0,0,0,0,0,0,0,0,0,0,0,0,0
423601,476_15_07,CHINESE TAIPEI,9659,76,wen-ting tseng,24,2,5,40,2,3,66.7,0,2,0,0,2,0,0,6,6,3,4,1,2,0,4
423602,476_15_07,CHINESE TAIPEI,0,TOTALS,CHINESE TAIPEI,200,35,66,53,28,41,68.3,7,25,28,10,22,45.5,9,24,33,13,23,15,6,3,87
423603,476_15_07,LEBANON,6780,4,jean abd el nour,26,3,6,50,1,4,25,2,2,100,4,4,100,2,5,7,3,3,1,0,0,12
423604,476_15_07,LEBANON,28366,5,amir saoud,9,0,2,0,0,0,0,0,2,0,0,0,0,0,1,1,1,2,1,1,0,0
423605,476_15_07,LEBANON,28367,6,mohamad ali haidar,29,7,16,43.8,3,6,50,4,10,40,0,0,0,2,3,5,0,4,2,0,2,18
423606,476_15_07,LEBANON,28368,7,wael arakji,28,5,8,62.5,3,6,50,2,2,100,2,2,100,2,1,3,2,1,0,1,0,14
423607,476_15_07,LEBANON,28369,8,joseph aby kheres,2,0,0,0,0,0,0,0,0,0,0,0,0,0,0,0,0,0,0,0,0,0
423608,476_15_07,LEBANON,28370,9,ahmad ibrahim,24,9,16,56.2,5,6,83.3,4,10,40,1,2,50,0,3,3,2,1,0,2,0,23
423609,476_15_07,LEBANON,28371,10,nadim souaid,0,0,0,0,0,0,0,0,0,0,0,0,0,0,0,0,0,1,0,0,0,0
423610,476_15_07,LEBANON,8977,11,rodrigue akl,7,0,1,0,0,0,0,0,1,0,0,0,0,0,0,0,0,0,0,1,0,0
423611,476_15_07,LEBANON,18668,12,charles tabet,21,0,0,0,0,0,0,0,0,0,0,0,0,2,2,4,2,3,0,1,1,0
423612,476_15_07,LEBANON,18667,13,bassel bawji,19,2,4,50,2,4,50,0,0,0,3,4,75,2,3,5,1,3,3,1,0,7
423613,476_15_07,LEBANON,28372,14,jasmon jovan youngblood,36,6,11,54.5,5,8,62.5,1,3,33.3,5,11,45.5,0,3,3,2,3,3,3,1,18
423614,476_15_07,LEBANON,28373,15,omar el ayoubi,0,0,0,0,0,0,0,0,0,0,0,0,0,0,0,0,0,0,0,0,0,0
423615,476_15_07,LEBANON,0,TOTALS,LEBANON,200,32,64,50,19,34,55.9,13,30,43.3,15,23,65.2,11,25,36,13,22,10,10,4,92
423616,476_15_08,QATAR,28374,4,abdelrahman yehia abdelhaleem,0,0,0,0,0,0,0,0,0,0,0,0,0,0,0,0,0,0,0,0,0,0
423617,476_15_08,QATAR,28375,5,clinton johnson,43,13,27,48.1,13,24,54.2,0,3,0,5,7,71.4,4,10,14,4,2,1,0,0,31
423618,476_15_08,QATAR,6826,6,saad abdulrahman ali,19,2,8,25,1,5,20,1,3,33.3,2,2,100,3,3,6,1,5,0,2,1,7
423619,476_15_08,QATAR,3860,7,daoud mousa daoud,22,4,8,50,2,3,66.7,2,5,40,0,2,0,1,3,4,0,5,0,1,0,10
423620,476_15_08,QATAR,6827,8,suliman abdi khalid,32,4,9,44.4,3,7,42.9,1,2,50,2,6,33.3,0,4,4,0,3,3,1,0,11
423621,476_15_08,QATAR,28376,9,mohamed hassan a mohamed,19,2,6,33.3,1,2,50,1,4,25,1,2,50,1,2,3,0,2,1,0,0,6
423622,476_15_08,QATAR,28377,10,abdulrahman mohamed saad,22,0,2,0,0,2,0,0,0,0,2,4,50,1,1,2,0,4,2,1,0,2
423623,476_15_08,QATAR,6830,11,ali saeed erfan,34,2,8,25,2,5,40,0,3,0,1,2,50,2,9,11,0,1,1,1,1,5
423624,476_15_08,QATAR,6831,12,mohammed saleem abdulla,9,0,1,0,0,0,0,0,1,0,1,2,50,0,2,2,0,2,0,0,0,1
423625,476_15_08,QATAR,23331,13,mohd mohamed,21,1,3,33.3,1,1,100,0,2,0,4,6,66.7,0,3,3,3,5,6,0,0,6
423626,476_15_08,QATAR,18646,14,abduallah shaher matalkeh,0,0,0,0,0,0,0,0,0,0,0,0,0,0,0,0,0,0,0,0,0,0
423627,476_15_08,QATAR,18645,15,khalid abdalla adam,4,0,0,0,0,0,0,0,0,0,0,0,0,0,2,2,0,2,0,0,0,0
423628,476_15_08,QATAR,0,TOTALS,QATAR,225,28,72,38.9,23,49,46.9,5,23,21.7,18,33,54.5,12,44,56,8,31,15,6,2,79
423629,476_15_08,KAZAKHSTAN,23366,4,timur sultanov,0,0,0,0,0,0,0,0,0,0,0,0,0,0,0,0,0,0,0,0,0,0
423630,476_15_08,KAZAKHSTAN,23367,5,jerry johnson,40,6,14,42.9,3,6,50,3,8,37.5,11,12,91.7,0,4,4,7,2,3,0,0,26
423631,476_15_08,KAZAKHSTAN,23368,6,rustam murzagaliyev,7,0,2,0,0,0,0,0,2,0,0,0,0,1,0,1,0,3,1,1,0,0
423632,476_15_08,KAZAKHSTAN,14353,7,maxim marchuk,7,0,1,0,0,0,0,0,1,0,0,0,0,0,0,0,0,0,1,0,0,0
423633,476_15_08,KAZAKHSTAN,28378,8,maxim smirnov,4,0,1,0,0,1,0,0,0,0,0,0,0,0,0,0,0,1,0,0,0,0
423634,476_15_08,KAZAKHSTAN,28379,9,anatoliy kolesnikov,25,3,12,25,3,9,33.3,0,3,0,3,6,50,1,7,8,0,5,2,0,0,9
423635,476_15_08,KAZAKHSTAN,13764,10,pavel ilin,37,2,6,33.3,0,1,0,2,5,40,0,2,0,2,3,5,0,4,3,3,0,6
423636,476_15_08,KAZAKHSTAN,3813,11,anton ponomarev,40,3,14,21.4,3,10,30,0,4,0,6,9,66.7,5,13,18,0,2,1,2,0,12
423637,476_15_08,KAZAKHSTAN,28380,12,dmitriy klimov,12,3,7,42.9,2,4,50,1,3,33.3,1,2,50,0,1,1,1,5,1,0,0,8
423638,476_15_08,KAZAKHSTAN,9605,13,rustam yargaliyev,37,0,6,0,0,2,0,0,4,0,2,3,66.7,2,2,4,1,3,0,0,0,2
423639,476_15_08,KAZAKHSTAN,9603,14,dmitriy gavrilov,1,0,1,0,0,0,0,0,1,0,0,0,0,0,1,1,0,0,0,0,0,0
423640,476_15_08,KAZAKHSTAN,13766,15,alexandr zhigulin,17,5,7,71.4,4,5,80,1,2,50,1,5,20,1,1,2,0,5,2,0,0,12
423641,476_15_08,KAZAKHSTAN,0,TOTALS,KAZAKHSTAN,225,22,71,31,15,38,39.5,7,33,21.2,24,39,61.5,13,36,49,9,30,14,6,0,75
423642,476_15_09,PHILIPPINES,25433,1,andray blatche,18,6,11,54.5,4,6,66.7,2,5,40,3,6,50,2,6,8,1,2,2,2,1,17
423643,476_15_09,PHILIPPINES,9700,5,gabriel norwood,18,0,5,0,0,2,0,0,3,0,0,0,0,1,1,2,2,2,0,1,2,0
423644,476_15_09,PHILIPPINES,23361,7,jayson william,18,7,9,77.8,2,3,66.7,5,6,83.3,2,2,100,0,5,5,2,2,2,0,0,21
423645,476_15_09,PHILIPPINES,28323,8,calvin abueva,14,1,4,25,1,4,25,0,0,0,6,10,60,2,4,6,2,3,2,0,0,8
423646,476_15_09,PHILIPPINES,28324,9,john intal,13,2,4,50,2,2,100,0,2,0,1,2,50,0,3,3,0,1,1,1,0,5
423647,476_15_09,PHILIPPINES,28325,11,terrence romeo,22,3,16,18.8,0,5,0,3,11,27.3,2,2,100,2,3,5,2,1,0,1,0,11
423648,476_15_09,PHILIPPINES,23365,15,jean marc pingris,13,1,1,100,1,1,100,0,0,0,0,0,0,0,3,3,1,1,1,0,2,2
423649,476_15_09,PHILIPPINES,28326,22,matthew ganuelas,22,3,6,50,3,5,60,0,1,0,1,4,25,2,4,6,3,0,0,0,1,7
423650,476_15_09,PHILIPPINES,14183,23,joachim gunther thoss,9,2,2,100,2,2,100,0,0,0,0,0,0,1,4,5,0,1,1,2,0,4
423651,476_15_09,PHILIPPINES,9697,25,donaldo hontiveros,22,5,8,62.5,1,2,50,4,6,66.7,0,0,0,2,5,7,2,2,1,0,0,14
423652,476_15_09,PHILIPPINES,18657,33,ranidel de ocampo,23,4,6,66.7,4,6,66.7,0,0,0,2,2,100,1,7,8,1,0,0,1,0,10
423653,476_15_09,PHILIPPINES,9698,88,pauliasi taulava,7,1,4,25,1,4,25,0,0,0,0,0,0,3,0,3,0,1,0,0,0,2
423654,476_15_09,PHILIPPINES,0,TOTALS,PHILIPPINES,200,35,76,46.1,21,42,50,14,34,41.2,17,28,60.7,16,46,62,16,16,10,8,6,101
423655,476_15_09,HONG KONG,28317,4,sheung ying so,9,0,3,0,0,1,0,0,2,0,0,0,0,0,1,1,0,0,0,0,0,0
423656,476_15_09,HONG KONG,28318,5,hoi to lau,3,0,1,0,0,1,0,0,0,0,0,0,0,0,0,0,0,1,1,0,0,0
423657,476_15_09,HONG KONG,28319,6,wai kong au-yeung,15,2,5,40,1,3,33.3,1,2,50,0,0,0,1,4,5,0,3,0,0,0,5
423658,476_15_09,HONG KONG,23387,7,ki lee,26,0,10,0,0,5,0,0,5,0,0,0,0,0,2,2,1,1,1,2,0,0
423659,476_15_09,HONG KONG,23388,8,siu wing chan,32,5,16,31.2,2,8,25,3,8,37.5,0,0,0,2,1,3,1,2,3,1,0,13
423660,476_15_09,HONG KONG,28320,9,shiu wah leung,12,0,3,0,0,1,0,0,2,0,1,2,50,0,1,1,1,2,0,0,0,1
423661,476_15_09,HONG KONG,28321,10,adam xu,19,3,5,60,3,5,60,0,0,0,0,0,0,0,0,0,0,0,3,0,0,6
423662,476_15_09,HONG KONG,3830,11,kam hing cheng,7,1,5,20,1,3,33.3,0,2,0,0,0,0,0,1,1,0,1,1,0,0,2
423663,476_15_09,HONG KONG,28322,12,ho chun lin,18,2,5,40,2,3,66.7,0,2,0,1,2,50,0,3,3,2,2,0,0,0,5
423664,476_15_09,HONG KONG,3834,13,chun wai wong,19,2,10,20,1,5,20,1,5,20,2,2,100,4,6,10,0,3,1,1,0,7
423665,476_15_09,HONG KONG,23391,14,duncan overbeck reid,26,5,11,45.5,5,11,45.5,0,0,0,1,2,50,2,3,5,5,4,2,0,1,11
423666,476_15_09,HONG KONG,3833,15,wai kit szeto,12,0,2,0,0,2,0,0,0,0,0,0,0,0,1,1,0,2,1,0,0,0
423667,476_15_09,HONG KONG,0,TOTALS,HONG KONG,200,20,76,26.3,15,48,31.2,5,28,17.9,5,8,62.5,11,27,38,10,21,14,4,1,50
423668,476_15_10,IRAN,14400,4,sajjad mashayekhi,15,1,3,33.3,1,3,33.3,0,0,0,1,2,50,2,2,4,1,1,3,2,0,3
423669,476_15_10,IRAN,22994,5,behnam yakhchalidehkordi,9,0,2,0,0,1,0,0,1,0,3,3,100,1,1,2,1,0,0,0,0,3
423670,476_15_10,IRAN,9684,6,javad davari,8,0,3,0,0,1,0,0,2,0,0,0,0,2,1,3,1,3,1,1,0,0
423671,476_15_10,IRAN,9685,7,mahdi kamrani,23,6,11,54.5,5,8,62.5,1,3,33.3,0,0,0,0,3,3,2,0,1,0,0,13
423672,476_15_10,IRAN,28339,8,saeid karekani,13,1,2,50,1,2,50,0,0,0,2,2,100,0,1,1,1,0,0,2,0,4
423673,476_15_10,IRAN,13743,9,mohammad hassanzadeh saberi a,15,8,12,66.7,8,12,66.7,0,0,0,2,4,50,3,1,4,0,3,3,3,0,18
423674,476_15_10,IRAN,9688,10,hamed afagh,18,4,8,50,2,2,100,2,6,33.3,0,0,0,1,2,3,1,3,0,0,0,10
423675,476_15_10,IRAN,9690,11,oshin sahakian,21,3,6,50,3,4,75,0,2,0,1,2,50,1,4,5,0,3,1,1,0,7
423676,476_15_10,IRAN,28340,12,asghar kardoustpoustinsaraei,9,1,3,33.3,1,3,33.3,0,0,0,1,2,50,1,2,3,0,2,1,0,1,3
423677,476_15_10,IRAN,13739,13,mohammad jamshidijafarabadi,25,2,6,33.3,2,4,50,0,2,0,0,0,0,3,2,5,3,1,2,2,0,4
423678,476_15_10,IRAN,11627,14,mohammadsamad nik,25,5,13,38.5,3,5,60,2,8,25,0,1,0,0,7,7,4,1,3,1,1,12
423679,476_15_10,IRAN,9693,15,hamed ehadadi,19,3,4,75,3,4,75,0,0,0,5,6,83.3,0,2,2,1,2,3,0,2,11
423680,476_15_10,IRAN,0,TOTALS,IRAN,200,34,73,46.6,29,49,59.2,5,24,20.8,15,22,68.2,16,30,46,15,20,18,12,4,88
423681,476_15_10,INDIA,23335,3,vinay kaushik,25,2,2,100,1,1,100,1,1,100,0,0,0,3,4,7,0,1,0,1,0,5
423682,476_15_10,INDIA,28354,4,rajesh prakash uppar,8,1,2,50,0,0,0,1,2,50,0,0,0,0,0,0,0,0,0,0,0,3
423683,476_15_10,INDIA,28355,7,siddhant sanjay shinde,2,0,0,0,0,0,0,0,0,0,0,0,0,0,0,0,0,0,0,0,0,0
423684,476_15_10,INDIA,14219,9,vishesh bhriguvanshi,37,2,11,18.2,2,7,28.6,0,4,0,0,0,0,2,3,5,4,2,6,2,1,4
423685,476_15_10,INDIA,18673,10,amritpal singh ,20,5,11,45.5,5,11,45.5,0,0,0,0,0,0,0,1,1,0,5,1,0,0,10
423686,476_15_10,INDIA,28356,13,vikas kumar ,2,0,0,0,0,0,0,0,0,0,0,0,0,0,0,0,0,0,0,0,0,0
423687,476_15_10,INDIA,18675,14,yadwinder singh,17,3,4,75,2,2,100,1,2,50,3,3,100,1,3,4,0,3,1,0,0,10
423688,476_15_10,INDIA,28357,15,arvind arumugam,14,3,7,42.9,3,6,50,0,1,0,0,0,0,0,2,2,1,2,2,0,0,6
423689,476_15_10,INDIA,18670,22,amjyot singh ,38,9,21,42.9,7,17,41.2,2,4,50,6,11,54.5,4,5,9,3,0,4,0,1,26
423690,476_15_10,INDIA,25645,66,akilan pari,30,1,6,16.7,1,4,25,0,2,0,0,0,0,0,1,1,0,2,2,3,0,2
423691,476_15_10,INDIA,28358,69,akashdeep hazra,2,0,0,0,0,0,0,0,0,0,0,0,0,0,0,0,0,1,0,0,0,0
423692,476_15_10,INDIA,28359,96,gurvinder singh gill,5,0,0,0,0,0,0,0,0,0,0,2,0,0,2,2,0,2,1,0,1,0
423693,476_15_10,INDIA,0,TOTALS,INDIA,200,26,64,40.6,21,48,43.8,5,16,31.2,9,16,56.2,10,22,32,8,18,17,6,3,66
423694,476_15_11,JAPAN,28341,0,yuta tabuse,12,2,3,66.7,2,3,66.7,0,0,0,1,2,50,1,3,4,3,1,0,0,0,5
423695,476_15_11,JAPAN,23322,6,makoto hiejima,15,2,4,50,2,3,66.7,0,1,0,2,2,100,1,0,1,4,3,0,3,0,6
423696,476_15_11,JAPAN,18625,8,atsuya ota,20,2,3,66.7,2,3,66.7,0,0,0,0,0,0,4,4,8,3,2,1,2,1,4
423697,476_15_11,JAPAN,28342,10,ryoma hashimoto,16,4,7,57.1,2,3,66.7,2,4,50,1,2,50,0,2,2,3,4,1,4,0,11
423698,476_15_11,JAPAN,3875,15,joji takeuchi,11,3,4,75,3,4,75,0,0,0,6,9,66.7,2,3,5,0,1,0,1,1,12
423699,476_15_11,JAPAN,18621,16,keijuro matsui,17,9,14,64.3,2,3,66.7,7,11,63.6,0,0,0,0,4,4,0,2,1,3,0,25
423700,476_15_11,JAPAN,28343,17,gaku arao,21,0,1,0,0,1,0,0,0,0,0,0,0,1,3,4,1,0,0,0,0,0
423701,476_15_11,JAPAN,23321,24,daiki tanaka,23,4,10,40,3,6,50,1,4,25,1,2,50,0,4,4,6,1,0,3,0,10
423702,476_15_11,JAPAN,28344,25,takatoshi furukawa,20,5,11,45.5,1,3,33.3,4,8,50,1,1,100,0,4,4,1,2,1,1,0,15
423703,476_15_11,JAPAN,25620,34,ryumo ono,24,8,12,66.7,6,9,66.7,2,3,66.7,1,2,50,2,6,8,2,0,1,0,0,19
423704,476_15_11,JAPAN,18623,42,kenta hirose,22,5,10,50,4,6,66.7,1,4,25,1,1,100,0,3,3,2,1,1,3,0,12
423705,476_15_11,JAPAN,0,TOTALS,JAPAN,200,44,79,55.7,27,44,61.4,17,35,48.6,14,21,66.7,12,39,51,25,17,7,20,2,119
423706,476_15_11,MALAYSIA,23307,0,wen keong tong,30,1,6,16.7,1,3,33.3,0,3,0,3,4,75,0,5,5,1,2,3,0,0,5
423707,476_15_11,MALAYSIA,28349,1,chee huei liaw,0,0,0,0,0,0,0,0,0,0,0,0,0,0,0,0,0,0,0,0,0,0
423708,476_15_11,MALAYSIA,3927,3,eng heng soo,12,0,5,0,0,4,0,0,1,0,0,0,0,0,0,0,1,1,2,0,0,0
423709,476_15_11,MALAYSIA,23306,8,wei hong choo,29,4,14,28.6,2,8,25,2,6,33.3,0,0,0,1,7,8,1,4,4,0,0,10
423710,476_15_11,MALAYSIA,23533,10,liang chuan yek,16,3,5,60,2,2,100,1,3,33.3,0,0,0,1,1,2,0,0,2,0,0,7
423711,476_15_11,MALAYSIA,18639,13,yoong jing kwaan,38,1,9,11.1,1,6,16.7,0,3,0,3,4,75,0,7,7,1,1,6,1,2,5
423712,476_15_11,MALAYSIA,28350,17,kok hou teo,10,0,1,0,0,1,0,0,0,0,0,0,0,0,0,0,0,1,2,0,0,0
423713,476_15_11,MALAYSIA,28351,20,chee kheun ma,25,4,13,30.8,1,4,25,3,9,33.3,0,0,0,0,2,2,0,4,4,1,0,11
423714,476_15_11,MALAYSIA,23310,21,lok seng mak,32,3,7,42.9,3,7,42.9,0,0,0,1,3,33.3,3,3,6,1,2,3,1,0,7
423715,476_15_11,MALAYSIA,28352,37,siik yang william soon,3,0,0,0,0,0,0,0,0,0,0,0,0,0,0,0,0,0,0,0,0,0
423716,476_15_11,MALAYSIA,28353,41,ivan yeo,0,0,0,0,0,0,0,0,0,0,0,0,0,0,0,0,0,0,0,0,0,0
423717,476_15_11,MALAYSIA,18638,55,tian yuan kuek,5,1,2,50,0,0,0,1,2,50,0,0,0,0,1,1,0,1,0,0,0,3
423718,476_15_11,MALAYSIA,0,TOTALS,MALAYSIA,200,17,62,27.4,10,35,28.6,7,27,25.9,7,11,63.6,6,28,34,5,16,26,3,2,48
423719,476_15_12,CHINESE TAIPEI,3841,1,lei tien,12,0,4,0,0,2,0,0,2,0,0,0,0,0,4,4,1,0,1,2,0,0
423720,476_15_12,CHINESE TAIPEI,25616,5,cheng liu,31,8,16,50,5,10,50,3,6,50,2,2,100,4,4,8,2,4,2,3,1,21
423721,476_15_12,CHINESE TAIPEI,23316,8,shih-chieh chen,12,0,3,0,0,3,0,0,0,0,0,0,0,1,0,1,1,0,2,0,1,0
423722,476_15_12,CHINESE TAIPEI,9656,9,shih-nien chen,0,0,0,0,0,0,0,0,0,0,0,0,0,0,0,0,0,0,0,0,0,0
423723,476_15_12,CHINESE TAIPEI,9665,13,cheng-ju lu,9,2,6,33.3,0,0,0,2,6,33.3,0,0,0,0,3,3,0,1,1,0,0,6
423724,476_15_12,CHINESE TAIPEI,23319,14,wen-cheng tsai,5,0,1,0,0,1,0,0,0,0,0,0,0,0,0,0,0,0,0,0,0,0
423725,476_15_12,CHINESE TAIPEI,23315,15,quincy spencer davis iii,29,5,9,55.6,5,9,55.6,0,0,0,3,4,75,4,4,8,1,5,4,1,2,13
423726,476_15_12,CHINESE TAIPEI,23317,24,chih-shan hung,26,5,8,62.5,2,3,66.7,3,5,60,0,0,0,1,1,2,4,5,0,1,0,13
423727,476_15_12,CHINESE TAIPEI,9663,27,chih-chieh lin,29,5,14,35.7,3,6,50,2,8,25,4,5,80,2,8,10,2,3,4,3,0,16
423728,476_15_12,CHINESE TAIPEI,3839,41,tai-hao wu,22,0,6,0,0,6,0,0,0,0,0,0,0,2,2,4,0,5,2,0,0,0
423729,476_15_12,CHINESE TAIPEI,28365,49,shun-hsiang chen,0,0,0,0,0,0,0,0,0,0,0,0,0,0,0,0,0,0,0,0,0,0
423730,476_15_12,CHINESE TAIPEI,9659,76,wen-ting tseng,25,2,6,33.3,2,5,40,0,1,0,0,0,0,1,4,5,1,3,3,1,0,4
423731,476_15_12,CHINESE TAIPEI,0,TOTALS,CHINESE TAIPEI,200,27,73,37,17,45,37.8,10,28,35.7,9,11,81.8,15,31,46,12,26,19,11,4,73
423732,476_15_12,KAZAKHSTAN,23366,4,timur sultanov,0,0,0,0,0,0,0,0,0,0,0,0,0,0,0,0,0,0,0,0,0,0
423733,476_15_12,KAZAKHSTAN,23367,5,jerry johnson,37,3,13,23.1,1,6,16.7,2,7,28.6,6,8,75,0,3,3,8,2,1,1,0,14
423734,476_15_12,KAZAKHSTAN,23368,6,rustam murzagaliyev,3,0,1,0,0,0,0,0,1,0,0,0,0,0,0,0,0,1,0,0,0,0
423735,476_15_12,KAZAKHSTAN,14353,7,maxim marchuk,0,0,0,0,0,0,0,0,0,0,0,0,0,0,0,0,0,0,0,0,0,0
423736,476_15_12,KAZAKHSTAN,28378,8,maxim smirnov,1,0,0,0,0,0,0,0,0,0,0,0,0,0,0,0,0,0,0,0,0,0
423737,476_15_12,KAZAKHSTAN,28379,9,anatoliy kolesnikov,31,6,16,37.5,3,10,30,3,6,50,2,4,50,3,4,7,0,2,5,1,0,17
423738,476_15_12,KAZAKHSTAN,13764,10,pavel ilin,25,4,12,33.3,3,8,37.5,1,4,25,0,0,0,1,2,3,1,3,3,1,0,9
423739,476_15_12,KAZAKHSTAN,3813,11,anton ponomarev,31,5,11,45.5,3,5,60,2,6,33.3,6,6,100,7,7,14,0,2,2,5,0,18
423740,476_15_12,KAZAKHSTAN,28380,12,dmitriy klimov,30,4,9,44.4,3,7,42.9,1,2,50,3,6,50,2,8,10,2,3,2,2,0,12
423741,476_15_12,KAZAKHSTAN,9605,13,rustam yargaliyev,24,4,6,66.7,3,4,75,1,2,50,0,0,0,2,2,4,1,1,0,0,0,9
423742,476_15_12,KAZAKHSTAN,9603,14,dmitriy gavrilov,0,0,0,0,0,0,0,0,0,0,0,0,0,0,0,0,0,0,0,0,0,0
423743,476_15_12,KAZAKHSTAN,13766,15,alexandr zhigulin,19,2,9,22.2,2,5,40,0,4,0,1,2,50,4,3,7,0,2,2,0,0,5
423744,476_15_12,KAZAKHSTAN,0,TOTALS,KAZAKHSTAN,200,28,77,36.4,18,45,40,10,32,31.2,18,26,69.2,21,32,53,12,16,15,10,0,84
423745,476_15_13,PALESTINE,28327,4,ahmed haroon,23,5,9,55.6,2,4,50,3,5,60,3,4,75,1,4,5,2,1,3,1,0,16
423746,476_15_13,PALESTINE,28328,5,shadi khatib,9,0,0,0,0,0,0,0,0,0,0,2,0,0,1,1,0,3,1,0,0,0
423747,476_15_13,PALESTINE,28329,6,jamal abu shamala,32,8,10,80,4,6,66.7,4,4,100,1,1,100,1,5,6,0,1,4,2,0,21
423748,476_15_13,PALESTINE,28330,7,ahmed younis,20,1,2,50,1,2,50,0,0,0,2,3,66.7,0,2,2,2,0,2,2,1,4
423749,476_15_13,PALESTINE,28331,8,jehad othman b. yaghmour,10,0,3,0,0,3,0,0,0,0,0,0,0,1,3,4,0,1,1,0,0,0
423750,476_15_13,PALESTINE,28332,9,amin salman,0,0,0,0,0,0,0,0,0,0,0,0,0,0,0,0,0,0,0,0,0,0
423751,476_15_13,PALESTINE,28333,10,imad qahwash,32,5,14,35.7,5,11,45.5,0,3,0,2,2,100,1,3,4,8,1,1,3,1,12
423752,476_15_13,PALESTINE,28334,11,enar odeh,2,0,0,0,0,0,0,0,0,0,0,0,0,0,1,1,0,2,1,0,0,0
423753,476_15_13,PALESTINE,28335,12,sami owda,3,0,1,0,0,0,0,0,1,0,0,0,0,0,0,0,0,0,0,0,0,0
423754,476_15_13,PALESTINE,28336,13,sani sakakini,27,6,15,40,4,10,40,2,5,40,11,14,78.6,2,6,8,0,0,3,2,0,25
423755,476_15_13,PALESTINE,28337,14,hamza yousef,15,1,2,50,1,2,50,0,0,0,2,4,50,2,4,6,1,5,0,1,0,4
423756,476_15_13,PALESTINE,28338,15,salim sakakini,25,4,8,50,4,8,50,0,0,0,0,0,0,2,3,5,1,1,1,0,0,8
423757,476_15_13,PALESTINE,0,TOTALS,PALESTINE,200,30,64,46.9,21,46,45.7,9,18,50,21,30,70,11,36,47,14,15,17,11,2,90
423758,476_15_13,KUWAIT,28310,1,yousiff borhamah,29,2,6,33.3,1,3,33.3,1,3,33.3,1,2,50,2,4,6,2,2,1,3,0,6
423759,476_15_13,KUWAIT,28311,4,mashari abu dhom,23,5,14,35.7,2,3,66.7,3,11,27.3,2,2,100,0,1,1,0,4,0,0,0,15
423760,476_15_13,KUWAIT,28312,5,hamad hasan,37,8,17,47.1,5,7,71.4,3,10,30,0,0,0,1,5,6,2,2,1,2,2,19
423761,476_15_13,KUWAIT,14244,12,abdulaziz alhamidi,11,1,5,20,1,4,25,0,1,0,0,0,0,0,1,1,0,1,3,1,0,2
423762,476_15_13,KUWAIT,28313,13,mashari alshammari,3,1,2,50,1,1,100,0,1,0,1,2,50,0,0,0,0,1,0,0,0,3
423763,476_15_13,KUWAIT,28314,15,mohammad marzouq,12,1,2,50,1,2,50,0,0,0,2,2,100,1,0,1,0,3,1,0,0,4
423764,476_15_13,KUWAIT,28315,16,naser alzafiri,19,1,7,14.3,0,6,0,1,1,100,0,0,0,0,3,3,1,2,2,0,0,3
423765,476_15_13,KUWAIT,14458,21,abdulrahman alshammari,22,2,4,50,2,4,50,0,0,0,0,0,0,1,8,9,0,4,3,1,0,4
423766,476_15_13,KUWAIT,28316,28,abdulrahman aljuma'h,15,2,4,50,1,2,50,1,2,50,0,0,0,1,0,1,1,4,1,0,0,5
423767,476_15_13,KUWAIT,14243,30,abdullah alsaeid,29,3,9,33.3,2,4,50,1,5,20,1,5,20,3,3,6,2,2,2,2,0,8
423768,476_15_13,KUWAIT,0,TOTALS,KUWAIT,200,26,70,37.1,16,36,44.4,10,34,29.4,7,13,53.8,10,28,38,8,26,15,9,2,69
423769,476_15_14,KOREA,11667,1,taesul kim,3,0,0,0,0,0,0,0,0,0,0,0,0,0,0,0,0,1,1,0,0,0
423770,476_15_14,KOREA,28345,3,junghyun lee,14,1,5,20,0,2,0,1,3,33.3,0,0,0,0,3,3,0,4,1,0,0,3
423771,476_15_14,KOREA,16672,4,seonggon moon,1,0,0,0,0,0,0,0,0,0,0,0,0,0,0,0,0,1,0,0,0,0
423772,476_15_14,KOREA,22972,5,junyong choi,1,0,0,0,0,0,0,0,0,0,0,0,0,0,0,0,0,0,0,0,0,0
423773,476_15_14,KOREA,9631,6,donggeun yang,37,8,14,57.1,5,10,50,3,4,75,5,6,83.3,3,7,10,3,1,2,1,0,24
423774,476_15_14,KOREA,18640,7,chan hee park,0,0,0,0,0,0,0,0,0,0,0,0,0,0,0,0,0,0,0,0,0,0
423775,476_15_14,KOREA,18643,10,sungmin cho,29,4,13,30.8,3,8,37.5,1,5,20,5,5,100,0,0,0,3,4,2,1,0,14
423776,476_15_14,KOREA,22971,11,sangjae kang,7,0,0,0,0,0,0,0,0,0,0,0,0,0,1,1,1,3,0,0,0,0
423777,476_15_14,KOREA,18644,15,jongkyu kim,20,2,4,50,2,4,50,0,0,0,0,0,0,1,2,3,0,4,0,0,2,4
423778,476_15_14,KOREA,28346,22,taeyoung moon,31,4,5,80,4,5,80,0,0,0,0,0,0,3,5,8,1,5,0,1,0,8
423779,476_15_14,KOREA,14338,32,jonghyun lee,19,4,9,44.4,4,9,44.4,0,0,0,0,0,0,1,1,2,0,2,1,0,3,8
423780,476_15_14,KOREA,18395,33,seounghyun lee,38,4,11,36.4,2,6,33.3,2,5,40,2,2,100,1,3,4,0,3,2,0,1,12
423781,476_15_14,KOREA,0,TOTALS,KOREA,200,27,61,44.3,20,44,45.5,7,17,41.2,12,13,92.3,11,22,33,8,28,9,3,6,73
423782,476_15_14,CHINA,18850,4,ji wei zhao,23,1,5,20,1,4,25,0,1,0,1,1,100,3,3,6,5,5,0,0,0,3
423783,476_15_14,CHINA,50,5,wei liu,7,0,0,0,0,0,0,0,0,0,0,0,0,0,2,2,2,2,0,0,0,0
423784,476_15_14,CHINA,14374,6,ailun guo,24,4,10,40,4,7,57.1,0,3,0,0,2,0,1,2,3,2,3,1,1,0,8
423785,476_15_14,CHINA,28363,7,tailong zhao,0,0,0,0,0,0,0,0,0,0,0,0,0,0,0,0,0,0,0,0,0,0
423786,476_15_14,CHINA,14377,8,yanyuhang ding,13,0,3,0,0,2,0,0,1,0,0,0,0,1,1,2,0,3,0,0,0,0
423787,476_15_14,CHINA,14378,9,xiaochuan zhai,13,0,2,0,0,2,0,0,0,0,0,0,0,0,1,1,0,0,0,0,0,0
423788,476_15_14,CHINA,16587,10,peng zhou,30,3,11,27.3,1,6,16.7,2,5,40,6,7,85.7,1,0,1,0,3,2,0,1,14
423789,476_15_14,CHINA,56,11,jianlian yi,32,7,13,53.8,7,13,53.8,0,0,0,6,8,75,4,7,11,0,1,1,2,1,20
423790,476_15_14,CHINA,28364,12,gen li,21,2,5,40,1,4,25,1,1,100,0,0,0,1,0,1,1,1,0,0,1,5
423791,476_15_14,CHINA,18361,13,muhao li,0,0,0,0,0,0,0,0,0,0,0,0,0,0,0,0,0,0,0,0,0,0
423792,476_15_14,CHINA,16635,14,zhelin wang,12,1,5,20,1,5,20,0,0,0,3,6,50,5,0,5,0,0,2,0,0,5
423793,476_15_14,CHINA,18858,15,qi zhou,25,9,14,64.3,9,13,69.2,0,1,0,3,3,100,3,5,8,1,1,2,0,2,21
423794,476_15_14,CHINA,0,TOTALS,CHINA,200,27,68,39.7,24,56,42.9,3,12,25,19,27,70.4,22,22,44,11,19,8,3,5,76
423795,476_15_15,JORDAN,18616,0,mah'd n.j. abdeen,18,2,7,28.6,0,1,0,2,6,33.3,0,0,0,0,2,2,5,2,0,0,0,6
423796,476_15_15,JORDAN,14432,4,malek kanaan,4,0,0,0,0,0,0,0,0,0,0,0,0,0,0,0,0,0,1,0,0,0
423797,476_15_15,JORDAN,28347,6,alex legion,23,8,13,61.5,5,9,55.6,3,4,75,0,0,0,1,3,4,1,1,0,1,0,19
423798,476_15_15,JORDAN,23313,7,ahmad f.l. alhamarsheh,28,3,4,75,1,1,100,2,3,66.7,4,5,80,1,6,7,1,3,2,1,0,12
423799,476_15_15,JORDAN,23312,9,hani alfaraj,17,2,4,50,1,1,100,1,3,33.3,0,0,0,0,0,0,0,1,0,1,0,5
423800,476_15_15,JORDAN,9626,10,osama daghles,22,2,4,50,2,2,100,0,2,0,0,0,0,0,5,5,2,5,3,0,0,4
423801,476_15_15,JORDAN,16589,13,mohammad hussein,0,0,0,0,0,0,0,0,0,0,0,0,0,0,0,0,0,0,0,0,0,0
423802,476_15_15,JORDAN,28348,20,ahmad mahmoud obeid,6,0,0,0,0,0,0,0,0,0,0,0,0,0,0,0,0,3,2,0,0,0
423803,476_15_15,JORDAN,3885,21,zaid abbas,24,5,7,71.4,5,5,100,0,2,0,5,8,62.5,3,4,7,3,3,2,2,1,15
423804,476_15_15,JORDAN,9623,23,mousa alawadi,19,4,7,57.1,2,2,100,2,5,40,2,4,50,1,0,1,1,0,2,0,0,12
423805,476_15_15,JORDAN,9627,33,wesam al-sous,17,5,9,55.6,1,1,100,4,8,50,0,0,0,2,0,2,1,1,0,1,0,14
423806,476_15_15,JORDAN,16588,41,ali jamal zaghab,22,5,9,55.6,5,9,55.6,0,0,0,1,2,50,5,5,10,1,2,0,0,2,11
423807,476_15_15,JORDAN,0,TOTALS,JORDAN,200,36,64,56.2,22,31,71,14,33,42.4,12,19,63.2,13,28,41,15,21,12,6,3,98
423808,476_15_15,SINGAPORE,25656,1,shi yang ng,0,0,0,0,0,0,0,0,0,0,0,0,0,0,0,0,0,0,0,0,0,0
423809,476_15_15,SINGAPORE,25653,2,wei jie desmond oh,14,1,4,25,1,2,50,0,2,0,3,4,75,0,0,0,1,4,0,1,0,5
423810,476_15_15,SINGAPORE,14339,4,mingrong jabez su,0,0,0,0,0,0,0,0,0,0,0,0,0,0,0,0,0,0,0,0,0,0
423811,476_15_15,SINGAPORE,25650,5,wei long wong,36,5,9,55.6,3,4,75,2,5,40,2,2,100,0,1,1,2,0,1,1,0,14
423812,476_15_15,SINGAPORE,25649,8,qing huang toh,14,2,5,40,1,1,100,1,4,25,0,0,0,1,2,3,1,0,0,0,0,5
423813,476_15_15,SINGAPORE,25659,9,john jing lun ng,14,1,6,16.7,0,0,0,1,6,16.7,0,0,0,1,1,2,0,2,0,0,0,3
423814,476_15_15,SINGAPORE,28360,10,wei meng leon kwek,27,3,8,37.5,2,7,28.6,1,1,100,0,0,0,5,2,7,1,1,2,1,0,7
423815,476_15_15,SINGAPORE,25657,12,shengyu lim,24,7,14,50,7,12,58.3,0,2,0,5,8,62.5,2,2,4,2,4,2,1,1,19
423816,476_15_15,SINGAPORE,25651,17,hanbin ng,28,3,14,21.4,1,5,20,2,9,22.2,0,0,0,1,4,5,2,3,4,0,0,8
423817,476_15_15,SINGAPORE,28361,22,kelvin hong da lim,3,0,0,0,0,0,0,0,0,0,0,0,0,0,0,0,0,0,0,0,0,0
423818,476_15_15,SINGAPORE,14341,23,kok chiang delvin goh,31,3,10,30,3,10,30,0,0,0,1,3,33.3,6,4,10,2,1,1,1,1,7
423819,476_15_15,SINGAPORE,28362,83,chin hong tan,9,0,1,0,0,1,0,0,0,0,0,0,0,0,0,0,1,2,0,0,0,0
423820,476_15_15,SINGAPORE,0,TOTALS,SINGAPORE,200,25,71,35.2,18,42,42.9,7,29,24.1,11,17,64.7,19,18,37,12,17,11,5,2,68
423821,476_15_16,LEBANON,6780,4,jean abd el nour,36,5,10,50,5,9,55.6,0,1,0,0,1,0,3,7,10,1,4,1,0,0,10
423822,476_15_16,LEBANON,28366,5,amir saoud,22,4,8,50,2,3,66.7,2,5,40,0,0,0,0,1,1,0,3,2,3,0,10
423823,476_15_16,LEBANON,28367,6,mohamad ali haidar,42,7,13,53.8,4,7,57.1,3,6,50,7,11,63.6,1,10,11,0,2,2,0,2,24
423824,476_15_16,LEBANON,28368,7,wael arakji,41,6,12,50,5,10,50,1,2,50,1,5,20,3,3,6,7,5,1,1,0,14
423825,476_15_16,LEBANON,28369,8,joseph aby kheres,1,0,0,0,0,0,0,0,0,0,0,0,0,0,0,0,0,0,0,0,0,0
423826,476_15_16,LEBANON,28370,9,ahmad ibrahim,21,4,13,30.8,2,7,28.6,2,6,33.3,3,4,75,2,1,3,0,1,0,1,1,13
423827,476_15_16,LEBANON,28371,10,nadim souaid,1,0,0,0,0,0,0,0,0,0,0,0,0,0,0,0,0,0,0,0,0,0
423828,476_15_16,LEBANON,8977,11,rodrigue akl,9,0,0,0,0,0,0,0,0,0,0,0,0,1,1,2,0,1,1,0,0,0
423829,476_15_16,LEBANON,18668,12,charles tabet,16,3,3,100,3,3,100,0,0,0,0,0,0,1,3,4,0,3,0,1,0,6
423830,476_15_16,LEBANON,18667,13,bassel bawji,15,2,5,40,2,5,40,0,0,0,0,0,0,1,2,3,1,3,4,0,3,4
423831,476_15_16,LEBANON,28372,14,jasmon jovan youngblood,48,7,18,38.9,6,12,50,1,6,16.7,4,8,50,2,2,4,4,0,3,2,0,19
423832,476_15_16,LEBANON,28373,15,omar el ayoubi,0,0,0,0,0,0,0,0,0,0,0,0,0,0,0,0,0,0,0,0,0,0
423833,476_15_16,LEBANON,0,TOTALS,LEBANON,250,38,82,46.3,29,56,51.8,9,26,34.6,15,29,51.7,18,30,48,13,22,15,8,6,100
423834,476_15_16,QATAR,28374,4,abdelrahman yehia abdelhaleem,0,0,0,0,0,0,0,0,0,0,0,0,0,0,0,0,0,0,0,0,0,0
423835,476_15_16,QATAR,28375,5,clinton johnson,50,13,24,54.2,12,20,60,1,4,25,4,4,100,1,6,7,2,4,5,0,0,31
423836,476_15_16,QATAR,6826,6,saad abdulrahman ali,26,6,10,60,4,6,66.7,2,4,50,6,9,66.7,0,5,5,1,4,3,2,0,20
423837,476_15_16,QATAR,3860,7,daoud mousa daoud,21,1,4,25,1,1,100,0,3,0,0,0,0,0,1,1,0,3,1,1,2,2
423838,476_15_16,QATAR,6827,8,suliman abdi khalid,12,0,2,0,0,1,0,0,1,0,4,4,100,0,3,3,0,0,0,0,0,4
423839,476_15_16,QATAR,28376,9,mohamed hassan a mohamed,23,3,8,37.5,0,1,0,3,7,42.9,2,3,66.7,1,1,2,0,5,1,0,0,11
423840,476_15_16,QATAR,28377,10,abdulrahman mohamed saad,30,6,12,50,6,11,54.5,0,1,0,1,2,50,1,2,3,0,4,0,2,1,13
423841,476_15_16,QATAR,6830,11,ali saeed erfan,33,4,12,33.3,3,8,37.5,1,4,25,5,7,71.4,2,2,4,1,0,0,2,1,14
423842,476_15_16,QATAR,6831,12,mohammed saleem abdulla,4,0,2,0,0,2,0,0,0,0,0,0,0,1,0,1,0,1,0,1,0,0
423843,476_15_16,QATAR,23331,13,mohd mohamed,29,4,9,44.4,4,8,50,0,1,0,0,2,0,3,6,9,2,4,1,1,0,8
423844,476_15_16,QATAR,18646,14,abduallah shaher matalkeh,0,0,0,0,0,0,0,0,0,0,0,0,0,0,0,0,0,0,0,0,0,0
423845,476_15_16,QATAR,18645,15,khalid abdalla adam,22,1,2,50,1,2,50,0,0,0,0,0,0,6,3,9,0,1,0,1,1,2
423846,476_15_16,QATAR,0,TOTALS,QATAR,250,38,85,44.7,31,60,51.7,7,25,28,22,31,71,19,32,51,6,26,13,10,5,105
423847,476_15_17,MALAYSIA,23307,0,wen keong tong,24,1,2,50,1,1,100,0,1,0,1,2,50,2,0,2,3,2,5,3,0,3
423848,476_15_17,MALAYSIA,28349,1,chee huei liaw,0,0,0,0,0,0,0,0,0,0,0,0,0,0,0,0,0,0,0,0,0,0
423849,476_15_17,MALAYSIA,3927,3,eng heng soo,14,1,4,25,1,2,50,0,2,0,0,0,0,0,3,3,1,1,2,0,0,2
423850,476_15_17,MALAYSIA,23306,8,wei hong choo,34,7,21,33.3,5,12,41.7,2,9,22.2,0,0,0,0,4,4,0,1,3,3,0,16
423851,476_15_17,MALAYSIA,23533,10,liang chuan yek,11,0,1,0,0,1,0,0,0,0,0,0,0,0,0,0,0,0,0,0,0,0
423852,476_15_17,MALAYSIA,18639,13,yoong jing kwaan,39,3,15,20,3,12,25,0,3,0,0,0,0,1,3,4,2,2,1,1,0,6
423853,476_15_17,MALAYSIA,28350,17,kok hou teo,8,0,2,0,0,1,0,0,1,0,0,0,0,0,1,1,1,1,3,1,0,0
423854,476_15_17,MALAYSIA,28351,20,chee kheun ma,29,4,15,26.7,1,6,16.7,3,9,33.3,0,0,0,0,0,0,0,3,1,1,0,11
423855,476_15_17,MALAYSIA,23310,21,lok seng mak,35,2,8,25,2,7,28.6,0,1,0,0,0,0,1,2,3,0,3,4,0,0,4
423856,476_15_17,MALAYSIA,28352,37,siik yang william soon,6,0,1,0,0,1,0,0,0,0,0,0,0,2,1,3,0,0,3,0,0,0
423857,476_15_17,MALAYSIA,28353,41,ivan yeo,0,0,0,0,0,0,0,0,0,0,0,0,0,0,0,0,0,0,0,0,0,0
423858,476_15_17,MALAYSIA,18638,55,tian yuan kuek,0,0,0,0,0,0,0,0,0,0,0,0,0,0,0,0,0,0,0,0,0,0
423859,476_15_17,MALAYSIA,0,TOTALS,MALAYSIA,200,18,69,26.1,13,43,30.2,5,26,19.2,1,2,50,7,17,24,7,13,23,9,0,42
423860,476_15_17,IRAN,14400,4,sajjad mashayekhi,20,6,8,75,4,5,80,2,3,66.7,0,0,0,0,4,4,2,1,2,3,0,14
423861,476_15_17,IRAN,22994,5,behnam yakhchalidehkordi,25,2,6,33.3,2,3,66.7,0,3,0,2,2,100,4,2,6,4,0,1,0,0,6
423862,476_15_17,IRAN,9684,6,javad davari,13,2,3,66.7,0,0,0,2,3,66.7,0,0,0,0,1,1,2,0,2,1,0,6
423863,476_15_17,IRAN,9685,7,mahdi kamrani,21,6,16,37.5,3,9,33.3,3,7,42.9,0,0,0,2,4,6,4,0,1,2,0,15
423864,476_15_17,IRAN,28339,8,saeid karekani,16,4,5,80,1,1,100,3,4,75,0,0,0,0,3,3,5,1,1,4,0,11
423865,476_15_17,IRAN,13743,9,mohammad hassanzadeh saberi a,25,11,16,68.8,11,16,68.8,0,0,0,6,7,85.7,12,6,18,0,0,2,1,0,28
423866,476_15_17,IRAN,9688,10,hamed afagh,0,0,0,0,0,0,0,0,0,0,0,0,0,0,0,0,0,0,0,0,0,0
423867,476_15_17,IRAN,9690,11,oshin sahakian,12,1,2,50,1,2,50,0,0,0,0,0,0,0,4,4,1,0,1,0,0,2
423868,476_15_17,IRAN,28340,12,asghar kardoustpoustinsaraei,25,11,14,78.6,11,14,78.6,0,0,0,2,5,40,4,6,10,1,1,2,0,1,24
423869,476_15_17,IRAN,13739,13,mohammad jamshidijafarabadi,22,1,5,20,1,1,100,0,4,0,3,3,100,0,5,5,4,0,2,3,0,5
423870,476_15_17,IRAN,11627,14,mohammadsamad nik,20,5,8,62.5,4,4,100,1,4,25,0,0,0,0,5,5,2,0,1,3,0,11
423871,476_15_17,IRAN,9693,15,hamed ehadadi,0,0,0,0,0,0,0,0,0,0,0,0,0,0,0,0,0,0,0,0,0,0
423872,476_15_17,IRAN,0,TOTALS,IRAN,200,49,83,59,38,55,69.1,11,28,39.3,13,17,76.5,22,42,64,25,3,15,17,1,122
423873,476_15_18,SINGAPORE,25656,1,shi yang ng,3,0,0,0,0,0,0,0,0,0,0,0,0,0,1,1,0,0,0,0,0,0
423874,476_15_18,SINGAPORE,25653,2,wei jie desmond oh,26,0,4,0,0,4,0,0,0,0,2,4,50,1,3,4,0,4,1,0,0,2
423875,476_15_18,SINGAPORE,14339,4,mingrong jabez su,0,0,0,0,0,0,0,0,0,0,0,0,0,0,0,0,0,0,0,0,0,0
423876,476_15_18,SINGAPORE,25650,5,wei long wong,30,1,7,14.3,0,2,0,1,5,20,2,2,100,1,5,6,4,4,3,0,0,5
423877,476_15_18,SINGAPORE,25649,8,qing huang toh,10,1,4,25,1,4,25,0,0,0,0,0,0,0,0,0,0,1,2,0,0,2
423878,476_15_18,SINGAPORE,25659,9,john jing lun ng,6,0,2,0,0,0,0,0,2,0,0,0,0,0,0,0,0,1,0,0,0,0
423879,476_15_18,SINGAPORE,28360,10,wei meng leon kwek,26,5,11,45.5,5,10,50,0,1,0,2,2,100,4,2,6,0,2,2,1,0,12
423880,476_15_18,SINGAPORE,25657,12,shengyu lim,18,2,6,33.3,2,4,50,0,2,0,0,0,0,1,1,2,0,3,2,1,0,4
423881,476_15_18,SINGAPORE,25651,17,hanbin ng,31,2,11,18.2,0,3,0,2,8,25,0,0,0,0,2,2,1,3,1,0,0,6
423882,476_15_18,SINGAPORE,28361,22,kelvin hong da lim,10,1,3,33.3,1,3,33.3,0,0,0,2,2,100,2,0,2,2,3,1,0,0,4
423883,476_15_18,SINGAPORE,14341,23,kok chiang delvin goh,34,3,8,37.5,3,8,37.5,0,0,0,2,6,33.3,4,6,10,1,2,2,1,2,8
423884,476_15_18,SINGAPORE,28362,83,chin hong tan,7,1,2,50,1,2,50,0,0,0,0,0,0,0,0,0,0,1,1,0,0,2
423885,476_15_18,SINGAPORE,0,TOTALS,SINGAPORE,200,16,58,27.6,13,40,32.5,3,18,16.7,10,16,62.5,14,22,36,8,24,21,3,2,45
423886,476_15_18,KOREA,11667,1,taesul kim,30,2,5,40,1,4,25,1,1,100,1,2,50,0,2,2,5,3,1,0,0,6
423887,476_15_18,KOREA,28345,3,junghyun lee,24,4,10,40,0,2,0,4,8,50,3,5,60,3,2,5,5,2,0,3,0,15
423888,476_15_18,KOREA,16672,4,seonggon moon,19,3,7,42.9,2,4,50,1,3,33.3,0,0,0,0,2,2,0,2,0,2,0,7
423889,476_15_18,KOREA,22972,5,junyong choi,35,2,7,28.6,1,2,50,1,5,20,5,6,83.3,1,9,10,8,2,5,3,0,10
423890,476_15_18,KOREA,9631,6,donggeun yang,0,0,0,0,0,0,0,0,0,0,0,0,0,0,0,0,0,0,0,0,0,0
423891,476_15_18,KOREA,18640,7,chan hee park,0,0,0,0,0,0,0,0,0,0,0,0,0,0,0,0,0,0,0,0,0,0
423892,476_15_18,KOREA,18643,10,sungmin cho,0,0,0,0,0,0,0,0,0,0,0,0,0,0,0,0,0,0,0,0,0,0
423893,476_15_18,KOREA,22971,11,sangjae kang,30,6,11,54.5,6,10,60,0,1,0,1,2,50,2,2,4,2,2,0,1,1,13
423894,476_15_18,KOREA,18644,15,jongkyu kim,20,5,8,62.5,5,8,62.5,0,0,0,7,7,100,2,8,10,0,2,1,1,0,17
423895,476_15_18,KOREA,28346,22,taeyoung moon,13,3,6,50,3,6,50,0,0,0,1,1,100,3,1,4,0,1,2,0,0,7
423896,476_15_18,KOREA,14338,32,jonghyun lee,20,3,5,60,3,5,60,0,0,0,3,4,75,1,2,3,1,3,2,0,4,9
423897,476_15_18,KOREA,18395,33,seounghyun lee,10,1,2,50,1,2,50,0,0,0,1,1,100,0,1,1,1,1,1,0,0,3
423898,476_15_18,KOREA,0,TOTALS,KOREA,200,29,61,47.5,22,43,51.2,7,18,38.9,22,28,78.6,12,30,42,22,18,13,10,5,87
423899,476_15_19,INDIA,23335,3,vinay kaushik,29,2,3,66.7,0,0,0,2,3,66.7,0,0,0,0,4,4,0,2,0,2,0,6
423900,476_15_19,INDIA,28354,4,rajesh prakash uppar,4,0,0,0,0,0,0,0,0,0,0,0,0,0,0,0,0,0,0,0,0,0
423901,476_15_19,INDIA,28355,7,siddhant sanjay shinde,0,0,0,0,0,0,0,0,0,0,0,0,0,0,0,0,0,0,0,0,0,0
423902,476_15_19,INDIA,14219,9,vishesh bhriguvanshi,40,7,17,41.2,1,7,14.3,6,10,60,4,5,80,1,7,8,5,2,3,1,0,24
423903,476_15_19,INDIA,18673,10,amritpal singh ,38,5,18,27.8,5,17,29.4,0,1,0,2,6,33.3,6,4,10,2,1,3,0,2,12
423904,476_15_19,INDIA,28356,13,vikas kumar ,0,0,0,0,0,0,0,0,0,0,0,0,0,0,0,0,0,0,0,0,0,0
423905,476_15_19,INDIA,18675,14,yadwinder singh,10,0,2,0,0,1,0,0,1,0,0,0,0,0,2,2,0,0,0,0,0,0
423906,476_15_19,INDIA,28357,15,arvind arumugam,3,0,2,0,0,2,0,0,0,0,0,0,0,1,1,2,0,0,0,0,0,0
423907,476_15_19,INDIA,18670,22,amjyot singh ,38,8,18,44.4,8,15,53.3,0,3,0,3,4,75,5,5,10,3,3,7,1,2,19
423908,476_15_19,INDIA,25645,66,akilan pari,36,2,5,40,2,3,66.7,0,2,0,0,0,0,1,3,4,1,4,1,2,0,4
423909,476_15_19,INDIA,28358,69,akashdeep hazra,0,0,0,0,0,0,0,0,0,0,0,0,0,0,0,0,0,0,0,0,0,0
423910,476_15_19,INDIA,28359,96,gurvinder singh gill,2,0,1,0,0,1,0,0,0,0,0,0,0,0,0,0,0,0,0,0,1,0
423911,476_15_19,INDIA,0,TOTALS,INDIA,200,24,66,36.4,16,46,34.8,8,20,40,9,15,60,15,28,43,11,12,15,6,5,65
423912,476_15_19,JAPAN,28341,0,yuta tabuse,29,5,11,45.5,5,10,50,0,1,0,0,0,0,3,4,7,8,2,0,3,0,10
423913,476_15_19,JAPAN,23322,6,makoto hiejima,29,8,13,61.5,7,10,70,1,3,33.3,2,2,100,2,1,3,6,1,2,1,1,19
423914,476_15_19,JAPAN,18625,8,atsuya ota,8,1,3,33.3,1,3,33.3,0,0,0,0,0,0,1,0,1,0,4,0,0,0,2
423915,476_15_19,JAPAN,28342,10,ryoma hashimoto,8,1,2,50,1,1,100,0,1,0,0,0,0,0,0,0,0,1,0,0,0,2
423916,476_15_19,JAPAN,3875,15,joji takeuchi,40,9,18,50,8,17,47.1,1,1,100,3,4,75,3,16,19,2,3,3,0,1,22
423917,476_15_19,JAPAN,18621,16,keijuro matsui,18,3,9,33.3,1,2,50,2,7,28.6,0,0,0,0,0,0,1,0,1,1,0,8
423918,476_15_19,JAPAN,28343,17,gaku arao,28,1,2,50,1,2,50,0,0,0,0,0,0,0,3,3,0,3,0,1,0,2
423919,476_15_19,JAPAN,23321,24,daiki tanaka,3,0,1,0,0,0,0,0,1,0,0,0,0,1,0,1,0,0,0,0,0,0
423920,476_15_19,JAPAN,28344,25,takatoshi furukawa,19,6,13,46.2,3,4,75,3,9,33.3,0,0,0,1,1,2,0,2,0,0,0,15
423921,476_15_19,JAPAN,25620,34,ryumo ono,4,0,2,0,0,2,0,0,0,0,0,0,0,0,0,0,0,0,0,0,0,0
423922,476_15_19,JAPAN,18623,42,kenta hirose,15,1,3,33.3,1,2,50,0,1,0,1,2,50,1,3,4,0,2,0,1,0,3
423923,476_15_19,JAPAN,0,TOTALS,JAPAN,200,35,77,45.5,28,53,52.8,7,24,29.2,6,8,75,16,29,45,17,18,7,7,2,83
423924,476_15_20,KUWAIT,28310,1,yousiff borhamah,18,3,6,50,2,5,40,1,1,100,0,0,0,1,3,4,3,5,2,0,0,7
423925,476_15_20,KUWAIT,28311,4,mashari abu dhom,26,4,8,50,0,0,0,4,8,50,0,0,0,0,1,1,2,3,3,0,0,12
423926,476_15_20,KUWAIT,28312,5,hamad hasan,14,1,3,33.3,1,1,100,0,2,0,1,1,100,1,2,3,0,5,1,0,0,3
423927,476_15_20,KUWAIT,14244,12,abdulaziz alhamidi,21,4,10,40,3,6,50,1,4,25,0,0,0,0,2,2,1,1,3,1,0,9
423928,476_15_20,KUWAIT,28313,13,mashari alshammari,4,0,3,0,0,2,0,0,1,0,0,2,0,1,0,1,0,3,0,0,0,0
423929,476_15_20,KUWAIT,28314,15,mohammad marzouq,4,0,0,0,0,0,0,0,0,0,0,0,0,0,3,3,0,0,0,0,0,0
423930,476_15_20,KUWAIT,28315,16,naser alzafiri,2,0,0,0,0,0,0,0,0,0,0,0,0,0,0,0,0,0,0,0,0,0
423931,476_15_20,KUWAIT,14458,21,abdulrahman alshammari,30,7,17,41.2,6,14,42.9,1,3,33.3,0,0,0,1,3,4,0,3,4,1,1,15
423932,476_15_20,KUWAIT,28316,28,abdulrahman aljuma'h,40,2,10,20,1,6,16.7,1,4,25,0,0,0,2,1,3,0,4,2,2,1,5
423933,476_15_20,KUWAIT,14243,30,abdullah alsaeid,40,3,9,33.3,1,3,33.3,2,6,33.3,5,6,83.3,0,2,2,5,2,2,3,0,13
423934,476_15_20,KUWAIT,0,TOTALS,KUWAIT,200,24,66,36.4,14,37,37.8,10,29,34.5,6,9,66.7,8,18,26,11,26,17,7,2,64
423935,476_15_20,PHILIPPINES,25433,1,andray blatche,19,3,9,33.3,3,7,42.9,0,2,0,2,4,50,2,6,8,1,2,3,1,3,8
423936,476_15_20,PHILIPPINES,9700,5,gabriel norwood,24,1,2,50,1,1,100,0,1,0,2,2,100,1,5,6,2,2,1,2,0,4
423937,476_15_20,PHILIPPINES,23361,7,jayson william,19,5,8,62.5,3,3,100,2,5,40,4,5,80,0,2,2,1,0,2,0,0,16
423938,476_15_20,PHILIPPINES,28323,8,calvin abueva,14,5,10,50,5,10,50,0,0,0,0,1,0,3,5,8,2,2,0,1,0,10
423939,476_15_20,PHILIPPINES,28324,9,john intal,13,5,7,71.4,5,7,71.4,0,0,0,0,0,0,1,0,1,1,2,1,0,0,10
423940,476_15_20,PHILIPPINES,28325,11,terrence romeo,19,6,10,60,3,7,42.9,3,3,100,4,5,80,0,1,1,2,0,1,2,0,19
423941,476_15_20,PHILIPPINES,23365,15,jean marc pingris,17,1,2,50,1,2,50,0,0,0,0,4,0,2,2,4,1,0,1,2,0,2
423942,476_15_20,PHILIPPINES,28326,22,matthew ganuelas,14,2,4,50,2,4,50,0,0,0,2,2,100,1,0,1,0,1,1,0,0,6
423943,476_15_20,PHILIPPINES,14183,23,joachim gunther thoss,12,4,5,80,4,5,80,0,0,0,0,0,0,1,0,1,0,3,2,0,0,8
423944,476_15_20,PHILIPPINES,9697,25,donaldo hontiveros,15,3,4,75,0,0,0,3,4,75,0,0,0,0,1,1,1,3,1,1,0,9
423945,476_15_20,PHILIPPINES,18657,33,ranidel de ocampo,23,3,4,75,2,3,66.7,1,1,100,2,2,100,2,3,5,2,1,0,0,1,9
423946,476_15_20,PHILIPPINES,9698,88,pauliasi taulava,11,3,8,37.5,3,8,37.5,0,0,0,3,6,50,3,7,10,1,0,1,1,0,9
423947,476_15_20,PHILIPPINES,0,TOTALS,PHILIPPINES,200,41,73,56.2,32,57,56.1,9,16,56.2,19,31,61.3,18,34,52,14,16,15,10,4,110
423948,476_15_21,HONG KONG,28317,4,sheung ying so,4,0,1,0,0,0,0,0,1,0,0,0,0,0,0,0,0,0,1,0,0,0
423949,476_15_21,HONG KONG,28318,5,hoi to lau,5,0,1,0,0,1,0,0,0,0,0,0,0,0,0,0,0,1,0,0,0,0
423950,476_15_21,HONG KONG,28319,6,wai kong au-yeung,16,1,6,16.7,1,3,33.3,0,3,0,0,0,0,2,4,6,2,0,0,1,0,2
423951,476_15_21,HONG KONG,23387,7,ki lee,26,7,10,70,2,2,100,5,8,62.5,7,7,100,1,1,2,0,3,1,0,0,26
423952,476_15_21,HONG KONG,23388,8,siu wing chan,33,10,17,58.8,8,9,88.9,2,8,25,0,0,0,0,2,2,4,3,1,0,0,22
423953,476_15_21,HONG KONG,28320,9,shiu wah leung,10,1,6,16.7,1,5,20,0,1,0,0,0,0,0,3,3,0,2,0,1,1,2
423954,476_15_21,HONG KONG,28321,10,adam xu,12,0,2,0,0,2,0,0,0,0,0,0,0,0,4,4,0,1,2,1,2,0
423955,476_15_21,HONG KONG,3830,11,kam hing cheng,20,2,6,33.3,2,5,40,0,1,0,3,4,75,0,5,5,2,1,4,1,0,7
423956,476_15_21,HONG KONG,28322,12,ho chun lin,9,0,1,0,0,1,0,0,0,0,0,0,0,0,2,2,1,1,0,0,0,0
423957,476_15_21,HONG KONG,3834,13,chun wai wong,27,2,9,22.2,0,3,0,2,6,33.3,0,0,0,1,8,9,0,4,0,1,2,6
423958,476_15_21,HONG KONG,23391,14,duncan overbeck reid,32,6,14,42.9,6,14,42.9,0,0,0,0,0,0,1,4,5,1,1,3,0,2,12
423959,476_15_21,HONG KONG,3833,15,wai kit szeto,7,0,1,0,0,1,0,0,0,0,2,2,100,1,0,1,0,4,3,0,0,2
423960,476_15_21,HONG KONG,0,TOTALS,HONG KONG,200,29,74,39.2,20,46,43.5,9,28,32.1,12,13,92.3,7,36,43,10,21,15,5,7,79
423961,476_15_21,PALESTINE,28327,4,ahmed haroon,30,5,10,50,1,3,33.3,4,7,57.1,0,0,0,1,7,8,2,3,2,0,0,14
423962,476_15_21,PALESTINE,28328,5,shadi khatib,16,1,3,33.3,1,3,33.3,0,0,0,0,0,0,1,2,3,0,2,0,0,0,2
423963,476_15_21,PALESTINE,28329,6,jamal abu shamala,40,8,16,50,4,9,44.4,4,7,57.1,2,2,100,0,7,7,1,3,3,3,2,22
423964,476_15_21,PALESTINE,28330,7,ahmed younis,23,2,5,40,2,5,40,0,0,0,0,0,0,1,1,2,3,5,1,0,1,4
423965,476_15_21,PALESTINE,28331,8,jehad othman b. yaghmour,0,0,0,0,0,0,0,0,0,0,0,0,0,0,0,0,0,0,0,0,0,0
423966,476_15_21,PALESTINE,28332,9,amin salman,0,0,0,0,0,0,0,0,0,0,0,0,0,0,0,0,0,0,0,0,0,0
423967,476_15_21,PALESTINE,28333,10,imad qahwash,40,8,22,36.4,6,13,46.2,2,9,22.2,6,10,60,2,4,6,2,2,2,0,0,24
423968,476_15_21,PALESTINE,28334,11,enar odeh,4,0,1,0,0,1,0,0,0,0,0,0,0,0,0,0,0,1,0,0,0,0
423969,476_15_21,PALESTINE,28335,12,sami owda,6,0,2,0,0,1,0,0,1,0,0,0,0,0,1,1,1,0,0,1,0,0
423970,476_15_21,PALESTINE,28336,13,sani sakakini,40,6,15,40,6,11,54.5,0,4,0,7,9,77.8,5,11,16,8,2,3,1,1,19
423971,476_15_21,PALESTINE,28337,14,hamza yousef,0,0,0,0,0,0,0,0,0,0,0,0,0,0,0,0,0,0,0,0,0,0
423972,476_15_21,PALESTINE,28338,15,salim sakakini,0,0,0,0,0,0,0,0,0,0,0,0,0,0,0,0,0,0,0,0,0,0
423973,476_15_21,PALESTINE,0,TOTALS,PALESTINE,200,30,74,40.5,20,46,43.5,10,28,35.7,15,21,71.4,12,36,48,17,18,15,5,4,85
423974,476_15_22,CHINA,18850,4,ji wei zhao,22,0,1,0,0,1,0,0,0,0,0,0,0,2,1,3,8,1,3,0,0,0
423975,476_15_22,CHINA,50,5,wei liu,11,2,4,50,2,4,50,0,0,0,0,0,0,0,2,2,1,0,1,0,0,4
423976,476_15_22,CHINA,14374,6,ailun guo,24,5,7,71.4,4,6,66.7,1,1,100,4,5,80,0,4,4,7,3,2,1,0,15
423977,476_15_22,CHINA,28363,7,tailong zhao,14,1,3,33.3,0,2,0,1,1,100,0,0,0,0,0,0,0,1,1,0,0,3
423978,476_15_22,CHINA,14377,8,yanyuhang ding,27,2,8,25,0,3,0,2,5,40,0,0,0,1,5,6,1,2,2,1,0,6
423979,476_15_22,CHINA,14378,9,xiaochuan zhai,11,3,5,60,3,3,100,0,2,0,0,0,0,1,1,2,0,0,1,0,0,6
423980,476_15_22,CHINA,16587,10,peng zhou,3,0,1,0,0,1,0,0,0,0,0,0,0,0,0,0,0,0,0,0,0,0
423981,476_15_22,CHINA,56,11,jianlian yi,28,12,20,60,12,20,60,0,0,0,2,5,40,3,11,14,0,1,0,0,0,26
423982,476_15_22,CHINA,28364,12,gen li,20,2,2,100,0,0,0,2,2,100,2,2,100,0,1,1,0,3,2,0,0,8
423983,476_15_22,CHINA,18361,13,muhao li,2,0,0,0,0,0,0,0,0,0,1,2,50,0,0,0,0,0,0,0,0,1
423984,476_15_22,CHINA,16635,14,zhelin wang,20,2,3,66.7,2,3,66.7,0,0,0,1,2,50,1,6,7,2,4,1,1,0,5
423985,476_15_22,CHINA,18858,15,qi zhou,19,4,6,66.7,4,6,66.7,0,0,0,2,3,66.7,0,3,3,0,0,1,0,1,10
423986,476_15_22,CHINA,0,TOTALS,CHINA,200,33,60,55,27,49,55.1,6,11,54.5,12,19,63.2,12,36,48,19,15,14,3,1,84
423987,476_15_22,JORDAN,18616,0,mah'd n.j. abdeen,18,2,5,40,2,2,100,0,3,0,0,0,0,0,0,0,2,1,0,2,0,4
423988,476_15_22,JORDAN,14432,4,malek kanaan,0,0,0,0,0,0,0,0,0,0,0,0,0,0,0,0,0,0,0,0,0,0
423989,476_15_22,JORDAN,28347,6,alex legion,34,4,15,26.7,3,13,23.1,1,2,50,1,2,50,0,3,3,0,0,1,4,1,10
423990,476_15_22,JORDAN,23313,7,ahmad f.l. alhamarsheh,25,3,9,33.3,2,5,40,1,4,25,0,0,0,2,4,6,1,3,0,0,0,7
423991,476_15_22,JORDAN,23312,9,hani alfaraj,0,0,0,0,0,0,0,0,0,0,0,0,0,0,0,0,0,0,0,0,0,0
423992,476_15_22,JORDAN,9626,10,osama daghles,22,3,7,42.9,2,5,40,1,2,50,0,0,0,1,1,2,2,1,2,1,0,7
423993,476_15_22,JORDAN,16589,13,mohammad hussein,0,0,0,0,0,0,0,0,0,0,0,0,0,0,0,0,0,0,0,0,0,0
423994,476_15_22,JORDAN,28348,20,ahmad mahmoud obeid,1,0,0,0,0,0,0,0,0,0,0,0,0,1,0,1,1,0,0,0,0,0
423995,476_15_22,JORDAN,3885,21,zaid abbas,29,9,20,45,7,14,50,2,6,33.3,2,4,50,3,2,5,1,4,0,1,0,22
423996,476_15_22,JORDAN,9623,23,mousa alawadi,26,1,9,11.1,0,6,0,1,3,33.3,0,2,0,2,4,6,0,3,1,0,0,3
423997,476_15_22,JORDAN,9627,33,wesam al-sous,20,4,8,50,1,3,33.3,3,5,60,0,0,0,1,0,1,0,0,0,1,0,11
423998,476_15_22,JORDAN,16588,41,ali jamal zaghab,24,1,4,25,1,4,25,0,0,0,1,4,25,3,2,5,0,5,2,0,0,3
423999,476_15_22,JORDAN,0,TOTALS,JORDAN,200,27,77,35.1,18,52,34.6,9,25,36,4,12,33.3,17,19,36,7,17,7,9,1,67
424000,476_15_23,QATAR,28374,4,abdelrahman yehia abdelhaleem,3,0,1,0,0,0,0,0,1,0,0,0,0,0,1,1,0,0,0,0,0,0
424001,476_15_23,QATAR,28375,5,clinton johnson,25,5,16,31.2,3,11,27.3,2,5,40,3,6,50,0,2,2,1,2,1,0,0,15
424002,476_15_23,QATAR,6826,6,saad abdulrahman ali,28,3,12,25,3,6,50,0,6,0,2,2,100,2,1,3,0,3,3,2,0,8
424003,476_15_23,QATAR,3860,7,daoud mousa daoud,15,1,6,16.7,1,4,25,0,2,0,0,0,0,0,1,1,0,2,0,0,1,2
424004,476_15_23,QATAR,6827,8,suliman abdi khalid,23,4,6,66.7,4,5,80,0,1,0,0,0,0,2,2,4,2,1,0,1,0,8
424005,476_15_23,QATAR,28376,9,mohamed hassan a mohamed,24,4,13,30.8,2,5,40,2,8,25,0,0,0,1,2,3,1,3,1,1,0,10
424006,476_15_23,QATAR,28377,10,abdulrahman mohamed saad,16,1,6,16.7,1,5,20,0,1,0,0,0,0,0,4,4,3,2,1,0,0,2
424007,476_15_23,QATAR,6830,11,ali saeed erfan,27,1,3,33.3,0,1,0,1,2,50,0,0,0,1,4,5,1,1,4,0,0,3
424008,476_15_23,QATAR,6831,12,mohammed saleem abdulla,19,3,4,75,3,4,75,0,0,0,0,0,0,5,2,7,0,3,0,1,1,6
424009,476_15_23,QATAR,23331,13,mohd mohamed,21,5,7,71.4,5,7,71.4,0,0,0,0,1,0,3,6,9,0,5,2,0,0,10
424010,476_15_23,QATAR,18646,14,abduallah shaher matalkeh,1,0,1,0,0,1,0,0,0,0,0,0,0,0,0,0,0,0,0,0,0,0
424011,476_15_23,QATAR,18645,15,khalid abdalla adam,0,0,0,0,0,0,0,0,0,0,0,0,0,0,0,0,0,0,0,0,0,0
424012,476_15_23,QATAR,0,TOTALS,QATAR,200,27,75,36,22,49,44.9,5,26,19.2,5,9,55.6,15,27,42,8,22,14,5,2,64
424013,476_15_23,CHINESE TAIPEI,3841,1,lei tien,13,2,7,28.6,2,4,50,0,3,0,2,2,100,3,3,6,1,2,0,0,0,6
424014,476_15_23,CHINESE TAIPEI,25616,5,cheng liu,23,5,13,38.5,3,6,50,2,7,28.6,1,3,33.3,0,4,4,0,1,3,1,0,13
424015,476_15_23,CHINESE TAIPEI,23316,8,shih-chieh chen,20,0,5,0,0,4,0,0,1,0,1,2,50,0,3,3,4,0,0,1,1,1
424016,476_15_23,CHINESE TAIPEI,9656,9,shih-nien chen,12,1,3,33.3,1,2,50,0,1,0,0,0,0,0,1,1,1,1,0,0,0,2
424017,476_15_23,CHINESE TAIPEI,9665,13,cheng-ju lu,9,3,5,60,0,0,0,3,5,60,0,0,0,0,1,1,0,2,1,1,0,9
424018,476_15_23,CHINESE TAIPEI,23319,14,wen-cheng tsai,16,2,6,33.3,2,6,33.3,0,0,0,1,1,100,1,3,4,0,2,2,0,0,5
424019,476_15_23,CHINESE TAIPEI,23315,15,quincy spencer davis iii,33,4,6,66.7,4,6,66.7,0,0,0,5,6,83.3,4,6,10,0,3,3,0,2,13
424020,476_15_23,CHINESE TAIPEI,23317,24,chih-shan hung,9,0,0,0,0,0,0,0,0,0,0,0,0,0,2,2,0,0,1,0,0,0
424021,476_15_23,CHINESE TAIPEI,9663,27,chih-chieh lin,24,4,10,40,2,5,40,2,5,40,4,6,66.7,0,4,4,1,1,2,1,0,14
424022,476_15_23,CHINESE TAIPEI,3839,41,tai-hao wu,8,0,0,0,0,0,0,0,0,0,0,0,0,2,2,4,1,1,0,0,0,0
424023,476_15_23,CHINESE TAIPEI,28365,49,shun-hsiang chen,8,1,3,33.3,0,0,0,1,3,33.3,0,0,0,0,1,1,1,1,1,0,0,3
424024,476_15_23,CHINESE TAIPEI,9659,76,wen-ting tseng,26,3,6,50,3,5,60,0,1,0,0,2,0,1,6,7,4,1,2,1,0,6
424025,476_15_23,CHINESE TAIPEI,0,TOTALS,CHINESE TAIPEI,200,25,64,39.1,17,38,44.7,8,26,30.8,14,22,63.6,13,37,50,13,15,15,5,3,72
424026,476_15_24,KAZAKHSTAN,23366,4,timur sultanov,8,2,3,66.7,0,0,0,2,3,66.7,2,2,100,0,0,0,0,3,0,0,0,8
424027,476_15_24,KAZAKHSTAN,23367,5,jerry johnson,13,1,3,33.3,1,2,50,0,1,0,0,0,0,0,1,1,2,0,4,1,0,2
424028,476_15_24,KAZAKHSTAN,23368,6,rustam murzagaliyev,19,2,5,40,1,3,33.3,1,2,50,0,0,0,1,0,1,0,2,1,1,0,5
424029,476_15_24,KAZAKHSTAN,14353,7,maxim marchuk,15,1,5,20,1,4,25,0,1,0,0,0,0,1,0,1,0,1,1,0,0,2
424030,476_15_24,KAZAKHSTAN,28378,8,maxim smirnov,8,0,2,0,0,2,0,0,0,0,0,0,0,1,0,1,0,0,0,0,0,0
424031,476_15_24,KAZAKHSTAN,28379,9,anatoliy kolesnikov,21,1,5,20,1,4,25,0,1,0,1,2,50,0,1,1,2,2,3,1,1,3
424032,476_15_24,KAZAKHSTAN,13764,10,pavel ilin,17,1,5,20,1,2,50,0,3,0,1,2,50,0,1,1,3,2,1,1,0,3
424033,476_15_24,KAZAKHSTAN,3813,11,anton ponomarev,19,3,5,60,2,4,50,1,1,100,5,8,62.5,2,3,5,0,2,1,0,1,12
424034,476_15_24,KAZAKHSTAN,28380,12,dmitriy klimov,27,3,8,37.5,0,2,0,3,6,50,0,0,0,0,5,5,1,2,0,0,0,9
424035,476_15_24,KAZAKHSTAN,9605,13,rustam yargaliyev,27,2,7,28.6,2,3,66.7,0,4,0,4,4,100,0,5,5,0,3,4,0,0,8
424036,476_15_24,KAZAKHSTAN,9603,14,dmitriy gavrilov,0,0,0,0,0,0,0,0,0,0,0,0,0,0,0,0,0,0,0,0,0,0
424037,476_15_24,KAZAKHSTAN,13766,15,alexandr zhigulin,25,1,5,20,0,2,0,1,3,33.3,0,2,0,2,2,4,1,5,2,0,0,3
424038,476_15_24,KAZAKHSTAN,0,TOTALS,KAZAKHSTAN,200,17,53,32.1,9,28,32.1,8,25,32,13,20,65,9,20,29,9,22,17,4,2,55
424039,476_15_24,LEBANON,6780,4,jean abd el nour,17,3,7,42.9,3,7,42.9,0,0,0,0,1,0,2,1,3,1,0,2,0,0,6
424040,476_15_24,LEBANON,28366,5,amir saoud,20,6,10,60,4,6,66.7,2,4,50,0,0,0,0,3,3,2,0,0,2,0,14
424041,476_15_24,LEBANON,28367,6,mohamad ali haidar,27,6,8,75,5,6,83.3,1,2,50,2,2,100,2,4,6,0,4,1,1,2,15
424042,476_15_24,LEBANON,28368,7,wael arakji,20,1,4,25,1,3,33.3,0,1,0,6,7,85.7,1,0,1,0,3,2,1,0,8
424043,476_15_24,LEBANON,28369,8,joseph aby kheres,18,3,6,50,3,6,50,0,0,0,0,0,0,3,0,3,2,3,0,0,0,6
424044,476_15_24,LEBANON,28370,9,ahmad ibrahim,0,0,0,0,0,0,0,0,0,0,0,0,0,0,0,0,0,0,0,0,0,0
424045,476_15_24,LEBANON,28371,10,nadim souaid,5,3,3,100,1,1,100,2,2,100,2,2,100,1,2,3,0,0,1,0,0,10
424046,476_15_24,LEBANON,8977,11,rodrigue akl,17,0,1,0,0,1,0,0,0,0,0,0,0,0,2,2,4,1,0,3,0,0
424047,476_15_24,LEBANON,18668,12,charles tabet,14,1,3,33.3,1,3,33.3,0,0,0,0,0,0,0,4,4,0,3,0,1,1,2
424048,476_15_24,LEBANON,18667,13,bassel bawji,21,0,5,0,0,4,0,0,1,0,0,0,0,0,4,4,0,2,1,1,1,0
424049,476_15_24,LEBANON,28372,14,jasmon jovan youngblood,37,12,18,66.7,9,13,69.2,3,5,60,3,6,50,2,6,8,2,0,3,1,0,30
424050,476_15_24,LEBANON,28373,15,omar el ayoubi,3,0,0,0,0,0,0,0,0,0,0,0,0,0,1,1,1,0,0,0,0,0
424051,476_15_24,LEBANON,0,TOTALS,LEBANON,200,35,65,53.8,27,50,54,8,15,53.3,13,18,72.2,13,30,43,12,16,12,10,4,91
424052,476_15_25,IRAN,14400,4,sajjad mashayekhi,21,2,6,33.3,2,4,50,0,2,0,0,0,0,0,2,2,6,1,1,3,0,4
424053,476_15_25,IRAN,22994,5,behnam yakhchalidehkordi,15,3,4,75,1,1,100,2,3,66.7,0,0,0,2,4,6,2,0,0,0,0,8
424054,476_15_25,IRAN,9684,6,javad davari,13,4,6,66.7,1,1,100,3,5,60,0,0,0,0,2,2,2,0,3,1,0,11
424055,476_15_25,IRAN,9685,7,mahdi kamrani,21,2,8,25,2,3,66.7,0,5,0,2,3,66.7,1,1,2,3,1,1,1,0,6
424056,476_15_25,IRAN,28339,8,saeid karekani,14,3,7,42.9,1,1,100,2,6,33.3,0,0,0,1,2,3,4,3,1,3,0,8
424057,476_15_25,IRAN,13743,9,mohammad hassanzadeh saberi a,24,3,4,75,3,4,75,0,0,0,3,6,50,3,4,7,1,3,1,2,0,9
424058,476_15_25,IRAN,9688,10,hamed afagh,5,1,3,33.3,1,2,50,0,1,0,1,1,100,0,0,0,0,1,0,0,0,3
424059,476_15_25,IRAN,9690,11,oshin sahakian,18,4,6,66.7,4,5,80,0,1,0,2,2,100,1,7,8,4,0,2,0,1,10
424060,476_15_25,IRAN,28340,12,asghar kardoustpoustinsaraei,13,5,8,62.5,5,8,62.5,0,0,0,1,1,100,2,5,7,0,0,0,1,0,11
424061,476_15_25,IRAN,13739,13,mohammad jamshidijafarabadi,22,8,11,72.7,4,4,100,4,7,57.1,2,2,100,1,2,3,3,0,3,0,1,22
424062,476_15_25,IRAN,11627,14,mohammadsamad nik,18,5,10,50,2,3,66.7,3,7,42.9,2,2,100,2,1,3,3,2,1,1,0,15
424063,476_15_25,IRAN,9693,15,hamed ehadadi,18,2,3,66.7,2,3,66.7,0,0,0,0,0,0,3,5,8,2,2,0,0,0,4
424064,476_15_25,IRAN,0,TOTALS,IRAN,200,42,76,55.3,28,39,71.8,14,37,37.8,13,17,76.5,17,38,55,30,13,13,12,2,111
424065,476_15_25,HONG KONG,28317,4,sheung ying so,5,0,1,0,0,0,0,0,1,0,0,0,0,0,0,0,0,1,0,0,0,0
424066,476_15_25,HONG KONG,28318,5,hoi to lau,6,0,1,0,0,1,0,0,0,0,0,0,0,0,1,1,0,0,0,0,0,0
424067,476_15_25,HONG KONG,28319,6,wai kong au-yeung,12,0,0,0,0,0,0,0,0,0,0,0,0,0,0,0,0,1,3,0,0,0
424068,476_15_25,HONG KONG,23387,7,ki lee,26,5,11,45.5,1,2,50,4,9,44.4,4,5,80,1,4,5,0,0,4,1,0,18
424069,476_15_25,HONG KONG,23388,8,siu wing chan,38,4,12,33.3,0,7,0,4,5,80,2,2,100,0,1,1,2,3,2,1,0,14
424070,476_15_25,HONG KONG,28320,9,shiu wah leung,9,0,1,0,0,0,0,0,1,0,0,0,0,0,1,1,0,1,1,0,0,0
424071,476_15_25,HONG KONG,28321,10,adam xu,11,1,5,20,1,5,20,0,0,0,1,1,100,0,0,0,0,1,1,0,0,3
424072,476_15_25,HONG KONG,3830,11,kam hing cheng,17,2,5,40,2,5,40,0,0,0,0,0,0,1,0,1,0,2,3,0,0,4
424073,476_15_25,HONG KONG,28322,12,ho chun lin,9,0,2,0,0,2,0,0,0,0,0,0,0,0,0,0,1,4,1,0,0,0
424074,476_15_25,HONG KONG,3834,13,chun wai wong,27,1,7,14.3,1,2,50,0,5,0,1,4,25,1,6,7,0,4,1,1,0,3
424075,476_15_25,HONG KONG,23391,14,duncan overbeck reid,32,7,19,36.8,7,19,36.8,0,0,0,0,0,0,3,3,6,6,2,1,1,0,14
424076,476_15_25,HONG KONG,3833,15,wai kit szeto,8,0,0,0,0,0,0,0,0,0,0,0,0,0,0,0,0,1,0,0,0,0
424077,476_15_25,HONG KONG,0,TOTALS,HONG KONG,200,20,64,31.2,12,43,27.9,8,21,38.1,8,12,66.7,8,17,25,9,20,17,4,0,56
424078,476_15_26,PALESTINE,28327,4,ahmed haroon,28,1,5,20,1,2,50,0,3,0,0,0,0,1,4,5,0,1,1,2,1,2
424079,476_15_26,PALESTINE,28328,5,shadi khatib,3,0,0,0,0,0,0,0,0,0,0,0,0,0,0,0,0,1,0,0,0,0
424080,476_15_26,PALESTINE,28329,6,jamal abu shamala,39,7,16,43.8,2,7,28.6,5,9,55.6,2,2,100,3,6,9,2,1,3,1,0,21
424081,476_15_26,PALESTINE,28330,7,ahmed younis,15,0,1,0,0,1,0,0,0,0,2,2,100,1,0,1,0,2,1,1,1,2
424082,476_15_26,PALESTINE,28331,8,jehad othman b. yaghmour,0,0,0,0,0,0,0,0,0,0,0,0,0,0,0,0,0,0,0,0,0,0
424083,476_15_26,PALESTINE,28332,9,amin salman,1,0,1,0,0,0,0,0,1,0,0,0,0,0,0,0,0,0,0,0,0,0
424084,476_15_26,PALESTINE,28333,10,imad qahwash,39,2,8,25,2,6,33.3,0,2,0,1,2,50,2,2,4,9,4,5,0,0,5
424085,476_15_26,PALESTINE,28334,11,enar odeh,0,0,0,0,0,0,0,0,0,0,0,0,0,0,0,0,0,0,0,0,0,0
424086,476_15_26,PALESTINE,28335,12,sami owda,0,0,0,0,0,0,0,0,0,0,0,0,0,0,0,0,0,0,0,0,0,0
424087,476_15_26,PALESTINE,28336,13,sani sakakini,36,10,22,45.5,10,19,52.6,0,3,0,3,5,60,4,8,12,1,2,3,4,0,23
424088,476_15_26,PALESTINE,28337,14,hamza yousef,11,0,4,0,0,4,0,0,0,0,1,2,50,1,3,4,0,3,0,0,0,1
424089,476_15_26,PALESTINE,28338,15,salim sakakini,28,6,14,42.9,6,14,42.9,0,0,0,4,5,80,5,2,7,0,4,3,0,0,16
424090,476_15_26,PALESTINE,0,TOTALS,PALESTINE,200,26,71,36.6,21,53,39.6,5,18,27.8,13,18,72.2,20,29,49,12,18,17,8,2,70
424091,476_15_26,INDIA,23335,3,vinay kaushik,24,1,3,33.3,0,2,0,1,1,100,0,0,0,1,0,1,1,2,0,0,0,3
424092,476_15_26,INDIA,28354,4,rajesh prakash uppar,2,0,0,0,0,0,0,0,0,0,0,0,0,0,0,0,0,0,0,0,0,0
424093,476_15_26,INDIA,28355,7,siddhant sanjay shinde,0,0,0,0,0,0,0,0,0,0,0,0,0,0,0,0,0,0,0,0,0,0
424094,476_15_26,INDIA,14219,9,vishesh bhriguvanshi,40,6,18,33.3,4,11,36.4,2,7,28.6,3,4,75,0,3,3,5,2,3,3,0,17
424095,476_15_26,INDIA,18673,10,amritpal singh ,39,7,11,63.6,7,11,63.6,0,0,0,0,0,0,3,6,9,0,4,2,0,0,14
424096,476_15_26,INDIA,28356,13,vikas kumar ,0,0,0,0,0,0,0,0,0,0,0,0,0,0,0,0,0,0,0,0,0,0
424097,476_15_26,INDIA,18675,14,yadwinder singh,23,1,4,25,1,3,33.3,0,1,0,2,2,100,1,5,6,2,3,1,1,0,4
424098,476_15_26,INDIA,28357,15,arvind arumugam,2,0,1,0,0,1,0,0,0,0,0,0,0,0,0,0,0,1,0,0,0,0
424099,476_15_26,INDIA,18670,22,amjyot singh ,39,11,28,39.3,8,19,42.1,3,9,33.3,7,8,87.5,6,5,11,3,4,4,3,0,32
424100,476_15_26,INDIA,25645,66,akilan pari,31,1,6,16.7,0,2,0,1,4,25,0,0,0,2,3,5,3,4,1,4,0,3
424101,476_15_26,INDIA,28358,69,akashdeep hazra,0,0,0,0,0,0,0,0,0,0,0,0,0,0,0,0,0,0,0,0,0,0
424102,476_15_26,INDIA,28359,96,gurvinder singh gill,0,0,0,0,0,0,0,0,0,0,0,0,0,0,0,0,0,0,0,0,0,0
424103,476_15_26,INDIA,0,TOTALS,INDIA,200,27,71,38,20,49,40.8,7,22,31.8,12,14,85.7,13,25,38,14,20,13,11,0,73
424104,476_15_27,KOREA,11667,1,taesul kim,8,1,1,100,1,1,100,0,0,0,0,0,0,0,2,2,1,0,0,0,0,2
424105,476_15_27,KOREA,28345,3,junghyun lee,13,0,2,0,0,0,0,0,2,0,0,0,0,0,0,0,4,2,2,0,0,0
424106,476_15_27,KOREA,16672,4,seonggon moon,0,0,0,0,0,0,0,0,0,0,0,0,0,0,0,0,0,0,0,0,0,0
424107,476_15_27,KOREA,22972,5,junyong choi,20,4,6,66.7,2,4,50,2,2,100,0,0,0,1,2,3,2,2,1,1,0,10
424108,476_15_27,KOREA,9631,6,donggeun yang,32,8,13,61.5,6,10,60,2,3,66.7,0,0,0,1,5,6,8,3,2,8,0,18
424109,476_15_27,KOREA,18640,7,chan hee park,0,0,0,0,0,0,0,0,0,0,0,0,0,0,0,0,0,0,0,0,0,0
424110,476_15_27,KOREA,18643,10,sungmin cho,32,5,8,62.5,2,2,100,3,6,50,2,2,100,0,3,3,4,3,1,3,1,15
424111,476_15_27,KOREA,22971,11,sangjae kang,6,0,2,0,0,2,0,0,0,0,0,0,0,0,1,1,0,0,0,0,0,0
424112,476_15_27,KOREA,18644,15,jongkyu kim,12,2,4,50,2,4,50,0,0,0,2,2,100,2,1,3,0,3,0,0,0,6
424113,476_15_27,KOREA,28346,22,taeyoung moon,15,1,6,16.7,1,5,20,0,1,0,2,2,100,0,2,2,2,2,1,0,0,4
424114,476_15_27,KOREA,14338,32,jonghyun lee,28,8,11,72.7,8,11,72.7,0,0,0,1,3,33.3,2,4,6,1,2,0,0,3,17
424115,476_15_27,KOREA,18395,33,seounghyun lee,34,5,11,45.5,4,8,50,1,3,33.3,2,2,100,0,4,4,2,0,3,0,0,13
424116,476_15_27,KOREA,0,TOTALS,KOREA,200,34,64,53.1,26,47,55.3,8,17,47.1,9,11,81.8,7,25,32,24,17,11,12,4,85
424117,476_15_27,LEBANON,6780,4,jean abd el nour,36,2,9,22.2,2,8,25,0,1,0,2,2,100,1,4,5,1,0,1,2,2,6
424118,476_15_27,LEBANON,28366,5,amir saoud,23,5,10,50,2,4,50,3,6,50,1,2,50,0,0,0,2,1,0,1,0,14
424119,476_15_27,LEBANON,28367,6,mohamad ali haidar,28,4,10,40,4,8,50,0,2,0,1,2,50,3,5,8,0,2,6,0,1,9
424120,476_15_27,LEBANON,28368,7,wael arakji,22,3,5,60,3,3,100,0,2,0,0,0,0,0,1,1,4,1,2,1,0,6
424121,476_15_27,LEBANON,28369,8,joseph aby kheres,11,3,6,50,3,6,50,0,0,0,0,0,0,3,1,4,0,1,1,1,1,6
424122,476_15_27,LEBANON,28370,9,ahmad ibrahim,0,0,0,0,0,0,0,0,0,0,0,0,0,0,0,0,0,0,0,0,0,0
424123,476_15_27,LEBANON,28371,10,nadim souaid,6,0,2,0,0,1,0,0,1,0,0,0,0,0,0,0,0,1,0,0,0,0
424124,476_15_27,LEBANON,8977,11,rodrigue akl,11,0,1,0,0,0,0,0,1,0,0,0,0,1,1,2,2,1,2,1,0,0
424125,476_15_27,LEBANON,18668,12,charles tabet,4,0,0,0,0,0,0,0,0,0,0,0,0,0,0,0,0,0,0,0,0,0
424126,476_15_27,LEBANON,18667,13,bassel bawji,25,4,7,57.1,3,6,50,1,1,100,0,0,0,2,10,12,0,3,1,1,0,9
424127,476_15_27,LEBANON,28372,14,jasmon jovan youngblood,32,8,14,57.1,6,9,66.7,2,5,40,3,5,60,0,2,2,3,2,4,2,0,21
424128,476_15_27,LEBANON,28373,15,omar el ayoubi,2,0,0,0,0,0,0,0,0,0,0,0,0,1,0,1,0,0,0,0,0,0
424129,476_15_27,LEBANON,0,TOTALS,LEBANON,200,29,64,45.3,23,45,51.1,6,19,31.6,7,11,63.6,12,25,37,12,12,17,9,4,71
424130,476_15_28,JAPAN,28341,0,yuta tabuse,26,1,8,12.5,1,7,14.3,0,1,0,2,2,100,1,1,2,0,3,1,0,0,4
424131,476_15_28,JAPAN,23322,6,makoto hiejima,26,8,14,57.1,7,11,63.6,1,3,33.3,0,0,0,0,3,3,1,4,3,1,0,17
424132,476_15_28,JAPAN,18625,8,atsuya ota,10,0,1,0,0,1,0,0,0,0,2,2,100,2,1,3,1,4,0,0,0,2
424133,476_15_28,JAPAN,28342,10,ryoma hashimoto,13,2,2,100,1,1,100,1,1,100,1,2,50,1,2,3,2,1,1,0,0,6
424134,476_15_28,JAPAN,3875,15,joji takeuchi,39,4,9,44.4,3,7,42.9,1,2,50,4,4,100,3,8,11,0,3,5,1,1,13
424135,476_15_28,JAPAN,18621,16,keijuro matsui,17,0,1,0,0,0,0,0,1,0,0,0,0,0,3,3,2,1,0,0,0,0
424136,476_15_28,JAPAN,28343,17,gaku arao,14,1,2,50,1,2,50,0,0,0,0,0,0,2,4,6,1,3,1,0,0,2
424137,476_15_28,JAPAN,23321,24,daiki tanaka,21,3,10,30,3,7,42.9,0,3,0,0,0,0,0,2,2,2,2,0,1,0,6
424138,476_15_28,JAPAN,28344,25,takatoshi furukawa,15,3,11,27.3,2,4,50,1,7,14.3,0,0,0,0,1,1,1,2,1,0,0,7
424139,476_15_28,JAPAN,25620,34,ryumo ono,16,4,5,80,3,3,100,1,2,50,0,0,0,0,3,3,2,2,2,0,0,9
424140,476_15_28,JAPAN,18623,42,kenta hirose,3,0,2,0,0,1,0,0,1,0,0,0,0,0,2,2,0,0,0,0,0,0
424141,476_15_28,JAPAN,0,TOTALS,JAPAN,200,26,65,40,21,44,47.7,5,21,23.8,9,10,90,11,32,43,12,25,15,3,1,66
424142,476_15_28,PHILIPPINES,25433,1,andray blatche,22,7,18,38.9,7,16,43.8,0,2,0,4,5,80,4,6,10,1,0,1,0,1,18
424143,476_15_28,PHILIPPINES,9700,5,gabriel norwood,31,1,4,25,0,2,0,1,2,50,0,2,0,0,3,3,0,3,1,2,0,3
424144,476_15_28,PHILIPPINES,23361,7,jayson william,27,4,10,40,4,7,57.1,0,3,0,4,4,100,0,1,1,4,2,1,0,0,12
424145,476_15_28,PHILIPPINES,28323,8,calvin abueva,18,1,6,16.7,1,3,33.3,0,3,0,8,11,72.7,2,4,6,0,1,1,1,0,10
424146,476_15_28,PHILIPPINES,28324,9,john intal,0,0,0,0,0,0,0,0,0,0,0,0,0,0,0,0,0,0,0,0,0,0
424147,476_15_28,PHILIPPINES,28325,11,terrence romeo,21,5,11,45.5,3,7,42.9,2,4,50,0,0,0,0,4,4,0,1,2,2,0,12
424148,476_15_28,PHILIPPINES,23365,15,jean marc pingris,16,0,1,0,0,1,0,0,0,0,0,0,0,0,2,2,0,1,0,0,0,0
424149,476_15_28,PHILIPPINES,28326,22,matthew ganuelas,8,0,0,0,0,0,0,0,0,0,0,0,0,0,0,0,0,0,0,0,0,0
424150,476_15_28,PHILIPPINES,14183,23,joachim gunther thoss,8,1,1,100,1,1,100,0,0,0,1,2,50,2,0,2,0,1,0,0,0,3
424151,476_15_28,PHILIPPINES,9697,25,donaldo hontiveros,15,1,2,50,1,1,100,0,1,0,0,0,0,0,1,1,0,2,0,0,0,2
424152,476_15_28,PHILIPPINES,18657,33,ranidel de ocampo,27,4,9,44.4,1,3,33.3,3,6,50,2,4,50,0,5,5,2,3,0,1,0,13
424153,476_15_28,PHILIPPINES,9698,88,pauliasi taulava,8,0,0,0,0,0,0,0,0,0,0,0,0,1,0,1,0,1,2,2,0,0
424154,476_15_28,PHILIPPINES,0,TOTALS,PHILIPPINES,200,24,62,38.7,18,41,43.9,6,21,28.6,19,28,67.9,11,26,37,7,15,8,8,1,73
424155,476_15_29,MALAYSIA,23307,0,wen keong tong,33,0,6,0,0,3,0,0,3,0,1,2,50,3,4,7,3,3,5,1,0,1
424156,476_15_29,MALAYSIA,28349,1,chee huei liaw,0,0,0,0,0,0,0,0,0,0,0,0,0,0,0,0,0,0,0,0,0,0
424157,476_15_29,MALAYSIA,3927,3,eng heng soo,18,5,12,41.7,3,8,37.5,2,4,50,1,2,50,2,4,6,1,3,1,1,0,13
424158,476_15_29,MALAYSIA,23306,8,wei hong choo,18,1,8,12.5,0,4,0,1,4,25,0,0,0,2,3,5,1,5,1,0,0,3
424159,476_15_29,MALAYSIA,23533,10,liang chuan yek,7,0,2,0,0,2,0,0,0,0,0,0,0,0,1,1,0,0,0,0,0,0
424160,476_15_29,MALAYSIA,18639,13,yoong jing kwaan,39,7,22,31.8,4,15,26.7,3,7,42.9,2,4,50,4,10,14,1,4,4,0,1,19
424161,476_15_29,MALAYSIA,28350,17,kok hou teo,5,0,0,0,0,0,0,0,0,0,0,0,0,0,0,0,0,1,1,1,0,0
424162,476_15_29,MALAYSIA,28351,20,chee kheun ma,25,2,13,15.4,1,7,14.3,1,6,16.7,0,0,0,2,0,2,1,4,4,1,0,5
424163,476_15_29,MALAYSIA,23310,21,lok seng mak,21,1,4,25,1,4,25,0,0,0,2,3,66.7,1,6,7,1,2,2,0,0,4
424164,476_15_29,MALAYSIA,28352,37,siik yang william soon,0,0,0,0,0,0,0,0,0,0,0,0,0,0,0,0,0,0,0,0,0,0
424165,476_15_29,MALAYSIA,28353,41,ivan yeo,34,7,15,46.7,7,11,63.6,0,4,0,2,4,50,4,4,8,0,5,1,0,0,16
424166,476_15_29,MALAYSIA,18638,55,tian yuan kuek,0,0,0,0,0,0,0,0,0,0,0,0,0,0,0,0,0,0,0,0,0,0
424167,476_15_29,MALAYSIA,0,TOTALS,MALAYSIA,200,23,82,28,16,54,29.6,7,28,25,8,15,53.3,19,33,52,8,27,19,4,1,61
424168,476_15_29,KUWAIT,28310,1,yousiff borhamah,26,3,5,60,3,4,75,0,1,0,1,1,100,1,3,4,0,5,1,3,1,7
424169,476_15_29,KUWAIT,28311,4,mashari abu dhom,22,4,8,50,1,1,100,3,7,42.9,3,6,50,1,4,5,1,0,0,1,0,14
424170,476_15_29,KUWAIT,28312,5,hamad hasan,39,7,15,46.7,4,5,80,3,10,30,9,9,100,1,8,9,4,3,2,3,1,26
424171,476_15_29,KUWAIT,14244,12,abdulaziz alhamidi,0,0,0,0,0,0,0,0,0,0,0,0,0,0,0,0,0,0,0,0,0,0
424172,476_15_29,KUWAIT,28313,13,mashari alshammari,5,1,2,50,1,2,50,0,0,0,0,0,0,0,2,2,0,0,1,0,0,2
424173,476_15_29,KUWAIT,28314,15,mohammad marzouq,6,0,4,0,0,4,0,0,0,0,2,2,100,2,1,3,0,0,0,1,1,2
424174,476_15_29,KUWAIT,28315,16,naser alzafiri,26,0,7,0,0,7,0,0,0,0,2,4,50,0,4,4,0,1,0,0,0,2
424175,476_15_29,KUWAIT,14458,21,abdulrahman alshammari,14,4,6,66.7,4,6,66.7,0,0,0,1,4,25,2,6,8,0,3,4,2,0,9
424176,476_15_29,KUWAIT,28316,28,abdulrahman aljuma'h,32,5,11,45.5,5,10,50,0,1,0,0,0,0,1,3,4,1,3,2,1,2,10
424177,476_15_29,KUWAIT,14243,30,abdullah alsaeid,31,3,9,33.3,2,6,33.3,1,3,33.3,4,8,50,3,3,6,2,3,5,3,0,11
424178,476_15_29,KUWAIT,0,TOTALS,KUWAIT,200,27,67,40.3,20,45,44.4,7,22,31.8,22,34,64.7,12,40,52,8,18,15,14,5,83
424179,476_15_30,CHINA,18850,4,ji wei zhao,17,2,3,66.7,0,0,0,2,3,66.7,1,2,50,1,1,2,1,3,1,0,0,7
424180,476_15_30,CHINA,50,5,wei liu,20,3,7,42.9,3,5,60,0,2,0,0,0,0,0,2,2,1,2,2,0,0,6
424181,476_15_30,CHINA,14374,6,ailun guo,20,4,7,57.1,4,4,100,0,3,0,0,1,0,1,2,3,3,4,1,3,0,8
424182,476_15_30,CHINA,28363,7,tailong zhao,7,0,1,0,0,0,0,0,1,0,0,0,0,0,0,0,0,1,0,0,0,0
424183,476_15_30,CHINA,14377,8,yanyuhang ding,28,4,6,66.7,3,3,100,1,3,33.3,1,1,100,1,3,4,2,3,1,2,0,10
424184,476_15_30,CHINA,14378,9,xiaochuan zhai,14,2,5,40,1,3,33.3,1,2,50,1,2,50,0,2,2,1,0,0,0,0,6
424185,476_15_30,CHINA,16587,10,peng zhou,5,0,1,0,0,1,0,0,0,0,0,0,0,0,2,2,0,1,0,0,0,0
424186,476_15_30,CHINA,56,11,jianlian yi,28,5,7,71.4,5,7,71.4,0,0,0,5,5,100,0,2,2,2,2,3,2,3,15
424187,476_15_30,CHINA,28364,12,gen li,25,5,11,45.5,3,4,75,2,7,28.6,0,0,0,0,1,1,1,2,3,0,0,12
424188,476_15_30,CHINA,18361,13,muhao li,2,0,0,0,0,0,0,0,0,0,0,2,0,1,0,1,0,0,1,0,0,0
424189,476_15_30,CHINA,16635,14,zhelin wang,19,1,2,50,1,2,50,0,0,0,2,2,100,1,1,2,0,2,1,0,0,4
424190,476_15_30,CHINA,18858,15,qi zhou,16,3,4,75,3,3,100,0,1,0,1,1,100,2,9,11,0,2,4,0,2,7
424191,476_15_30,CHINA,0,TOTALS,CHINA,200,29,54,53.7,23,32,71.9,6,22,27.3,11,16,68.8,8,28,36,11,22,19,7,5,75
424192,476_15_30,KAZAKHSTAN,23366,4,timur sultanov,0,0,0,0,0,0,0,0,0,0,0,0,0,0,0,0,0,0,0,0,0,0
424193,476_15_30,KAZAKHSTAN,23367,5,jerry johnson,20,4,10,40,3,7,42.9,1,3,33.3,2,2,100,0,3,3,4,3,1,0,0,11
424194,476_15_30,KAZAKHSTAN,23368,6,rustam murzagaliyev,20,0,1,0,0,0,0,0,1,0,1,2,50,1,1,2,1,3,2,2,0,1
424195,476_15_30,KAZAKHSTAN,14353,7,maxim marchuk,3,2,3,66.7,2,2,100,0,1,0,0,0,0,0,1,1,0,0,0,0,0,4
424196,476_15_30,KAZAKHSTAN,28378,8,maxim smirnov,21,2,5,40,1,3,33.3,1,2,50,0,0,0,0,1,1,1,3,0,1,0,5
424197,476_15_30,KAZAKHSTAN,28379,9,anatoliy kolesnikov,32,5,11,45.5,5,10,50,0,1,0,4,6,66.7,1,4,5,1,2,1,3,0,14
424198,476_15_30,KAZAKHSTAN,13764,10,pavel ilin,26,1,4,25,1,3,33.3,0,1,0,2,3,66.7,1,0,1,1,0,3,0,0,4
424199,476_15_30,KAZAKHSTAN,3813,11,anton ponomarev,9,1,3,33.3,1,3,33.3,0,0,0,0,0,0,1,1,2,0,2,1,1,0,2
424200,476_15_30,KAZAKHSTAN,28380,12,dmitriy klimov,28,1,7,14.3,0,4,0,1,3,33.3,1,2,50,1,1,2,2,3,3,1,0,4
424201,476_15_30,KAZAKHSTAN,9605,13,rustam yargaliyev,19,2,5,40,1,2,50,1,3,33.3,4,4,100,0,3,3,0,0,0,0,0,9
424202,476_15_30,KAZAKHSTAN,9603,14,dmitriy gavrilov,0,0,0,0,0,0,0,0,0,0,0,0,0,0,0,0,0,0,0,0,0,0
424203,476_15_30,KAZAKHSTAN,13766,15,alexandr zhigulin,22,3,9,33.3,1,6,16.7,2,3,66.7,0,0,0,0,1,1,0,5,0,0,0,8
424204,476_15_30,KAZAKHSTAN,0,TOTALS,KAZAKHSTAN,200,21,58,36.2,15,40,37.5,6,18,33.3,14,19,73.7,10,18,28,10,21,13,8,0,62
424205,476_15_31,SINGAPORE,25656,1,shi yang ng,1,0,0,0,0,0,0,0,0,0,0,0,0,0,0,0,0,0,0,0,0,0
424206,476_15_31,SINGAPORE,25653,2,wei jie desmond oh,24,4,7,57.1,2,3,66.7,2,4,50,2,2,100,0,2,2,2,2,1,1,0,12
424207,476_15_31,SINGAPORE,14339,4,mingrong jabez su,0,0,0,0,0,0,0,0,0,0,0,0,0,0,0,0,0,0,0,0,0,0
424208,476_15_31,SINGAPORE,25650,5,wei long wong,35,3,16,18.8,1,6,16.7,2,10,20,1,2,50,3,3,6,1,1,2,2,0,9
424209,476_15_31,SINGAPORE,25649,8,qing huang toh,10,3,5,60,3,5,60,0,0,0,0,0,0,0,1,1,0,0,1,0,0,6
424210,476_15_31,SINGAPORE,25659,9,john jing lun ng,5,0,2,0,0,1,0,0,1,0,0,0,0,0,1,1,0,1,0,0,0,0
424211,476_15_31,SINGAPORE,28360,10,wei meng leon kwek,27,4,7,57.1,4,6,66.7,0,1,0,1,2,50,0,2,2,0,3,3,1,0,9
424212,476_15_31,SINGAPORE,25657,12,shengyu lim,23,4,10,40,4,7,57.1,0,3,0,2,2,100,2,5,7,1,2,4,0,0,10
424213,476_15_31,SINGAPORE,25651,17,hanbin ng,27,7,16,43.8,4,6,66.7,3,10,30,0,0,0,1,1,2,3,1,2,1,0,17
424214,476_15_31,SINGAPORE,28361,22,kelvin hong da lim,4,0,1,0,0,1,0,0,0,0,0,0,0,0,0,0,0,0,1,1,0,0
424215,476_15_31,SINGAPORE,14341,23,kok chiang delvin goh,30,0,6,0,0,6,0,0,0,0,0,0,0,2,6,8,3,2,0,0,1,0
424216,476_15_31,SINGAPORE,28362,83,chin hong tan,15,1,5,20,1,3,33.3,0,2,0,0,0,0,3,0,3,1,3,0,1,0,2
424217,476_15_31,SINGAPORE,0,TOTALS,SINGAPORE,200,26,75,34.7,19,44,43.2,7,31,22.6,6,8,75,12,21,33,11,15,15,7,1,65
424218,476_15_31,CHINESE TAIPEI,3841,1,lei tien,21,8,13,61.5,3,6,50,5,7,71.4,0,0,0,1,3,4,0,4,1,0,0,21
424219,476_15_31,CHINESE TAIPEI,25616,5,cheng liu,22,2,8,25,2,5,40,0,3,0,0,0,0,1,1,2,3,3,3,1,0,4
424220,476_15_31,CHINESE TAIPEI,23316,8,shih-chieh chen,21,4,6,66.7,3,4,75,1,2,50,0,0,0,2,0,2,3,0,1,1,0,9
424221,476_15_31,CHINESE TAIPEI,9656,9,shih-nien chen,18,1,4,25,0,1,0,1,3,33.3,2,2,100,0,3,3,2,0,1,0,0,5
424222,476_15_31,CHINESE TAIPEI,9665,13,cheng-ju lu,18,4,7,57.1,1,2,50,3,5,60,1,2,50,0,2,2,2,0,0,2,0,12
424223,476_15_31,CHINESE TAIPEI,23319,14,wen-cheng tsai,16,7,8,87.5,7,8,87.5,0,0,0,4,5,80,3,2,5,0,0,1,1,0,18
424224,476_15_31,CHINESE TAIPEI,23315,15,quincy spencer davis iii,23,5,8,62.5,4,6,66.7,1,2,50,1,1,100,0,12,12,1,0,2,1,2,12
424225,476_15_31,CHINESE TAIPEI,23317,24,chih-shan hung,0,0,0,0,0,0,0,0,0,0,0,0,0,0,0,0,0,0,0,0,0,0
424226,476_15_31,CHINESE TAIPEI,9663,27,chih-chieh lin,5,1,1,100,1,1,100,0,0,0,0,0,0,1,1,2,3,0,1,0,0,2
424227,476_15_31,CHINESE TAIPEI,3839,41,tai-hao wu,18,4,5,80,4,5,80,0,0,0,5,5,100,1,3,4,1,1,0,2,0,13
424228,476_15_31,CHINESE TAIPEI,28365,49,shun-hsiang chen,20,2,5,40,1,2,50,1,3,33.3,1,1,100,0,2,2,1,4,0,0,0,6
424229,476_15_31,CHINESE TAIPEI,9659,76,wen-ting tseng,19,3,5,60,2,4,50,1,1,100,2,2,100,0,5,5,3,1,3,2,1,9
424230,476_15_31,CHINESE TAIPEI,0,TOTALS,CHINESE TAIPEI,200,41,70,58.6,28,44,63.6,13,26,50,16,18,88.9,10,36,46,19,13,13,10,3,111
424231,476_15_32,QATAR,28374,4,abdelrahman yehia abdelhaleem,0,0,0,0,0,0,0,0,0,0,0,0,0,0,0,0,0,0,0,0,0,0
424232,476_15_32,QATAR,28375,5,clinton johnson,35,4,15,26.7,4,11,36.4,0,4,0,3,4,75,1,4,5,5,2,2,1,0,11
424233,476_15_32,QATAR,6826,6,saad abdulrahman ali,18,2,6,33.3,1,2,50,1,4,25,0,0,0,0,2,2,1,5,4,0,0,5
424234,476_15_32,QATAR,3860,7,daoud mousa daoud,17,3,7,42.9,3,5,60,0,2,0,2,4,50,1,2,3,0,3,3,3,0,8
424235,476_15_32,QATAR,6827,8,suliman abdi khalid,21,4,8,50,3,6,50,1,2,50,0,2,0,1,1,2,0,2,1,0,0,9
424236,476_15_32,QATAR,28376,9,mohamed hassan a mohamed,12,2,3,66.7,0,0,0,2,3,66.7,0,0,0,0,0,0,0,0,1,0,0,6
424237,476_15_32,QATAR,28377,10,abdulrahman mohamed saad,24,5,7,71.4,5,6,83.3,0,1,0,1,3,33.3,1,4,5,1,5,1,1,0,11
424238,476_15_32,QATAR,6830,11,ali saeed erfan,33,7,13,53.8,5,9,55.6,2,4,50,4,4,100,8,3,11,2,5,2,2,1,20
424239,476_15_32,QATAR,6831,12,mohammed saleem abdulla,5,0,0,0,0,0,0,0,0,0,0,0,0,0,0,0,0,0,0,0,0,0
424240,476_15_32,QATAR,23331,13,mohd mohamed,27,1,4,25,1,2,50,0,2,0,1,2,50,1,7,8,2,3,3,0,0,3
424241,476_15_32,QATAR,18646,14,abduallah shaher matalkeh,0,0,0,0,0,0,0,0,0,0,0,0,0,0,0,0,0,0,0,0,0,0
424242,476_15_32,QATAR,18645,15,khalid abdalla adam,7,0,2,0,0,2,0,0,0,0,0,0,0,0,1,1,0,0,0,0,0,0
424243,476_15_32,QATAR,0,TOTALS,QATAR,200,28,65,43.1,22,43,51.2,6,22,27.3,11,19,57.9,14,27,41,11,25,17,7,1,73
424244,476_15_32,JORDAN,18616,0,mah'd n.j. abdeen,11,2,4,50,0,0,0,2,4,50,2,2,100,1,2,3,0,0,1,0,0,8
424245,476_15_32,JORDAN,14432,4,malek kanaan,0,0,0,0,0,0,0,0,0,0,0,0,0,0,0,0,0,0,0,0,0,0
424246,476_15_32,JORDAN,28347,6,alex legion,32,6,17,35.3,3,10,30,3,7,42.9,7,9,77.8,2,6,8,4,1,2,2,0,22
424247,476_15_32,JORDAN,23313,7,ahmad f.l. alhamarsheh,15,0,2,0,0,1,0,0,1,0,1,2,50,1,1,2,1,4,1,0,0,1
424248,476_15_32,JORDAN,23312,9,hani alfaraj,0,0,0,0,0,0,0,0,0,0,0,0,0,0,0,0,0,0,0,0,0,0
424249,476_15_32,JORDAN,9626,10,osama daghles,35,6,10,60,3,5,60,3,5,60,3,4,75,1,3,4,5,4,2,0,0,18
424250,476_15_32,JORDAN,16589,13,mohammad hussein,0,0,0,0,0,0,0,0,0,0,0,0,0,0,0,0,0,0,0,0,0,0
424251,476_15_32,JORDAN,28348,20,ahmad mahmoud obeid,0,0,0,0,0,0,0,0,0,0,0,0,0,0,0,0,0,0,0,0,0,0
424252,476_15_32,JORDAN,3885,21,zaid abbas,34,5,12,41.7,5,10,50,0,2,0,0,4,0,4,4,8,2,3,4,0,1,10
424253,476_15_32,JORDAN,9623,23,mousa alawadi,32,4,12,33.3,1,4,25,3,8,37.5,2,2,100,1,5,6,0,3,2,2,0,13
424254,476_15_32,JORDAN,9627,33,wesam al-sous,11,1,5,20,1,1,100,0,4,0,0,0,0,0,0,0,0,0,1,0,0,2
424255,476_15_32,JORDAN,16588,41,ali jamal zaghab,29,5,6,83.3,5,6,83.3,0,0,0,0,0,0,3,5,8,0,4,1,3,2,10
424256,476_15_32,JORDAN,0,TOTALS,JORDAN,200,29,68,42.6,18,37,48.6,11,31,35.5,15,23,65.2,15,28,43,12,20,14,7,3,84
424257,476_15_33,INDIA,23335,3,vinay kaushik,12,0,5,0,0,1,0,0,4,0,0,0,0,2,0,2,1,1,2,0,0,0
424258,476_15_33,INDIA,28354,4,rajesh prakash uppar,0,0,0,0,0,0,0,0,0,0,0,0,0,0,0,0,0,0,0,0,0,0
424259,476_15_33,INDIA,28355,7,siddhant sanjay shinde,0,0,0,0,0,0,0,0,0,0,0,0,0,0,0,0,0,0,0,0,0,0
424260,476_15_33,INDIA,14219,9,vishesh bhriguvanshi,40,6,13,46.2,4,6,66.7,2,7,28.6,2,2,100,0,3,3,6,2,1,4,1,16
424261,476_15_33,INDIA,18673,10,amritpal singh ,38,2,8,25,2,8,25,0,0,0,4,7,57.1,6,8,14,1,3,2,0,0,8
424262,476_15_33,INDIA,28356,13,vikas kumar ,0,0,0,0,0,0,0,0,0,0,0,0,0,0,1,1,0,0,0,0,0,0
424263,476_15_33,INDIA,18675,14,yadwinder singh,37,7,16,43.8,4,9,44.4,3,7,42.9,1,3,33.3,2,4,6,0,2,1,1,0,18
424264,476_15_33,INDIA,28357,15,arvind arumugam,0,0,0,0,0,0,0,0,0,0,0,0,0,0,0,0,0,0,0,0,0,0
424265,476_15_33,INDIA,18670,22,amjyot singh ,39,12,20,60,10,14,71.4,2,6,33.3,0,0,0,5,7,12,4,2,5,0,3,26
424266,476_15_33,INDIA,25645,66,akilan pari,31,3,14,21.4,3,7,42.9,0,7,0,2,2,100,0,4,4,3,3,1,3,0,8
424267,476_15_33,INDIA,28358,69,akashdeep hazra,0,0,0,0,0,0,0,0,0,0,0,0,0,0,0,0,0,0,0,0,0,0
424268,476_15_33,INDIA,28359,96,gurvinder singh gill,3,0,0,0,0,0,0,0,0,0,0,0,0,0,0,0,0,0,0,0,0,0
424269,476_15_33,INDIA,0,TOTALS,INDIA,200,30,76,39.5,23,45,51.1,7,31,22.6,9,14,64.3,17,30,47,15,13,12,8,4,76
424270,476_15_33,HONG KONG,28317,4,sheung ying so,0,0,0,0,0,0,0,0,0,0,0,0,0,0,0,0,0,0,0,0,0,0
424271,476_15_33,HONG KONG,28318,5,hoi to lau,0,0,0,0,0,0,0,0,0,0,0,0,0,0,0,0,0,0,0,0,0,0
424272,476_15_33,HONG KONG,28319,6,wai kong au-yeung,16,1,1,100,1,1,100,0,0,0,1,2,50,1,3,4,3,0,0,0,0,3
424273,476_15_33,HONG KONG,23387,7,ki lee,25,0,8,0,0,2,0,0,6,0,0,0,0,0,4,4,2,2,2,0,0,0
424274,476_15_33,HONG KONG,23388,8,siu wing chan,30,6,14,42.9,3,7,42.9,3,7,42.9,2,2,100,2,2,4,3,1,2,1,0,17
424275,476_15_33,HONG KONG,28320,9,shiu wah leung,4,0,0,0,0,0,0,0,0,0,1,2,50,0,0,0,1,0,0,0,0,1
424276,476_15_33,HONG KONG,28321,10,adam xu,24,5,9,55.6,5,9,55.6,0,0,0,0,0,0,1,2,3,0,0,0,1,1,10
424277,476_15_33,HONG KONG,3830,11,kam hing cheng,15,0,5,0,0,4,0,0,1,0,1,2,50,0,1,1,0,2,1,0,0,1
424278,476_15_33,HONG KONG,28322,12,ho chun lin,10,0,2,0,0,1,0,0,1,0,0,0,0,0,1,1,1,0,1,0,0,0
424279,476_15_33,HONG KONG,3834,13,chun wai wong,31,8,12,66.7,5,7,71.4,3,5,60,2,2,100,2,8,10,0,1,3,2,0,21
424280,476_15_33,HONG KONG,23391,14,duncan overbeck reid,34,8,16,50,8,16,50,0,0,0,0,0,0,3,6,9,1,3,2,1,0,16
424281,476_15_33,HONG KONG,3833,15,wai kit szeto,10,1,2,50,1,2,50,0,0,0,0,0,0,0,3,3,0,2,1,0,0,2
424282,476_15_33,HONG KONG,0,TOTALS,HONG KONG,200,29,69,42,23,49,46.9,6,20,30,7,10,70,11,31,42,11,11,13,5,1,71
424283,476_15_34,PHILIPPINES,25433,1,andray blatche,26,5,10,50,4,7,57.1,1,3,33.3,7,11,63.6,2,5,7,1,4,1,4,2,18
424284,476_15_34,PHILIPPINES,9700,5,gabriel norwood,28,2,4,50,1,2,50,1,2,50,0,0,0,1,2,3,3,3,0,2,1,5
424285,476_15_34,PHILIPPINES,23361,7,jayson william,30,11,18,61.1,9,13,69.2,2,5,40,2,3,66.7,0,2,2,3,2,5,3,0,26
424286,476_15_34,PHILIPPINES,28323,8,calvin abueva,21,4,6,66.7,4,6,66.7,0,0,0,5,7,71.4,1,5,6,0,1,2,1,0,13
424287,476_15_34,PHILIPPINES,28324,9,john intal,2,0,0,0,0,0,0,0,0,0,0,0,0,0,0,0,1,1,0,0,0,0
424288,476_15_34,PHILIPPINES,28325,11,terrence romeo,20,4,11,36.4,1,6,16.7,3,5,60,4,7,57.1,0,2,2,0,2,1,0,0,15
424289,476_15_34,PHILIPPINES,23365,15,jean marc pingris,18,0,3,0,0,3,0,0,0,0,0,0,0,1,1,2,0,0,0,1,1,0
424290,476_15_34,PHILIPPINES,28326,22,matthew ganuelas,1,0,0,0,0,0,0,0,0,0,0,0,0,0,0,0,0,0,0,0,0,0
424291,476_15_34,PHILIPPINES,14183,23,joachim gunther thoss,5,0,0,0,0,0,0,0,0,0,0,0,0,0,0,0,0,1,0,0,0,0
424292,476_15_34,PHILIPPINES,9697,25,donaldo hontiveros,21,1,7,14.3,0,2,0,1,5,20,0,0,0,0,1,1,0,1,2,0,0,3
424293,476_15_34,PHILIPPINES,18657,33,ranidel de ocampo,24,2,3,66.7,1,1,100,1,2,50,0,0,0,0,10,10,1,2,0,1,1,5
424294,476_15_34,PHILIPPINES,9698,88,pauliasi taulava,5,0,0,0,0,0,0,0,0,0,2,2,100,3,1,4,0,2,1,0,0,2
424295,476_15_34,PHILIPPINES,0,TOTALS,PHILIPPINES,200,29,62,46.8,20,40,50,9,22,40.9,20,30,66.7,10,30,40,9,19,12,12,5,87
424296,476_15_34,IRAN,14400,4,sajjad mashayekhi,19,5,8,62.5,4,5,80,1,3,33.3,0,0,0,0,1,1,2,4,1,1,0,11
424297,476_15_34,IRAN,22994,5,behnam yakhchalidehkordi,2,0,0,0,0,0,0,0,0,0,0,0,0,0,0,0,0,0,0,0,0,0
424298,476_15_34,IRAN,9684,6,javad davari,17,3,3,100,0,0,0,3,3,100,0,0,0,0,2,2,0,0,1,0,0,9
424299,476_15_34,IRAN,9685,7,mahdi kamrani,27,3,12,25,1,8,12.5,2,4,50,3,6,50,1,2,3,3,0,3,2,0,11
424300,476_15_34,IRAN,28339,8,saeid karekani,9,1,3,33.3,1,1,100,0,2,0,0,0,0,1,2,3,1,0,0,1,0,2
424301,476_15_34,IRAN,13743,9,mohammad hassanzadeh saberi a,19,1,3,33.3,1,3,33.3,0,0,0,0,1,0,2,3,5,0,3,1,0,0,2
424302,476_15_34,IRAN,9688,10,hamed afagh,9,0,2,0,0,0,0,0,2,0,0,0,0,0,2,2,0,1,1,0,0,0
424303,476_15_34,IRAN,9690,11,oshin sahakian,26,0,5,0,0,3,0,0,2,0,0,0,0,2,6,8,1,2,2,0,0,0
424304,476_15_34,IRAN,28340,12,asghar kardoustpoustinsaraei,0,0,0,0,0,0,0,0,0,0,0,0,0,0,0,0,0,0,0,0,0,0
424305,476_15_34,IRAN,13739,13,mohammad jamshidijafarabadi,19,3,7,42.9,3,7,42.9,0,0,0,1,1,100,1,2,3,2,3,1,0,0,7
424306,476_15_34,IRAN,11627,14,mohammadsamad nik,26,7,15,46.7,2,7,28.6,5,8,62.5,2,3,66.7,0,2,2,1,3,4,0,0,21
424307,476_15_34,IRAN,9693,15,hamed ehadadi,27,4,9,44.4,4,9,44.4,0,0,0,2,4,50,5,2,7,0,5,2,1,1,10
424308,476_15_34,IRAN,0,TOTALS,IRAN,200,27,67,40.3,16,43,37.2,11,24,45.8,8,15,53.3,13,26,39,10,21,16,5,1,73
424309,476_15_35,PALESTINE,28327,4,ahmed haroon,0,0,0,0,0,0,0,0,0,0,0,0,0,0,0,0,0,0,0,0,0,0
424310,476_15_35,PALESTINE,28328,5,shadi khatib,3,0,1,0,0,1,0,0,0,0,0,0,0,0,0,0,0,1,0,0,0,0
424311,476_15_35,PALESTINE,28329,6,jamal abu shamala,38,7,15,46.7,3,7,42.9,4,8,50,4,4,100,0,6,6,3,2,2,2,0,22
424312,476_15_35,PALESTINE,28330,7,ahmed younis,36,1,5,20,1,4,25,0,1,0,0,0,0,0,1,1,1,3,2,0,1,2
424313,476_15_35,PALESTINE,28331,8,jehad othman b. yaghmour,6,1,2,50,1,2,50,0,0,0,0,0,0,0,0,0,0,1,0,0,0,2
424314,476_15_35,PALESTINE,28332,9,amin salman,2,0,0,0,0,0,0,0,0,0,0,0,0,0,0,0,0,1,0,0,0,0
424315,476_15_35,PALESTINE,28333,10,imad qahwash,38,4,8,50,3,7,42.9,1,1,100,0,2,0,1,2,3,6,2,3,1,0,9
424316,476_15_35,PALESTINE,28334,11,enar odeh,4,0,0,0,0,0,0,0,0,0,0,0,0,0,0,0,0,0,0,0,0,0
424317,476_15_35,PALESTINE,28335,12,sami owda,4,1,2,50,1,2,50,0,0,0,0,0,0,0,1,1,1,1,0,0,0,2
424318,476_15_35,PALESTINE,28336,13,sani sakakini,36,11,26,42.3,10,22,45.5,1,4,25,4,4,100,4,13,17,0,4,1,0,0,27
424319,476_15_35,PALESTINE,28337,14,hamza yousef,23,1,2,50,1,2,50,0,0,0,0,0,0,1,3,4,1,4,2,1,0,2
424320,476_15_35,PALESTINE,28338,15,salim sakakini,11,0,1,0,0,1,0,0,0,0,1,2,50,0,1,1,0,1,0,0,0,1
424321,476_15_35,PALESTINE,0,TOTALS,PALESTINE,200,26,62,41.9,20,48,41.7,6,14,42.9,9,12,75,6,30,36,12,20,11,4,1,67
424322,476_15_35,JAPAN,28341,0,yuta tabuse,30,1,5,20,1,5,20,0,0,0,0,0,0,0,3,3,3,2,0,2,0,2
424323,476_15_35,JAPAN,23322,6,makoto hiejima,24,6,14,42.9,5,10,50,1,4,25,0,0,0,0,1,1,2,3,1,0,0,13
424324,476_15_35,JAPAN,18625,8,atsuya ota,21,1,2,50,1,2,50,0,0,0,0,2,0,2,2,4,1,3,1,0,0,2
424325,476_15_35,JAPAN,28342,10,ryoma hashimoto,9,1,3,33.3,0,1,0,1,2,50,0,0,0,0,2,2,2,2,1,0,0,3
424326,476_15_35,JAPAN,3875,15,joji takeuchi,38,8,15,53.3,8,13,61.5,0,2,0,5,7,71.4,7,12,19,2,1,3,0,2,21
424327,476_15_35,JAPAN,18621,16,keijuro matsui,19,5,10,50,4,6,66.7,1,4,25,1,2,50,1,4,5,3,2,0,0,0,12
424328,476_15_35,JAPAN,28343,17,gaku arao,6,0,0,0,0,0,0,0,0,0,2,2,100,0,0,0,0,0,0,1,0,2
424329,476_15_35,JAPAN,23321,24,daiki tanaka,16,2,7,28.6,2,5,40,0,2,0,0,0,0,3,1,4,2,1,1,1,0,4
424330,476_15_35,JAPAN,28344,25,takatoshi furukawa,21,2,10,20,2,6,33.3,0,4,0,2,4,50,1,2,3,1,2,0,1,0,6
424331,476_15_35,JAPAN,25620,34,ryumo ono,15,3,9,33.3,0,3,0,3,6,50,0,4,0,4,2,6,2,1,3,0,0,9
424332,476_15_35,JAPAN,18623,42,kenta hirose,1,0,1,0,0,1,0,0,0,0,0,0,0,0,0,0,0,0,0,0,0,0
424333,476_15_35,JAPAN,0,TOTALS,JAPAN,200,29,76,38.2,23,52,44.2,6,24,25,10,21,47.6,22,31,53,18,17,10,5,2,74
424334,476_15_36,QATAR,28374,4,abdelrahman yehia abdelhaleem,3,0,0,0,0,0,0,0,0,0,0,0,0,1,1,2,0,1,0,0,0,0
424335,476_15_36,QATAR,28375,5,clinton johnson,31,7,17,41.2,6,14,42.9,1,3,33.3,0,0,0,2,1,3,4,2,2,1,0,15
424336,476_15_36,QATAR,6826,6,saad abdulrahman ali,35,5,11,45.5,2,5,40,3,6,50,2,4,50,3,1,4,0,0,0,2,0,15
424337,476_15_36,QATAR,3860,7,daoud mousa daoud,0,0,0,0,0,0,0,0,0,0,0,0,0,0,0,0,0,0,0,0,0,0
424338,476_15_36,QATAR,6827,8,suliman abdi khalid,23,3,9,33.3,1,4,25,2,5,40,2,2,100,2,8,10,0,3,3,0,0,10
424339,476_15_36,QATAR,28376,9,mohamed hassan a mohamed,15,1,3,33.3,0,0,0,1,3,33.3,0,0,0,0,1,1,0,0,2,0,0,3
424340,476_15_36,QATAR,28377,10,abdulrahman mohamed saad,16,2,7,28.6,2,6,33.3,0,1,0,0,2,0,1,1,2,0,3,0,1,0,4
424341,476_15_36,QATAR,6830,11,ali saeed erfan,38,2,12,16.7,2,9,22.2,0,3,0,2,2,100,3,7,10,1,3,1,0,0,6
424342,476_15_36,QATAR,6831,12,mohammed saleem abdulla,8,0,1,0,0,1,0,0,0,0,0,0,0,1,0,1,0,1,0,0,0,0
424343,476_15_36,QATAR,23331,13,mohd mohamed,31,4,5,80,4,5,80,0,0,0,8,9,88.9,3,7,10,1,4,2,0,1,16
424344,476_15_36,QATAR,18646,14,abduallah shaher matalkeh,0,0,0,0,0,0,0,0,0,0,0,0,0,0,0,0,0,0,0,0,0,0
424345,476_15_36,QATAR,18645,15,khalid abdalla adam,0,0,0,0,0,0,0,0,0,0,0,0,0,0,0,0,0,0,0,0,0,0
424346,476_15_36,QATAR,0,TOTALS,QATAR,200,24,65,36.9,17,44,38.6,7,21,33.3,14,19,73.7,19,29,48,6,17,11,4,1,69
424347,476_15_36,KOREA,11667,1,taesul kim,5,0,0,0,0,0,0,0,0,0,0,0,0,0,0,0,1,0,0,0,0,0
424348,476_15_36,KOREA,28345,3,junghyun lee,6,0,0,0,0,0,0,0,0,0,0,0,0,0,0,0,0,0,0,0,0,0
424349,476_15_36,KOREA,16672,4,seonggon moon,6,0,3,0,0,1,0,0,2,0,0,0,0,0,1,1,0,1,0,1,0,0
424350,476_15_36,KOREA,22972,5,junyong choi,13,1,2,50,0,0,0,1,2,50,1,2,50,1,4,5,2,5,1,0,0,4
424351,476_15_36,KOREA,9631,6,donggeun yang,35,5,15,33.3,2,6,33.3,3,9,33.3,2,2,100,0,2,2,4,1,1,3,1,15
424352,476_15_36,KOREA,18640,7,chan hee park,0,0,0,0,0,0,0,0,0,0,0,0,0,0,0,0,0,0,0,0,0,0
424353,476_15_36,KOREA,18643,10,sungmin cho,31,2,11,18.2,1,1,100,1,10,10,2,2,100,1,2,3,2,4,1,0,0,7
424354,476_15_36,KOREA,22971,11,sangjae kang,2,0,2,0,0,2,0,0,0,0,0,0,0,0,0,0,0,0,0,0,0,0
424355,476_15_36,KOREA,18644,15,jongkyu kim,20,3,6,50,3,6,50,0,0,0,2,4,50,2,4,6,0,3,1,1,1,8
424356,476_15_36,KOREA,28346,22,taeyoung moon,24,2,9,22.2,2,8,25,0,1,0,0,0,0,3,3,6,1,1,2,2,0,4
424357,476_15_36,KOREA,14338,32,jonghyun lee,20,3,3,100,3,3,100,0,0,0,0,2,0,1,2,3,0,3,2,1,2,6
424358,476_15_36,KOREA,18395,33,seounghyun lee,38,9,13,69.2,8,12,66.7,1,1,100,0,0,0,2,4,6,1,0,0,0,0,19
424359,476_15_36,KOREA,0,TOTALS,KOREA,200,25,64,39.1,19,39,48.7,6,25,24,7,12,58.3,11,24,35,11,18,8,8,4,63
424360,476_15_37,LEBANON,6780,4,jean abd el nour,10,1,3,33.3,1,2,50,0,1,0,0,0,0,1,1,2,0,0,1,1,0,2
424361,476_15_37,LEBANON,28366,5,amir saoud,20,4,7,57.1,2,3,66.7,2,4,50,0,0,0,0,0,0,0,0,2,1,0,10
424362,476_15_37,LEBANON,28367,6,mohamad ali haidar,17,2,9,22.2,2,6,33.3,0,3,0,1,1,100,0,3,3,0,4,2,0,0,5
424363,476_15_37,LEBANON,28368,7,wael arakji,20,2,3,66.7,2,3,66.7,0,0,0,0,0,0,0,1,1,4,1,3,2,0,4
424364,476_15_37,LEBANON,28369,8,joseph aby kheres,8,0,2,0,0,2,0,0,0,0,0,0,0,1,0,1,0,2,0,0,0,0
424365,476_15_37,LEBANON,28370,9,ahmad ibrahim,2,0,0,0,0,0,0,0,0,0,0,0,0,0,0,0,0,0,0,0,0,0
424366,476_15_37,LEBANON,28371,10,nadim souaid,18,3,9,33.3,2,6,33.3,1,3,33.3,1,2,50,3,0,3,1,3,1,1,0,8
424367,476_15_37,LEBANON,8977,11,rodrigue akl,20,0,0,0,0,0,0,0,0,0,0,0,0,0,3,3,4,1,1,0,0,0
424368,476_15_37,LEBANON,18668,12,charles tabet,22,4,10,40,4,10,40,0,0,0,0,0,0,1,2,3,0,2,0,0,0,8
424369,476_15_37,LEBANON,18667,13,bassel bawji,27,4,12,33.3,3,7,42.9,1,5,20,5,6,83.3,3,4,7,2,4,3,0,2,14
424370,476_15_37,LEBANON,28372,14,jasmon jovan youngblood,16,6,9,66.7,4,6,66.7,2,3,66.7,0,0,0,0,1,1,0,1,0,1,0,14
424371,476_15_37,LEBANON,28373,15,omar el ayoubi,18,3,4,75,2,3,66.7,1,1,100,0,0,0,0,0,0,0,0,0,3,0,7
424372,476_15_37,LEBANON,0,TOTALS,LEBANON,200,29,68,42.6,22,48,45.8,7,20,35,7,9,77.8,12,18,30,11,18,13,9,2,72
424373,476_15_37,CHINA,18850,4,ji wei zhao,19,1,2,50,0,1,0,1,1,100,2,2,100,1,3,4,1,2,2,1,0,5
424374,476_15_37,CHINA,50,5,wei liu,19,2,7,28.6,2,6,33.3,0,1,0,0,0,0,1,6,7,3,1,1,1,0,4
424375,476_15_37,CHINA,14374,6,ailun guo,20,5,6,83.3,4,5,80,1,1,100,2,3,66.7,0,2,2,2,1,3,0,0,13
424376,476_15_37,CHINA,28363,7,tailong zhao,1,0,0,0,0,0,0,0,0,0,0,0,0,0,0,0,0,0,0,0,0,0
424377,476_15_37,CHINA,14377,8,yanyuhang ding,20,1,3,33.3,1,2,50,0,1,0,0,0,0,1,0,1,3,4,1,1,0,2
424378,476_15_37,CHINA,14378,9,xiaochuan zhai,18,5,8,62.5,3,4,75,2,4,50,1,2,50,3,3,6,0,3,0,0,0,13
424379,476_15_37,CHINA,16587,10,peng zhou,23,5,10,50,3,5,60,2,5,40,1,2,50,1,2,3,3,0,0,4,0,13
424380,476_15_37,CHINA,56,11,jianlian yi,25,7,11,63.6,7,11,63.6,0,0,0,5,5,100,1,4,5,2,1,3,2,0,19
424381,476_15_37,CHINA,28364,12,gen li,10,0,1,0,0,0,0,0,1,0,0,0,0,1,1,2,0,3,0,1,0,0
424382,476_15_37,CHINA,18361,13,muhao li,0,0,0,0,0,0,0,0,0,0,0,0,0,0,0,0,0,0,0,0,0,0
424383,476_15_37,CHINA,16635,14,zhelin wang,24,4,11,36.4,4,11,36.4,0,0,0,3,3,100,4,1,5,0,3,1,0,0,11
424384,476_15_37,CHINA,18858,15,qi zhou,22,3,5,60,3,4,75,0,1,0,4,6,66.7,2,3,5,2,0,3,0,4,10
424385,476_15_37,CHINA,0,TOTALS,CHINA,200,33,64,51.6,27,49,55.1,6,15,40,18,23,78.3,16,27,43,16,18,15,10,4,90
424386,476_15_38,MALAYSIA,23307,0,wen keong tong,35,4,10,40,3,9,33.3,1,1,100,1,1,100,1,0,1,5,1,3,1,0,10
424387,476_15_38,MALAYSIA,28349,1,chee huei liaw,0,0,0,0,0,0,0,0,0,0,0,0,0,0,0,0,0,0,0,0,0,0
424388,476_15_38,MALAYSIA,3927,3,eng heng soo,27,6,13,46.2,3,6,50,3,7,42.9,0,0,0,5,0,5,1,2,3,1,0,15
424389,476_15_38,MALAYSIA,23306,8,wei hong choo,27,4,12,33.3,3,6,50,1,6,16.7,0,0,0,0,2,2,1,5,2,0,1,9
424390,476_15_38,MALAYSIA,23533,10,liang chuan yek,8,0,0,0,0,0,0,0,0,0,0,0,0,0,0,0,0,1,0,0,0,0
424391,476_15_38,MALAYSIA,18639,13,yoong jing kwaan,26,4,15,26.7,4,13,30.8,0,2,0,2,5,40,5,1,6,1,4,3,1,1,10
424392,476_15_38,MALAYSIA,28350,17,kok hou teo,0,0,0,0,0,0,0,0,0,0,0,0,0,0,0,0,0,0,0,0,0,0
424393,476_15_38,MALAYSIA,28351,20,chee kheun ma,15,0,8,0,0,3,0,0,5,0,2,2,100,0,3,3,0,1,2,1,1,2
424394,476_15_38,MALAYSIA,23310,21,lok seng mak,22,3,6,50,3,5,60,0,1,0,0,0,0,1,3,4,1,2,0,0,0,6
424395,476_15_38,MALAYSIA,28352,37,siik yang william soon,3,1,1,100,1,1,100,0,0,0,0,1,0,0,1,1,0,0,0,0,0,2
424396,476_15_38,MALAYSIA,28353,41,ivan yeo,36,2,9,22.2,2,9,22.2,0,0,0,1,2,50,1,12,13,1,0,1,1,0,5
424397,476_15_38,MALAYSIA,18638,55,tian yuan kuek,0,0,0,0,0,0,0,0,0,0,0,0,0,0,0,0,0,0,0,0,0,0
424398,476_15_38,MALAYSIA,0,TOTALS,MALAYSIA,200,24,74,32.4,19,52,36.5,5,22,22.7,6,11,54.5,14,24,38,10,16,15,5,3,59
424399,476_15_38,SINGAPORE,25656,1,shi yang ng,2,0,0,0,0,0,0,0,0,0,0,0,0,0,0,0,1,0,0,1,0,0
424400,476_15_38,SINGAPORE,25653,2,wei jie desmond oh,27,5,7,71.4,5,5,100,0,2,0,1,1,100,0,1,1,2,3,3,1,0,11
424401,476_15_38,SINGAPORE,14339,4,mingrong jabez su,0,0,0,0,0,0,0,0,0,0,0,0,0,0,0,0,0,0,0,0,0,0
424402,476_15_38,SINGAPORE,25650,5,wei long wong,37,4,7,57.1,2,3,66.7,2,4,50,0,0,0,0,2,2,5,1,2,1,0,10
424403,476_15_38,SINGAPORE,25649,8,qing huang toh,9,0,1,0,0,1,0,0,0,0,0,0,0,0,0,0,0,1,0,0,0,0
424404,476_15_38,SINGAPORE,25659,9,john jing lun ng,3,1,1,100,0,0,0,1,1,100,0,0,0,0,0,0,0,1,1,0,0,3
424405,476_15_38,SINGAPORE,28360,10,wei meng leon kwek,12,4,6,66.7,4,6,66.7,0,0,0,1,2,50,0,4,4,0,5,1,0,0,9
424406,476_15_38,SINGAPORE,25657,12,shengyu lim,28,9,17,52.9,6,13,46.2,3,4,75,3,3,100,2,9,11,3,4,1,2,0,24
424407,476_15_38,SINGAPORE,25651,17,hanbin ng,34,3,10,30,0,3,0,3,7,42.9,0,0,0,2,4,6,3,1,0,0,0,9
424408,476_15_38,SINGAPORE,28361,22,kelvin hong da lim,3,1,1,100,1,1,100,0,0,0,0,0,0,0,0,0,0,0,1,0,0,2
424409,476_15_38,SINGAPORE,14341,23,kok chiang delvin goh,36,8,16,50,8,16,50,0,0,0,4,4,100,6,12,18,1,0,6,3,1,20
424410,476_15_38,SINGAPORE,28362,83,chin hong tan,8,2,4,50,2,4,50,0,0,0,0,1,0,0,1,1,0,1,0,0,0,4
424411,476_15_38,SINGAPORE,0,TOTALS,SINGAPORE,200,37,70,52.9,28,52,53.8,9,18,50,9,11,81.8,11,37,48,15,17,15,8,1,92
424412,476_15_39,JORDAN,18616,0,mah'd n.j. abdeen,22,5,12,41.7,2,4,50,3,8,37.5,0,0,0,0,1,1,3,2,0,2,0,13
424413,476_15_39,JORDAN,14432,4,malek kanaan,1,0,0,0,0,0,0,0,0,0,0,0,0,0,0,0,1,0,1,0,0,0
424414,476_15_39,JORDAN,28347,6,alex legion,34,10,18,55.6,7,12,58.3,3,6,50,0,0,0,1,5,6,5,4,1,1,0,23
424415,476_15_39,JORDAN,23313,7,ahmad f.l. alhamarsheh,19,0,5,0,0,3,0,0,2,0,0,0,0,3,1,4,1,3,0,0,0,0
424416,476_15_39,JORDAN,23312,9,hani alfaraj,0,0,0,0,0,0,0,0,0,0,0,0,0,0,0,0,0,0,0,0,0,0
424417,476_15_39,JORDAN,9626,10,osama daghles,21,3,4,75,3,3,100,0,1,0,2,2,100,1,4,5,1,1,2,1,0,8
424418,476_15_39,JORDAN,16589,13,mohammad hussein,0,0,0,0,0,0,0,0,0,0,0,0,0,0,0,0,0,0,0,0,0,0
424419,476_15_39,JORDAN,28348,20,ahmad mahmoud obeid,1,0,0,0,0,0,0,0,0,0,0,0,0,0,0,0,0,1,0,0,0,0
424420,476_15_39,JORDAN,3885,21,zaid abbas,29,3,9,33.3,2,7,28.6,1,2,50,6,10,60,0,10,10,3,3,2,4,1,13
424421,476_15_39,JORDAN,9623,23,mousa alawadi,27,5,13,38.5,1,3,33.3,4,10,40,0,0,0,0,2,2,1,1,0,0,0,14
424422,476_15_39,JORDAN,9627,33,wesam al-sous,15,1,5,20,1,5,20,0,0,0,2,2,100,1,2,3,0,2,0,0,0,4
424423,476_15_39,JORDAN,16588,41,ali jamal zaghab,30,6,9,66.7,6,9,66.7,0,0,0,0,0,0,5,4,9,1,3,1,0,3,12
424424,476_15_39,JORDAN,0,TOTALS,JORDAN,200,33,75,44,22,46,47.8,11,29,37.9,10,14,71.4,13,30,43,16,20,8,8,4,87
424425,476_15_39,KAZAKHSTAN,23366,4,timur sultanov,0,0,0,0,0,0,0,0,0,0,0,0,0,0,0,0,0,0,0,0,0,0
424426,476_15_39,KAZAKHSTAN,23367,5,jerry johnson,31,9,13,69.2,5,7,71.4,4,6,66.7,4,4,100,0,4,4,4,3,2,0,0,26
424427,476_15_39,KAZAKHSTAN,23368,6,rustam murzagaliyev,9,1,1,100,0,0,0,1,1,100,0,0,0,0,0,0,0,2,1,0,0,3
424428,476_15_39,KAZAKHSTAN,14353,7,maxim marchuk,7,1,3,33.3,1,3,33.3,0,0,0,1,3,33.3,0,1,1,0,1,3,0,0,3
424429,476_15_39,KAZAKHSTAN,28378,8,maxim smirnov,14,1,5,20,1,5,20,0,0,0,0,0,0,1,1,2,0,2,0,0,0,2
424430,476_15_39,KAZAKHSTAN,28379,9,anatoliy kolesnikov,27,4,8,50,4,8,50,0,0,0,4,6,66.7,1,4,5,0,1,5,0,0,12
424431,476_15_39,KAZAKHSTAN,13764,10,pavel ilin,22,1,5,20,1,2,50,0,3,0,1,2,50,1,2,3,0,3,0,1,1,3
424432,476_15_39,KAZAKHSTAN,3813,11,anton ponomarev,34,4,11,36.4,1,6,16.7,3,5,60,6,7,85.7,4,9,13,1,3,1,1,0,17
424433,476_15_39,KAZAKHSTAN,28380,12,dmitriy klimov,16,1,4,25,1,3,33.3,0,1,0,0,0,0,0,2,2,2,0,1,0,1,2
424434,476_15_39,KAZAKHSTAN,9605,13,rustam yargaliyev,23,0,6,0,0,2,0,0,4,0,1,2,50,1,2,3,1,1,0,0,0,1
424435,476_15_39,KAZAKHSTAN,9603,14,dmitriy gavrilov,0,0,0,0,0,0,0,0,0,0,0,0,0,0,0,0,0,0,0,0,0,0
424436,476_15_39,KAZAKHSTAN,13766,15,alexandr zhigulin,16,2,4,50,2,4,50,0,0,0,0,1,0,0,1,1,0,4,0,1,0,4
424437,476_15_39,KAZAKHSTAN,0,TOTALS,KAZAKHSTAN,200,24,60,40,16,40,40,8,20,40,17,25,68,9,28,37,8,20,13,3,2,73
424438,476_15_40,KUWAIT,28310,1,yousiff borhamah,26,2,7,28.6,2,6,33.3,0,1,0,0,2,0,3,1,4,2,1,1,1,0,4
424439,476_15_40,KUWAIT,28311,4,mashari abu dhom,31,4,14,28.6,3,7,42.9,1,7,14.3,0,0,0,1,1,2,1,2,4,1,0,9
424440,476_15_40,KUWAIT,28312,5,hamad hasan,36,9,20,45,3,11,27.3,6,9,66.7,2,2,100,1,5,6,0,3,6,1,1,26
424441,476_15_40,KUWAIT,14244,12,abdulaziz alhamidi,0,0,0,0,0,0,0,0,0,0,0,0,0,0,0,0,0,0,0,0,0,0
424442,476_15_40,KUWAIT,28313,13,mashari alshammari,12,3,5,60,3,4,75,0,1,0,1,2,50,2,1,3,2,3,0,1,0,7
424443,476_15_40,KUWAIT,28314,15,mohammad marzouq,4,0,0,0,0,0,0,0,0,0,0,0,0,0,1,1,0,1,0,0,0,0
424444,476_15_40,KUWAIT,28315,16,naser alzafiri,5,0,1,0,0,1,0,0,0,0,0,0,0,0,1,1,0,0,0,1,0,0
424445,476_15_40,KUWAIT,14458,21,abdulrahman alshammari,24,4,10,40,4,9,44.4,0,1,0,1,2,50,4,6,10,0,0,4,0,1,9
424446,476_15_40,KUWAIT,28316,28,abdulrahman aljuma'h,30,1,8,12.5,1,7,14.3,0,1,0,0,0,0,2,2,4,0,4,4,0,0,2
424447,476_15_40,KUWAIT,14243,30,abdullah alsaeid,32,3,9,33.3,3,6,50,0,3,0,6,8,75,5,7,12,2,1,1,0,0,12
424448,476_15_40,KUWAIT,0,TOTALS,KUWAIT,200,26,74,35.1,19,51,37.3,7,23,30.4,10,16,62.5,19,25,44,7,15,21,5,2,69
424449,476_15_40,CHINESE TAIPEI,3841,1,lei tien,18,4,7,57.1,3,4,75,1,3,33.3,2,2,100,0,4,4,1,4,2,1,0,11
424450,476_15_40,CHINESE TAIPEI,25616,5,cheng liu,22,7,14,50,4,8,50,3,6,50,0,0,0,0,1,1,1,1,0,4,0,17
424451,476_15_40,CHINESE TAIPEI,23316,8,shih-chieh chen,16,2,7,28.6,2,7,28.6,0,0,0,4,4,100,2,3,5,9,1,1,3,0,8
424452,476_15_40,CHINESE TAIPEI,9656,9,shih-nien chen,18,3,4,75,3,4,75,0,0,0,0,0,0,0,0,0,8,2,2,2,0,6
424453,476_15_40,CHINESE TAIPEI,9665,13,cheng-ju lu,16,5,8,62.5,1,2,50,4,6,66.7,0,0,0,0,1,1,0,1,1,0,0,14
424454,476_15_40,CHINESE TAIPEI,23319,14,wen-cheng tsai,16,3,6,50,3,6,50,0,0,0,1,2,50,1,1,2,3,0,2,0,0,7
424455,476_15_40,CHINESE TAIPEI,23315,15,quincy spencer davis iii,24,1,4,25,1,4,25,0,0,0,0,1,0,3,7,10,1,3,2,1,3,2
424456,476_15_40,CHINESE TAIPEI,23317,24,chih-shan hung,6,1,2,50,0,0,0,1,2,50,0,0,0,0,0,0,1,0,0,0,0,3
424457,476_15_40,CHINESE TAIPEI,9663,27,chih-chieh lin,12,4,7,57.1,2,3,66.7,2,4,50,0,0,0,1,3,4,1,1,0,0,0,10
424458,476_15_40,CHINESE TAIPEI,3839,41,tai-hao wu,18,3,4,75,3,4,75,0,0,0,2,2,100,0,4,4,1,2,0,2,0,8
424459,476_15_40,CHINESE TAIPEI,28365,49,shun-hsiang chen,14,3,5,60,2,2,100,1,3,33.3,1,1,100,0,1,1,0,2,3,2,0,8
424460,476_15_40,CHINESE TAIPEI,9659,76,wen-ting tseng,20,2,4,50,1,3,33.3,1,1,100,0,0,0,1,4,5,3,3,1,0,1,5
424461,476_15_40,CHINESE TAIPEI,0,TOTALS,CHINESE TAIPEI,200,38,72,52.8,25,47,53.2,13,25,52,10,12,83.3,10,32,42,29,20,14,15,4,99
424462,476_15_41,PALESTINE,28327,4,ahmed haroon,28,1,5,20,0,2,0,1,3,33.3,0,0,0,2,2,4,0,2,0,0,0,3
424463,476_15_41,PALESTINE,28328,5,shadi khatib,1,0,0,0,0,0,0,0,0,0,0,0,0,0,0,0,0,0,0,0,0,0
424464,476_15_41,PALESTINE,28329,6,jamal abu shamala,38,4,12,33.3,1,4,25,3,8,37.5,0,0,0,0,6,6,2,3,7,4,1,11
424465,476_15_41,PALESTINE,28330,7,ahmed younis,13,0,3,0,0,3,0,0,0,0,0,0,0,0,1,1,0,0,0,1,0,0
424466,476_15_41,PALESTINE,28331,8,jehad othman b. yaghmour,9,1,1,100,1,1,100,0,0,0,0,0,0,1,1,2,0,1,1,0,0,2
424467,476_15_41,PALESTINE,28332,9,amin salman,0,0,0,0,0,0,0,0,0,0,0,0,0,0,0,0,0,0,0,0,0,0
424468,476_15_41,PALESTINE,28333,10,imad qahwash,40,3,9,33.3,3,7,42.9,0,2,0,5,6,83.3,1,2,3,7,2,5,4,0,11
424469,476_15_41,PALESTINE,28334,11,enar odeh,0,0,0,0,0,0,0,0,0,0,0,0,0,0,0,0,0,0,0,0,0,0
424470,476_15_41,PALESTINE,28335,12,sami owda,0,0,0,0,0,0,0,0,0,0,0,0,0,0,0,0,0,0,0,0,0,0
424471,476_15_41,PALESTINE,28336,13,sani sakakini,36,6,21,28.6,6,17,35.3,0,4,0,1,4,25,3,3,6,1,4,4,2,0,13
424472,476_15_41,PALESTINE,28337,14,hamza yousef,17,1,2,50,1,2,50,0,0,0,0,1,0,1,2,3,0,2,3,0,0,2
424473,476_15_41,PALESTINE,28338,15,salim sakakini,17,3,6,50,3,5,60,0,1,0,0,0,0,1,3,4,0,4,1,1,0,6
424474,476_15_41,PALESTINE,0,TOTALS,PALESTINE,200,19,59,32.2,15,41,36.6,4,18,22.2,6,11,54.5,9,22,31,10,18,22,12,1,48
424475,476_15_41,IRAN,14400,4,sajjad mashayekhi,15,1,4,25,1,3,33.3,0,1,0,1,3,33.3,0,3,3,3,2,0,1,0,3
424476,476_15_41,IRAN,22994,5,behnam yakhchalidehkordi,14,3,5,60,2,2,100,1,3,33.3,0,0,0,1,1,2,1,2,0,1,0,7
424477,476_15_41,IRAN,9684,6,javad davari,11,2,5,40,1,2,50,1,3,33.3,2,2,100,1,0,1,1,1,0,2,0,7
424478,476_15_41,IRAN,9685,7,mahdi kamrani,25,6,10,60,5,6,83.3,1,4,25,1,1,100,1,3,4,3,3,3,2,0,14
424479,476_15_41,IRAN,28339,8,saeid karekani,15,5,10,50,3,6,50,2,4,50,0,0,0,0,2,2,2,1,2,1,0,12
424480,476_15_41,IRAN,13743,9,mohammad hassanzadeh saberi a,21,3,6,50,3,5,60,0,1,0,1,2,50,5,3,8,0,0,1,4,0,7
424481,476_15_41,IRAN,9688,10,hamed afagh,14,3,7,42.9,1,1,100,2,6,33.3,0,0,0,1,0,1,0,0,3,2,0,8
424482,476_15_41,IRAN,9690,11,oshin sahakian,19,3,7,42.9,2,5,40,1,2,50,0,0,0,2,7,9,0,1,1,3,0,7
424483,476_15_41,IRAN,28340,12,asghar kardoustpoustinsaraei,18,6,10,60,6,10,60,0,0,0,3,6,50,3,6,9,0,0,1,0,1,15
424484,476_15_41,IRAN,13739,13,mohammad jamshidijafarabadi,5,0,4,0,0,2,0,0,2,0,0,0,0,0,0,0,1,0,0,0,0,0
424485,476_15_41,IRAN,11627,14,mohammadsamad nik,21,0,0,0,0,0,0,0,0,0,0,0,0,0,0,0,3,3,0,2,0,0
424486,476_15_41,IRAN,9693,15,hamed ehadadi,22,5,12,41.7,5,12,41.7,0,0,0,4,4,100,4,7,11,2,2,4,0,1,14
424487,476_15_41,IRAN,0,TOTALS,IRAN,200,37,80,46.2,29,54,53.7,8,26,30.8,12,18,66.7,20,34,54,16,15,15,18,2,94
424488,476_15_42,JAPAN,28341,0,yuta tabuse,21,1,3,33.3,1,3,33.3,0,0,0,0,0,0,1,2,3,2,2,1,2,0,2
424489,476_15_42,JAPAN,23322,6,makoto hiejima,22,8,12,66.7,6,7,85.7,2,5,40,1,1,100,1,2,3,4,1,0,4,0,19
424490,476_15_42,JAPAN,18625,8,atsuya ota,20,1,1,100,1,1,100,0,0,0,1,2,50,0,3,3,0,3,1,1,0,3
424491,476_15_42,JAPAN,28342,10,ryoma hashimoto,19,1,5,20,1,1,100,0,4,0,3,3,100,0,1,1,2,2,2,0,0,5
424492,476_15_42,JAPAN,3875,15,joji takeuchi,21,8,13,61.5,8,13,61.5,0,0,0,1,1,100,1,7,8,3,1,3,0,0,17
424493,476_15_42,JAPAN,18621,16,keijuro matsui,14,4,7,57.1,1,3,33.3,3,4,75,0,0,0,1,2,3,1,0,0,0,0,11
424494,476_15_42,JAPAN,28343,17,gaku arao,19,0,0,0,0,0,0,0,0,0,0,0,0,1,1,2,1,4,1,0,1,0
424495,476_15_42,JAPAN,23321,24,daiki tanaka,17,2,4,50,2,4,50,0,0,0,0,0,0,3,0,3,1,2,1,0,0,4
424496,476_15_42,JAPAN,28344,25,takatoshi furukawa,11,2,3,66.7,2,2,100,0,1,0,3,4,75,0,1,1,0,1,3,1,0,7
424497,476_15_42,JAPAN,25620,34,ryumo ono,21,3,7,42.9,1,4,25,2,3,66.7,1,1,100,0,1,1,0,1,0,0,0,9
424498,476_15_42,JAPAN,18623,42,kenta hirose,16,4,8,50,2,3,66.7,2,5,40,2,2,100,0,3,3,3,2,0,1,1,12
424499,476_15_42,JAPAN,0,TOTALS,JAPAN,200,34,63,54,25,41,61,9,22,40.9,12,14,85.7,9,25,34,17,19,13,9,2,89
424500,476_15_42,HONG KONG,28317,4,sheung ying so,4,2,3,66.7,0,1,0,2,2,100,0,0,0,0,0,0,0,1,0,1,0,6
424501,476_15_42,HONG KONG,28318,5,hoi to lau,11,0,0,0,0,0,0,0,0,0,1,2,50,1,2,3,1,0,0,0,0,1
424502,476_15_42,HONG KONG,28319,6,wai kong au-yeung,20,0,3,0,0,3,0,0,0,0,0,2,0,1,2,3,1,2,1,1,0,0
424503,476_15_42,HONG KONG,23387,7,ki lee,24,3,7,42.9,1,2,50,2,5,40,0,0,0,0,1,1,1,0,2,0,0,8
424504,476_15_42,HONG KONG,23388,8,siu wing chan,34,3,8,37.5,1,3,33.3,2,5,40,0,0,0,0,1,1,1,3,9,0,0,8
424505,476_15_42,HONG KONG,28320,9,shiu wah leung,3,1,1,100,1,1,100,0,0,0,0,0,0,0,0,0,0,0,0,0,0,2
424506,476_15_42,HONG KONG,28321,10,adam xu,11,0,0,0,0,0,0,0,0,0,2,2,100,0,0,0,0,0,4,0,0,2
424507,476_15_42,HONG KONG,3830,11,kam hing cheng,16,2,6,33.3,1,5,20,1,1,100,2,2,100,0,2,2,2,2,1,1,0,7
424508,476_15_42,HONG KONG,28322,12,ho chun lin,8,1,2,50,1,1,100,0,1,0,0,0,0,0,0,0,1,0,0,0,0,2
424509,476_15_42,HONG KONG,3834,13,chun wai wong,28,3,6,50,0,1,0,3,5,60,5,6,83.3,1,5,6,0,3,3,1,1,14
424510,476_15_42,HONG KONG,23391,14,duncan overbeck reid,30,4,12,33.3,4,11,36.4,0,1,0,2,2,100,2,4,6,3,3,2,0,2,10
424511,476_15_42,HONG KONG,3833,15,wai kit szeto,11,1,1,100,1,1,100,0,0,0,0,0,0,0,2,2,0,3,2,0,0,2
424512,476_15_42,HONG KONG,0,TOTALS,HONG KONG,200,20,49,40.8,10,29,34.5,10,20,50,12,16,75,6,20,26,10,17,24,4,3,62
424513,476_15_43,PHILIPPINES,25433,1,andray blatche,25,7,16,43.8,6,14,42.9,1,2,50,0,0,0,2,1,3,2,0,2,5,0,15
424514,476_15_43,PHILIPPINES,9700,5,gabriel norwood,22,1,4,25,1,2,50,0,2,0,0,0,0,2,4,6,2,2,1,0,1,2
424515,476_15_43,PHILIPPINES,23361,7,jayson william,17,5,10,50,3,8,37.5,2,2,100,0,0,0,1,5,6,3,1,0,1,0,12
424516,476_15_43,PHILIPPINES,28323,8,calvin abueva,19,5,9,55.6,5,9,55.6,0,0,0,2,2,100,2,5,7,1,3,2,2,0,12
424517,476_15_43,PHILIPPINES,28324,9,john intal,18,1,6,16.7,1,2,50,0,4,0,0,0,0,1,6,7,4,0,1,0,0,2
424518,476_15_43,PHILIPPINES,28325,11,terrence romeo,23,6,13,46.2,3,5,60,3,8,37.5,5,5,100,0,3,3,4,1,1,3,0,20
424519,476_15_43,PHILIPPINES,23365,15,jean marc pingris,17,6,7,85.7,6,7,85.7,0,0,0,0,0,0,2,2,4,1,3,0,2,0,12
424520,476_15_43,PHILIPPINES,28326,22,matthew ganuelas,10,2,3,66.7,2,3,66.7,0,0,0,1,2,50,0,2,2,1,0,1,1,0,5
424521,476_15_43,PHILIPPINES,14183,23,joachim gunther thoss,9,0,2,0,0,2,0,0,0,0,0,0,0,2,2,4,1,1,0,0,0,0
424522,476_15_43,PHILIPPINES,9697,25,donaldo hontiveros,20,2,7,28.6,0,0,0,2,7,28.6,0,0,0,0,3,3,0,1,1,1,0,6
424523,476_15_43,PHILIPPINES,18657,33,ranidel de ocampo,14,6,7,85.7,5,6,83.3,1,1,100,0,0,0,2,1,3,1,2,1,0,1,13
424524,476_15_43,PHILIPPINES,9698,88,pauliasi taulava,6,0,1,0,0,1,0,0,0,0,0,0,0,0,0,0,1,1,0,0,0,0
424525,476_15_43,PHILIPPINES,0,TOTALS,PHILIPPINES,200,41,85,48.2,32,59,54.2,9,26,34.6,8,9,88.9,15,35,50,21,15,10,15,2,99
424526,476_15_43,INDIA,23335,3,vinay kaushik,7,0,1,0,0,0,0,0,1,0,0,0,0,0,0,0,0,0,0,0,0,0
424527,476_15_43,INDIA,28354,4,rajesh prakash uppar,7,0,3,0,0,1,0,0,2,0,0,0,0,1,0,1,0,2,2,1,0,0
424528,476_15_43,INDIA,28355,7,siddhant sanjay shinde,7,1,1,100,0,0,0,1,1,100,0,0,0,0,0,0,1,0,2,0,0,3
424529,476_15_43,INDIA,14219,9,vishesh bhriguvanshi,35,7,17,41.2,2,7,28.6,5,10,50,2,2,100,1,2,3,3,1,3,0,0,21
424530,476_15_43,INDIA,18673,10,amritpal singh ,38,7,15,46.7,6,14,42.9,1,1,100,3,5,60,3,10,13,1,3,1,2,2,18
424531,476_15_43,INDIA,28356,13,vikas kumar ,2,0,1,0,0,0,0,0,1,0,0,0,0,0,0,0,0,0,2,1,0,0
424532,476_15_43,INDIA,18675,14,yadwinder singh,25,3,8,37.5,2,7,28.6,1,1,100,0,0,0,2,3,5,0,2,4,0,0,7
424533,476_15_43,INDIA,28357,15,arvind arumugam,12,0,4,0,0,4,0,0,0,0,0,0,0,2,2,4,1,0,1,1,1,0
424534,476_15_43,INDIA,18670,22,amjyot singh ,38,5,14,35.7,5,11,45.5,0,3,0,1,1,100,0,5,5,3,2,6,2,0,11
424535,476_15_43,INDIA,25645,66,akilan pari,25,2,5,40,1,3,33.3,1,2,50,0,0,0,0,3,3,2,2,1,0,0,5
424536,476_15_43,INDIA,28358,69,akashdeep hazra,0,0,0,0,0,0,0,0,0,0,0,0,0,0,0,0,0,0,0,0,0,0
424537,476_15_43,INDIA,28359,96,gurvinder singh gill,3,0,0,0,0,0,0,0,0,0,0,0,0,0,1,1,0,0,0,0,0,0
424538,476_15_43,INDIA,0,TOTALS,INDIA,200,25,69,36.2,16,47,34,9,22,40.9,6,8,75,9,29,38,11,12,22,7,3,65
424539,476_15_44,LEBANON,6780,4,jean abd el nour,28,3,7,42.9,1,3,33.3,2,4,50,1,2,50,2,5,7,0,2,1,0,0,9
424540,476_15_44,LEBANON,28366,5,amir saoud,28,6,9,66.7,2,3,66.7,4,6,66.7,4,4,100,1,3,4,2,1,1,1,0,20
424541,476_15_44,LEBANON,28367,6,mohamad ali haidar,30,6,16,37.5,4,11,36.4,2,5,40,1,2,50,3,4,7,1,4,3,1,1,15
424542,476_15_44,LEBANON,28368,7,wael arakji,24,5,10,50,5,8,62.5,0,2,0,1,5,20,1,3,4,2,2,4,2,1,11
424543,476_15_44,LEBANON,28369,8,joseph aby kheres,5,0,0,0,0,0,0,0,0,0,0,0,0,1,3,4,0,1,0,0,0,0
424544,476_15_44,LEBANON,28370,9,ahmad ibrahim,0,0,0,0,0,0,0,0,0,0,0,0,0,0,0,0,0,0,0,0,0,0
424545,476_15_44,LEBANON,28371,10,nadim souaid,0,0,0,0,0,0,0,0,0,0,0,0,0,0,0,0,0,0,0,0,0,0
424546,476_15_44,LEBANON,8977,11,rodrigue akl,20,1,2,50,0,1,0,1,1,100,0,0,0,3,2,5,2,0,1,1,0,3
424547,476_15_44,LEBANON,18668,12,charles tabet,12,0,2,0,0,2,0,0,0,0,2,2,100,0,0,0,0,4,0,0,1,2
424548,476_15_44,LEBANON,18667,13,bassel bawji,21,3,6,50,3,5,60,0,1,0,2,2,100,1,3,4,0,2,1,0,1,8
424549,476_15_44,LEBANON,28372,14,jasmon jovan youngblood,33,3,13,23.1,2,7,28.6,1,6,16.7,5,10,50,1,5,6,7,4,2,0,0,12
424550,476_15_44,LEBANON,28373,15,omar el ayoubi,0,0,0,0,0,0,0,0,0,0,0,0,0,0,0,0,0,0,0,0,0,0
424551,476_15_44,LEBANON,0,TOTALS,LEBANON,200,27,65,41.5,17,40,42.5,10,25,40,16,27,59.3,17,28,45,14,20,15,5,4,80
424552,476_15_44,JORDAN,18616,0,mah'd n.j. abdeen,29,6,11,54.5,4,5,80,2,6,33.3,5,5,100,1,4,5,4,2,0,0,0,19
424553,476_15_44,JORDAN,14432,4,malek kanaan,1,0,0,0,0,0,0,0,0,0,0,0,0,0,0,0,0,0,0,0,0,0
424554,476_15_44,JORDAN,28347,6,alex legion,35,8,18,44.4,7,14,50,1,4,25,7,8,87.5,1,3,4,0,2,4,3,1,24
424555,476_15_44,JORDAN,23313,7,ahmad f.l. alhamarsheh,22,0,5,0,0,3,0,0,2,0,0,0,0,2,2,4,0,1,0,1,0,0
424556,476_15_44,JORDAN,23312,9,hani alfaraj,0,0,0,0,0,0,0,0,0,0,0,0,0,0,0,0,0,0,0,0,0,0
424557,476_15_44,JORDAN,9626,10,osama daghles,17,2,5,40,2,5,40,0,0,0,0,0,0,0,5,5,1,4,0,0,0,4
424558,476_15_44,JORDAN,16589,13,mohammad hussein,21,3,5,60,3,5,60,0,0,0,3,6,50,3,5,8,0,4,1,2,1,9
424559,476_15_44,JORDAN,28348,20,ahmad mahmoud obeid,0,0,0,0,0,0,0,0,0,0,0,0,0,0,0,0,0,0,0,0,0,0
424560,476_15_44,JORDAN,3885,21,zaid abbas,34,2,12,16.7,2,10,20,0,2,0,3,3,100,3,3,6,1,4,3,2,1,7
424561,476_15_44,JORDAN,9623,23,mousa alawadi,30,5,12,41.7,4,7,57.1,1,5,20,2,2,100,0,0,0,1,5,1,0,1,13
424562,476_15_44,JORDAN,9627,33,wesam al-sous,12,0,2,0,0,0,0,0,2,0,0,0,0,0,1,1,3,0,0,2,0,0
424563,476_15_44,JORDAN,16588,41,ali jamal zaghab,0,0,0,0,0,0,0,0,0,0,0,0,0,0,0,0,0,0,0,0,0,0
424564,476_15_44,JORDAN,0,TOTALS,JORDAN,200,26,70,37.1,22,49,44.9,4,21,19,20,24,83.3,13,28,41,10,22,10,10,4,76
424565,476_15_45,CHINA,18850,4,ji wei zhao,19,2,5,40,1,4,25,1,1,100,0,0,0,1,0,1,2,1,1,2,0,5
424566,476_15_45,CHINA,50,5,wei liu,8,1,2,50,1,2,50,0,0,0,3,4,75,0,1,1,1,1,0,0,0,5
424567,476_15_45,CHINA,14374,6,ailun guo,20,4,5,80,4,4,100,0,1,0,3,4,75,0,0,0,3,2,1,2,0,11
424568,476_15_45,CHINA,28363,7,tailong zhao,19,1,6,16.7,1,1,100,0,5,0,0,0,0,0,1,1,0,3,1,0,1,2
424569,476_15_45,CHINA,14377,8,yanyuhang ding,14,1,3,33.3,1,2,50,0,1,0,0,1,0,0,1,1,2,0,0,0,0,2
424570,476_15_45,CHINA,14378,9,xiaochuan zhai,21,3,6,50,2,3,66.7,1,3,33.3,3,5,60,1,4,5,0,1,1,1,0,10
424571,476_15_45,CHINA,16587,10,peng zhou,13,4,4,100,1,1,100,3,3,100,2,2,100,0,2,2,0,1,0,0,0,13
424572,476_15_45,CHINA,56,11,jianlian yi,21,4,10,40,3,9,33.3,1,1,100,4,4,100,0,9,9,3,1,1,0,0,13
424573,476_15_45,CHINA,28364,12,gen li,22,4,7,57.1,1,1,100,3,6,50,2,2,100,2,4,6,1,1,1,0,0,13
424574,476_15_45,CHINA,18361,13,muhao li,17,1,4,25,1,4,25,0,0,0,2,2,100,3,2,5,0,4,0,0,0,4
424575,476_15_45,CHINA,16635,14,zhelin wang,14,3,4,75,3,4,75,0,0,0,3,3,100,0,2,2,1,3,1,1,0,9
424576,476_15_45,CHINA,18858,15,qi zhou,13,0,2,0,0,2,0,0,0,0,2,2,100,1,5,6,0,1,3,0,2,2
424577,476_15_45,CHINA,0,TOTALS,CHINA,200,28,58,48.3,19,37,51.4,9,21,42.9,24,29,82.8,8,32,40,13,20,10,6,3,89
424578,476_15_45,QATAR,28374,4,abdelrahman yehia abdelhaleem,20,3,5,60,1,1,100,2,4,50,3,4,75,2,2,4,0,4,4,2,0,11
424579,476_15_45,QATAR,28375,5,clinton johnson,0,0,0,0,0,0,0,0,0,0,0,0,0,0,0,0,0,0,0,0,0,0
424580,476_15_45,QATAR,6826,6,saad abdulrahman ali,15,4,5,80,2,3,66.7,2,2,100,1,1,100,1,2,3,1,1,0,0,0,11
424581,476_15_45,QATAR,3860,7,daoud mousa daoud,12,0,0,0,0,0,0,0,0,0,0,0,0,0,1,1,0,1,0,0,0,0
424582,476_15_45,QATAR,6827,8,suliman abdi khalid,24,1,8,12.5,1,8,12.5,0,0,0,0,0,0,1,2,3,1,2,1,0,0,2
424583,476_15_45,QATAR,28376,9,mohamed hassan a mohamed,31,4,11,36.4,2,6,33.3,2,5,40,1,2,50,0,2,2,1,2,1,1,0,11
424584,476_15_45,QATAR,28377,10,abdulrahman mohamed saad,33,5,13,38.5,4,10,40,1,3,33.3,3,3,100,1,5,6,2,3,3,1,0,14
424585,476_15_45,QATAR,6830,11,ali saeed erfan,22,1,8,12.5,0,4,0,1,4,25,5,6,83.3,0,4,4,1,2,0,0,0,8
424586,476_15_45,QATAR,6831,12,mohammed saleem abdulla,11,1,4,25,0,2,0,1,2,50,0,0,0,0,1,1,0,3,0,0,0,3
424587,476_15_45,QATAR,23331,13,mohd mohamed,0,0,0,0,0,0,0,0,0,0,0,0,0,0,0,0,0,0,0,0,0,0
424588,476_15_45,QATAR,18646,14,abduallah shaher matalkeh,6,1,1,100,1,1,100,0,0,0,0,2,0,1,0,1,0,1,0,0,0,2
424589,476_15_45,QATAR,18645,15,khalid abdalla adam,27,0,4,0,0,4,0,0,0,0,3,6,50,2,3,5,0,3,3,1,0,3
424590,476_15_45,QATAR,0,TOTALS,QATAR,200,20,59,33.9,11,39,28.2,9,20,45,16,24,66.7,10,25,35,6,22,13,5,0,65
424591,476_15_46,KOREA,11667,1,taesul kim,22,5,7,71.4,4,5,80,1,2,50,0,0,0,0,1,1,1,1,2,2,0,11
424592,476_15_46,KOREA,28345,3,junghyun lee,15,2,6,33.3,1,1,100,1,5,20,0,0,0,0,2,2,2,2,1,1,0,5
424593,476_15_46,KOREA,16672,4,seonggon moon,10,1,4,25,0,1,0,1,3,33.3,0,0,0,0,1,1,2,2,0,0,0,3
424594,476_15_46,KOREA,22972,5,junyong choi,10,2,3,66.7,2,3,66.7,0,0,0,0,0,0,0,1,1,1,0,0,0,0,4
424595,476_15_46,KOREA,9631,6,donggeun yang,18,0,0,0,0,0,0,0,0,0,2,2,100,0,0,0,3,0,0,3,0,2
424596,476_15_46,KOREA,18640,7,chan hee park,1,0,0,0,0,0,0,0,0,0,0,0,0,0,0,0,0,0,0,0,0,0
424597,476_15_46,KOREA,18643,10,sungmin cho,20,3,9,33.3,2,3,66.7,1,6,16.7,2,2,100,0,2,2,1,1,0,2,0,9
424598,476_15_46,KOREA,22971,11,sangjae kang,20,1,3,33.3,1,3,33.3,0,0,0,2,2,100,1,1,2,0,2,2,0,0,4
424599,476_15_46,KOREA,18644,15,jongkyu kim,20,2,5,40,2,5,40,0,0,0,0,0,0,1,2,3,1,5,0,1,1,4
424600,476_15_46,KOREA,28346,22,taeyoung moon,24,7,9,77.8,7,9,77.8,0,0,0,2,2,100,0,2,2,1,2,0,3,0,16
424601,476_15_46,KOREA,14338,32,jonghyun lee,17,4,5,80,4,5,80,0,0,0,1,2,50,0,3,3,0,1,1,0,1,9
424602,476_15_46,KOREA,18395,33,seounghyun lee,23,5,6,83.3,4,5,80,1,1,100,1,1,100,1,3,4,4,3,4,2,0,12
424603,476_15_46,KOREA,0,TOTALS,KOREA,200,32,57,56.1,27,40,67.5,5,17,29.4,10,11,90.9,4,23,27,16,19,11,14,2,79
424604,476_15_46,KAZAKHSTAN,23366,4,timur sultanov,18,0,5,0,0,1,0,0,4,0,0,0,0,1,1,2,0,2,1,0,0,0
424605,476_15_46,KAZAKHSTAN,23367,5,jerry johnson,0,0,0,0,0,0,0,0,0,0,0,0,0,0,0,0,0,0,0,0,0,0
424606,476_15_46,KAZAKHSTAN,23368,6,rustam murzagaliyev,27,3,6,50,2,4,50,1,2,50,0,0,0,0,1,1,7,4,4,2,0,7
424607,476_15_46,KAZAKHSTAN,14353,7,maxim marchuk,18,1,4,25,1,3,33.3,0,1,0,0,0,0,0,2,2,0,1,3,0,0,2
424608,476_15_46,KAZAKHSTAN,28378,8,maxim smirnov,12,0,3,0,0,3,0,0,0,0,0,2,0,0,3,3,1,1,1,0,0,0
424609,476_15_46,KAZAKHSTAN,28379,9,anatoliy kolesnikov,0,0,0,0,0,0,0,0,0,0,0,0,0,0,0,0,0,0,0,0,0,0
424610,476_15_46,KAZAKHSTAN,13764,10,pavel ilin,23,1,5,20,1,2,50,0,3,0,0,0,0,0,2,2,1,1,3,0,0,2
424611,476_15_46,KAZAKHSTAN,3813,11,anton ponomarev,29,1,3,33.3,1,1,100,0,2,0,8,9,88.9,2,5,7,2,2,0,0,0,10
424612,476_15_46,KAZAKHSTAN,28380,12,dmitriy klimov,17,9,12,75,8,10,80,1,2,50,3,4,75,2,2,4,0,4,0,1,0,22
424613,476_15_46,KAZAKHSTAN,9605,13,rustam yargaliyev,32,3,6,50,2,4,50,1,2,50,2,2,100,1,1,2,0,0,3,1,0,9
424614,476_15_46,KAZAKHSTAN,9603,14,dmitriy gavrilov,0,0,0,0,0,0,0,0,0,0,0,0,0,0,0,0,0,0,0,0,0,0
424615,476_15_46,KAZAKHSTAN,13766,15,alexandr zhigulin,24,4,6,66.7,2,2,100,2,4,50,1,2,50,1,2,3,1,2,1,0,0,11
424616,476_15_46,KAZAKHSTAN,0,TOTALS,KAZAKHSTAN,200,22,50,44,17,30,56.7,5,20,25,14,19,73.7,7,22,29,12,17,20,4,0,63
424617,476_15_47,HONG KONG,28317,4,sheung ying so,9,2,2,100,0,0,0,2,2,100,0,0,0,0,1,1,2,1,0,0,0,6
424618,476_15_47,HONG KONG,28318,5,hoi to lau,15,2,2,100,2,2,100,0,0,0,0,0,0,2,0,2,1,4,1,0,0,4
424619,476_15_47,HONG KONG,28319,6,wai kong au-yeung,18,2,5,40,1,4,25,1,1,100,0,0,0,0,3,3,0,2,1,1,0,5
424620,476_15_47,HONG KONG,23387,7,ki lee,17,3,11,27.3,2,3,66.7,1,8,12.5,0,0,0,0,0,0,1,2,2,0,0,7
424621,476_15_47,HONG KONG,23388,8,siu wing chan,24,3,8,37.5,0,2,0,3,6,50,0,0,0,1,2,3,2,1,2,1,0,9
424622,476_15_47,HONG KONG,28320,9,shiu wah leung,10,0,1,0,0,0,0,0,1,0,0,0,0,0,0,0,2,4,3,1,0,0
424623,476_15_47,HONG KONG,28321,10,adam xu,19,0,1,0,0,1,0,0,0,0,0,0,0,0,4,4,3,0,3,0,1,0
424624,476_15_47,HONG KONG,3830,11,kam hing cheng,14,2,5,40,2,3,66.7,0,2,0,2,2,100,0,1,1,1,2,0,2,0,6
424625,476_15_47,HONG KONG,28322,12,ho chun lin,11,1,2,50,0,1,0,1,1,100,0,0,0,0,0,0,1,3,1,1,0,3
424626,476_15_47,HONG KONG,3834,13,chun wai wong,24,3,9,33.3,1,2,50,2,7,28.6,0,0,0,0,4,4,1,3,2,1,0,8
424627,476_15_47,HONG KONG,23391,14,duncan overbeck reid,31,7,15,46.7,7,15,46.7,0,0,0,0,0,0,4,9,13,2,2,2,0,0,14
424628,476_15_47,HONG KONG,3833,15,wai kit szeto,8,0,2,0,0,2,0,0,0,0,0,0,0,0,2,2,0,2,1,0,0,0
424629,476_15_47,HONG KONG,0,TOTALS,HONG KONG,200,25,63,39.7,15,35,42.9,10,28,35.7,2,2,100,8,28,36,16,26,19,7,1,62
424630,476_15_47,JORDAN,18616,0,mah'd n.j. abdeen,26,5,10,50,1,3,33.3,4,7,57.1,2,2,100,1,1,2,1,1,2,0,0,16
424631,476_15_47,JORDAN,14432,4,malek kanaan,6,2,3,66.7,1,1,100,1,2,50,2,5,40,0,0,0,2,0,0,0,0,7
424632,476_15_47,JORDAN,28347,6,alex legion,27,6,13,46.2,2,6,33.3,4,7,57.1,6,6,100,1,4,5,0,1,2,2,1,22
424633,476_15_47,JORDAN,23313,7,ahmad f.l. alhamarsheh,21,1,2,50,1,2,50,0,0,0,2,2,100,3,2,5,1,2,3,1,0,4
424634,476_15_47,JORDAN,23312,9,hani alfaraj,15,1,7,14.3,0,5,0,1,2,50,0,0,0,3,1,4,3,0,0,0,0,3
424635,476_15_47,JORDAN,9626,10,osama daghles,20,1,5,20,0,0,0,1,5,20,0,0,0,0,3,3,3,2,1,0,0,3
424636,476_15_47,JORDAN,16589,13,mohammad hussein,25,2,5,40,2,5,40,0,0,0,0,1,0,3,3,6,2,1,3,1,1,4
424637,476_15_47,JORDAN,28348,20,ahmad mahmoud obeid,11,2,3,66.7,2,3,66.7,0,0,0,0,0,0,0,3,3,0,0,1,0,0,4
424638,476_15_47,JORDAN,3885,21,zaid abbas,24,4,6,66.7,3,4,75,1,2,50,0,0,0,2,7,9,2,2,2,3,0,9
424639,476_15_47,JORDAN,9623,23,mousa alawadi,25,3,11,27.3,1,3,33.3,2,8,25,2,3,66.7,0,4,4,5,0,1,1,0,10
424640,476_15_47,JORDAN,9627,33,wesam al-sous,0,0,0,0,0,0,0,0,0,0,0,0,0,0,0,0,0,0,0,0,0,0
424641,476_15_47,JORDAN,16588,41,ali jamal zaghab,0,0,0,0,0,0,0,0,0,0,0,0,0,0,0,0,0,0,0,0,0,0
424642,476_15_47,JORDAN,0,TOTALS,JORDAN,200,27,65,41.5,13,32,40.6,14,33,42.4,14,19,73.7,13,29,42,19,9,15,8,2,82
424643,476_15_48,PALESTINE,28327,4,ahmed haroon,38,2,7,28.6,1,3,33.3,1,4,25,2,4,50,2,3,5,1,1,1,0,0,7
424644,476_15_48,PALESTINE,28328,5,shadi khatib,7,1,2,50,1,2,50,0,0,0,1,2,50,1,1,2,0,1,1,0,0,3
424645,476_15_48,PALESTINE,28329,6,jamal abu shamala,38,9,16,56.2,3,6,50,6,10,60,1,3,33.3,2,8,10,3,2,1,1,0,25
424646,476_15_48,PALESTINE,28330,7,ahmed younis,17,1,4,25,1,3,33.3,0,1,0,0,0,0,2,1,3,1,1,1,2,2,2
424647,476_15_48,PALESTINE,28331,8,jehad othman b. yaghmour,7,0,1,0,0,1,0,0,0,0,0,0,0,0,1,1,0,0,0,1,0,0
424648,476_15_48,PALESTINE,28332,9,amin salman,0,0,0,0,0,0,0,0,0,0,0,0,0,0,0,0,0,0,0,0,0,0
424649,476_15_48,PALESTINE,28333,10,imad qahwash,38,1,7,14.3,1,5,20,0,2,0,2,3,66.7,1,2,3,8,1,5,2,0,4
424650,476_15_48,PALESTINE,28334,11,enar odeh,0,0,0,0,0,0,0,0,0,0,0,0,0,0,0,0,0,0,0,0,0,0
424651,476_15_48,PALESTINE,28335,12,sami owda,7,1,4,25,1,4,25,0,0,0,0,0,0,2,0,2,0,1,3,2,0,2
424652,476_15_48,PALESTINE,28336,13,sani sakakini,38,12,28,42.9,12,26,46.2,0,2,0,8,13,61.5,10,8,18,4,3,4,1,0,32
424653,476_15_48,PALESTINE,28337,14,hamza yousef,9,0,0,0,0,0,0,0,0,0,0,0,0,0,1,1,0,0,3,0,0,0
424654,476_15_48,PALESTINE,28338,15,salim sakakini,26,4,9,44.4,4,9,44.4,0,0,0,0,0,0,2,5,7,1,2,1,0,0,8
424655,476_15_48,PALESTINE,0,TOTALS,PALESTINE,225,31,78,39.7,24,59,40.7,7,19,36.8,14,25,56,22,31,53,18,12,20,9,2,83
424656,476_15_48,KAZAKHSTAN,23366,4,timur sultanov,1,0,0,0,0,0,0,0,0,0,0,0,0,0,0,0,0,0,0,0,0,0
424657,476_15_48,KAZAKHSTAN,23367,5,jerry johnson,24,4,9,44.4,4,5,80,0,4,0,0,0,0,1,2,3,2,3,4,0,0,8
424658,476_15_48,KAZAKHSTAN,23368,6,rustam murzagaliyev,29,6,11,54.5,2,5,40,4,6,66.7,0,0,0,0,2,2,1,5,2,3,0,16
424659,476_15_48,KAZAKHSTAN,14353,7,maxim marchuk,5,0,0,0,0,0,0,0,0,0,0,0,0,0,2,2,0,0,0,0,0,0
424660,476_15_48,KAZAKHSTAN,28378,8,maxim smirnov,11,0,1,0,0,0,0,0,1,0,1,2,50,0,1,1,1,5,2,0,0,1
424661,476_15_48,KAZAKHSTAN,28379,9,anatoliy kolesnikov,0,0,0,0,0,0,0,0,0,0,0,0,0,0,0,0,0,0,0,0,0,0
424662,476_15_48,KAZAKHSTAN,13764,10,pavel ilin,38,6,18,33.3,6,12,50,0,6,0,0,0,0,4,3,7,2,1,2,1,1,12
424663,476_15_48,KAZAKHSTAN,3813,11,anton ponomarev,15,0,7,0,0,3,0,0,4,0,0,0,0,2,3,5,2,5,1,0,0,0
424664,476_15_48,KAZAKHSTAN,28380,12,dmitriy klimov,23,3,8,37.5,2,6,33.3,1,2,50,0,0,0,3,5,8,1,2,1,1,0,7
424665,476_15_48,KAZAKHSTAN,9605,13,rustam yargaliyev,45,10,16,62.5,5,7,71.4,5,9,55.6,1,1,100,0,2,2,2,1,2,2,0,26
424666,476_15_48,KAZAKHSTAN,9603,14,dmitriy gavrilov,0,0,0,0,0,0,0,0,0,0,0,0,0,0,0,0,0,0,0,0,0,0
424667,476_15_48,KAZAKHSTAN,13766,15,alexandr zhigulin,33,5,9,55.6,4,5,80,1,4,25,0,0,0,2,8,10,3,5,4,1,2,11
424668,476_15_48,KAZAKHSTAN,0,TOTALS,KAZAKHSTAN,225,34,79,43,23,43,53.5,11,36,30.6,2,3,66.7,14,31,45,14,28,20,8,3,81
424669,476_15_49,IRAN,14400,4,sajjad mashayekhi,13,1,4,25,1,3,33.3,0,1,0,0,0,0,1,1,2,4,2,1,0,0,2
424670,476_15_49,IRAN,22994,5,behnam yakhchalidehkordi,6,1,2,50,1,1,100,0,1,0,0,0,0,1,2,3,0,1,0,0,0,2
424671,476_15_49,IRAN,9684,6,javad davari,19,3,6,50,3,6,50,0,0,0,2,2,100,2,3,5,1,2,0,0,0,8
424672,476_15_49,IRAN,9685,7,mahdi kamrani,25,1,6,16.7,0,4,0,1,2,50,1,2,50,1,1,2,5,3,2,5,0,4
424673,476_15_49,IRAN,28339,8,saeid karekani,21,3,6,50,2,5,40,1,1,100,2,2,100,1,0,1,0,0,1,1,0,9
424674,476_15_49,IRAN,13743,9,mohammad hassanzadeh saberi a,17,1,2,50,1,1,100,0,1,0,2,4,50,4,1,5,0,3,1,0,0,4
424675,476_15_49,IRAN,9688,10,hamed afagh,19,4,9,44.4,1,3,33.3,3,6,50,0,0,0,0,1,1,1,1,0,1,0,11
424676,476_15_49,IRAN,9690,11,oshin sahakian,24,6,8,75,6,8,75,0,0,0,0,0,0,1,6,7,1,4,1,1,1,12
424677,476_15_49,IRAN,28340,12,asghar kardoustpoustinsaraei,5,0,2,0,0,2,0,0,0,0,0,0,0,0,0,0,0,2,1,0,0,0
424678,476_15_49,IRAN,13739,13,mohammad jamshidijafarabadi,5,0,1,0,0,0,0,0,1,0,0,0,0,0,1,1,0,0,1,0,0,0
424679,476_15_49,IRAN,11627,14,mohammadsamad nik,20,2,6,33.3,1,4,25,1,2,50,0,0,0,1,1,2,0,2,2,1,0,5
424680,476_15_49,IRAN,9693,15,hamed ehadadi,26,8,13,61.5,8,13,61.5,0,0,0,2,6,33.3,6,8,14,3,1,3,0,0,18
424681,476_15_49,IRAN,0,TOTALS,IRAN,200,30,65,46.2,24,50,48,6,15,40,9,16,56.2,19,25,44,15,21,14,9,1,75
424682,476_15_49,KOREA,11667,1,taesul kim,20,1,2,50,1,2,50,0,0,0,1,2,50,0,2,2,3,1,1,0,0,3
424683,476_15_49,KOREA,28345,3,junghyun lee,9,1,5,20,1,3,33.3,0,2,0,0,0,0,1,0,1,3,2,1,0,0,2
424684,476_15_49,KOREA,16672,4,seonggon moon,3,0,0,0,0,0,0,0,0,0,0,0,0,0,0,0,0,0,0,0,0,0
424685,476_15_49,KOREA,22972,5,junyong choi,15,3,5,60,3,4,75,0,1,0,1,2,50,0,1,1,1,5,0,1,1,7
424686,476_15_49,KOREA,9631,6,donggeun yang,20,3,9,33.3,3,6,50,0,3,0,0,0,0,0,1,1,3,1,2,1,0,6
424687,476_15_49,KOREA,18640,7,chan hee park,0,0,0,0,0,0,0,0,0,0,0,0,0,0,0,0,0,0,0,0,0,0
424688,476_15_49,KOREA,18643,10,sungmin cho,31,2,5,40,0,1,0,2,4,50,2,2,100,0,1,1,2,1,2,4,0,8
424689,476_15_49,KOREA,22971,11,sangjae kang,22,2,3,66.7,2,3,66.7,0,0,0,4,4,100,1,1,2,1,2,1,0,0,8
424690,476_15_49,KOREA,18644,15,jongkyu kim,23,4,7,57.1,4,7,57.1,0,0,0,2,2,100,0,4,4,0,1,1,1,0,10
424691,476_15_49,KOREA,28346,22,taeyoung moon,22,2,3,66.7,2,2,100,0,1,0,6,6,100,0,5,5,1,3,2,1,0,10
424692,476_15_49,KOREA,14338,32,jonghyun lee,22,3,8,37.5,3,8,37.5,0,0,0,0,0,0,0,2,2,0,1,0,0,3,6
424693,476_15_49,KOREA,18395,33,seounghyun lee,13,1,3,33.3,1,1,100,0,2,0,0,0,0,1,2,3,1,1,0,0,1,2
424694,476_15_49,KOREA,0,TOTALS,KOREA,200,22,50,44,20,37,54.1,2,13,15.4,16,18,88.9,4,20,24,15,18,12,8,5,62
424695,476_15_50,JAPAN,28341,0,yuta tabuse,37,4,5,80,3,4,75,1,1,100,3,4,75,1,2,3,6,2,3,0,0,12
424696,476_15_50,JAPAN,23322,6,makoto hiejima,38,6,17,35.3,6,14,42.9,0,3,0,5,6,83.3,1,5,6,4,2,1,4,1,17
424697,476_15_50,JAPAN,18625,8,atsuya ota,23,3,3,100,3,3,100,0,0,0,1,3,33.3,1,1,2,0,3,0,1,1,7
424698,476_15_50,JAPAN,28342,10,ryoma hashimoto,0,0,0,0,0,0,0,0,0,0,0,0,0,0,0,0,0,0,0,0,0,0
424699,476_15_50,JAPAN,3875,15,joji takeuchi,33,5,10,50,5,10,50,0,0,0,5,8,62.5,1,7,8,2,4,2,0,0,15
424700,476_15_50,JAPAN,18621,16,keijuro matsui,5,0,2,0,0,0,0,0,2,0,0,0,0,0,0,0,0,0,0,0,0,0
424701,476_15_50,JAPAN,28343,17,gaku arao,10,0,0,0,0,0,0,0,0,0,0,0,0,0,1,1,0,5,0,1,0,0
424702,476_15_50,JAPAN,23321,24,daiki tanaka,2,1,2,50,1,2,50,0,0,0,0,0,0,0,1,1,0,0,0,0,0,2
424703,476_15_50,JAPAN,28344,25,takatoshi furukawa,31,7,13,53.8,3,4,75,4,9,44.4,4,4,100,0,5,5,0,3,1,1,0,22
424704,476_15_50,JAPAN,25620,34,ryumo ono,14,0,3,0,0,2,0,0,1,0,1,2,50,2,3,5,0,0,2,0,0,1
424705,476_15_50,JAPAN,18623,42,kenta hirose,7,1,1,100,0,0,0,1,1,100,2,2,100,0,0,0,0,0,1,1,0,5
424706,476_15_50,JAPAN,0,TOTALS,JAPAN,200,27,56,48.2,21,39,53.8,6,17,35.3,21,29,72.4,9,25,34,12,19,10,8,2,81
424707,476_15_50,QATAR,28374,4,abdelrahman yehia abdelhaleem,0,0,0,0,0,0,0,0,0,0,0,0,0,0,0,0,0,0,0,0,0,0
424708,476_15_50,QATAR,28375,5,clinton johnson,36,5,11,45.5,5,9,55.6,0,2,0,6,6,100,0,2,2,1,2,3,0,0,16
424709,476_15_50,QATAR,6826,6,saad abdulrahman ali,15,1,6,16.7,0,1,0,1,5,20,0,0,0,1,1,2,1,3,1,0,0,3
424710,476_15_50,QATAR,3860,7,daoud mousa daoud,16,1,3,33.3,1,2,50,0,1,0,0,0,0,1,0,1,2,3,0,0,0,2
424711,476_15_50,QATAR,6827,8,suliman abdi khalid,22,2,7,28.6,2,3,66.7,0,4,0,0,0,0,0,0,0,1,2,1,0,0,4
424712,476_15_50,QATAR,28376,9,mohamed hassan a mohamed,20,4,10,40,0,1,0,4,9,44.4,1,1,100,2,2,4,0,1,2,2,0,13
424713,476_15_50,QATAR,28377,10,abdulrahman mohamed saad,26,1,4,25,0,1,0,1,3,33.3,0,0,0,1,6,7,1,5,2,1,0,3
424714,476_15_50,QATAR,6830,11,ali saeed erfan,24,2,4,50,2,3,66.7,0,1,0,6,10,60,2,4,6,1,4,3,1,0,10
424715,476_15_50,QATAR,6831,12,mohammed saleem abdulla,6,1,2,50,1,2,50,0,0,0,1,2,50,0,0,0,0,0,0,0,0,3
424716,476_15_50,QATAR,23331,13,mohd mohamed,32,6,9,66.7,6,9,66.7,0,0,0,0,1,0,1,7,8,7,2,1,2,0,12
424717,476_15_50,QATAR,18646,14,abduallah shaher matalkeh,0,0,0,0,0,0,0,0,0,0,0,0,0,0,0,0,0,0,0,0,0,0
424718,476_15_50,QATAR,18645,15,khalid abdalla adam,4,0,0,0,0,0,0,0,0,0,1,2,50,1,1,2,0,0,0,0,0,1
424719,476_15_50,QATAR,0,TOTALS,QATAR,200,23,56,41.1,17,31,54.8,6,25,24,15,22,68.2,12,24,36,14,22,14,6,0,67
424720,476_15_51,INDIA,23335,3,vinay kaushik,16,1,2,50,1,1,100,0,1,0,0,0,0,0,0,0,0,1,1,0,0,2
424721,476_15_51,INDIA,28354,4,rajesh prakash uppar,1,0,0,0,0,0,0,0,0,0,0,0,0,0,0,0,0,0,1,0,0,0
424722,476_15_51,INDIA,28355,7,siddhant sanjay shinde,2,1,2,50,0,0,0,1,2,50,0,0,0,1,0,1,0,1,0,0,0,3
424723,476_15_51,INDIA,14219,9,vishesh bhriguvanshi,40,8,15,53.3,5,8,62.5,3,7,42.9,3,4,75,0,3,3,5,3,3,0,0,22
424724,476_15_51,INDIA,18673,10,amritpal singh ,30,2,11,18.2,2,11,18.2,0,0,0,1,2,50,2,2,4,0,5,2,2,0,5
424725,476_15_51,INDIA,28356,13,vikas kumar ,0,0,0,0,0,0,0,0,0,0,0,0,0,0,0,0,0,0,0,0,0,0
424726,476_15_51,INDIA,18675,14,yadwinder singh,35,7,13,53.8,6,10,60,1,3,33.3,1,2,50,1,4,5,1,2,2,2,1,16
424727,476_15_51,INDIA,28357,15,arvind arumugam,15,0,1,0,0,1,0,0,0,0,1,2,50,2,2,4,1,3,2,1,0,1
424728,476_15_51,INDIA,18670,22,amjyot singh ,37,2,13,15.4,2,8,25,0,5,0,1,2,50,3,4,7,2,3,6,1,1,5
424729,476_15_51,INDIA,25645,66,akilan pari,21,2,4,50,2,3,66.7,0,1,0,0,0,0,0,0,0,1,2,4,0,0,4
424730,476_15_51,INDIA,28358,69,akashdeep hazra,0,0,0,0,0,0,0,0,0,0,0,0,0,0,0,0,0,0,0,0,0,0
424731,476_15_51,INDIA,28359,96,gurvinder singh gill,4,0,0,0,0,0,0,0,0,0,0,0,0,0,0,0,0,0,0,0,0,0
424732,476_15_51,INDIA,0,TOTALS,INDIA,200,23,61,37.7,18,42,42.9,5,19,26.3,7,12,58.3,9,21,30,10,20,21,6,2,58
424733,476_15_51,CHINA,18850,4,ji wei zhao,18,3,6,50,3,5,60,0,1,0,1,1,100,2,3,5,3,2,2,2,0,7
424734,476_15_51,CHINA,50,5,wei liu,13,0,3,0,0,3,0,0,0,0,0,0,0,0,0,0,2,3,0,0,0,0
424735,476_15_51,CHINA,14374,6,ailun guo,21,3,7,42.9,2,5,40,1,2,50,4,6,66.7,1,3,4,5,0,1,2,0,11
424736,476_15_51,CHINA,28363,7,tailong zhao,10,1,2,50,0,1,0,1,1,100,0,0,0,0,0,0,1,1,1,0,0,3
424737,476_15_51,CHINA,14377,8,yanyuhang ding,22,1,4,25,0,1,0,1,3,33.3,0,0,0,0,2,2,4,0,0,2,0,3
424738,476_15_51,CHINA,14378,9,xiaochuan zhai,25,6,7,85.7,3,4,75,3,3,100,0,0,0,1,4,5,4,3,1,1,0,15
424739,476_15_51,CHINA,16587,10,peng zhou,13,5,8,62.5,2,2,100,3,6,50,0,0,0,0,2,2,2,1,1,2,1,13
424740,476_15_51,CHINA,56,11,jianlian yi,23,8,12,66.7,8,11,72.7,0,1,0,5,5,100,0,7,7,3,2,1,0,1,21
424741,476_15_51,CHINA,28364,12,gen li,16,3,8,37.5,1,2,50,2,6,33.3,0,0,0,0,3,3,2,0,0,0,0,8
424742,476_15_51,CHINA,18361,13,muhao li,10,1,1,100,1,1,100,0,0,0,4,5,80,0,1,1,0,1,1,0,0,6
424743,476_15_51,CHINA,16635,14,zhelin wang,15,3,6,50,3,6,50,0,0,0,3,4,75,2,2,4,0,3,2,0,1,9
424744,476_15_51,CHINA,18858,15,qi zhou,14,4,4,100,4,4,100,0,0,0,0,0,0,1,1,2,0,2,3,0,2,8
424745,476_15_51,CHINA,0,TOTALS,CHINA,200,38,68,55.9,27,45,60,11,23,47.8,17,21,81,7,30,37,26,18,14,9,5,104
424746,476_15_52,PHILIPPINES,25433,1,andray blatche,33,8,14,57.1,7,12,58.3,1,2,50,7,9,77.8,4,13,17,3,2,3,0,2,24
424747,476_15_52,PHILIPPINES,9700,5,gabriel norwood,33,2,7,28.6,1,2,50,1,5,20,0,0,0,0,2,2,0,3,0,2,0,5
424748,476_15_52,PHILIPPINES,23361,7,jayson william,31,10,17,58.8,5,7,71.4,5,10,50,0,0,0,1,2,3,1,3,2,2,0,25
424749,476_15_52,PHILIPPINES,28323,8,calvin abueva,16,3,8,37.5,2,6,33.3,1,2,50,0,0,0,1,4,5,0,3,1,2,0,7
424750,476_15_52,PHILIPPINES,28324,9,john intal,0,0,0,0,0,0,0,0,0,0,0,0,0,0,0,0,0,0,0,0,0,0
424751,476_15_52,PHILIPPINES,28325,11,terrence romeo,20,4,14,28.6,3,8,37.5,1,6,16.7,1,1,100,1,1,2,0,0,1,1,0,10
424752,476_15_52,PHILIPPINES,23365,15,jean marc pingris,18,4,5,80,4,5,80,0,0,0,0,0,0,3,1,4,0,3,1,1,0,8
424753,476_15_52,PHILIPPINES,28326,22,matthew ganuelas,10,0,0,0,0,0,0,0,0,0,0,0,0,0,1,1,2,2,0,0,0,0
424754,476_15_52,PHILIPPINES,14183,23,joachim gunther thoss,6,0,2,0,0,2,0,0,0,0,0,0,0,1,0,1,0,0,1,0,0,0
424755,476_15_52,PHILIPPINES,9697,25,donaldo hontiveros,10,0,1,0,0,0,0,0,1,0,0,0,0,1,1,2,2,3,0,0,0,0
424756,476_15_52,PHILIPPINES,18657,33,ranidel de ocampo,22,1,7,14.3,1,3,33.3,0,4,0,1,2,50,2,1,3,0,3,0,1,0,3
424757,476_15_52,PHILIPPINES,9698,88,pauliasi taulava,0,0,0,0,0,0,0,0,0,0,0,0,0,0,0,0,0,0,0,0,0,0
424758,476_15_52,PHILIPPINES,0,TOTALS,PHILIPPINES,200,32,75,42.7,23,45,51.1,9,30,30,9,12,75,18,26,44,8,22,9,9,2,82
424759,476_15_52,LEBANON,6780,4,jean abd el nour,34,2,8,25,2,6,33.3,0,2,0,4,5,80,2,2,4,0,1,1,0,0,8
424760,476_15_52,LEBANON,28366,5,amir saoud,26,2,7,28.6,1,2,50,1,5,20,2,2,100,0,2,2,2,0,2,0,0,7
424761,476_15_52,LEBANON,28367,6,mohamad ali haidar,35,8,14,57.1,7,9,77.8,1,5,20,1,5,20,4,5,9,0,2,1,0,1,18
424762,476_15_52,LEBANON,28368,7,wael arakji,27,3,5,60,2,3,66.7,1,2,50,1,2,50,1,1,2,2,2,3,0,0,8
424763,476_15_52,LEBANON,28369,8,joseph aby kheres,0,0,0,0,0,0,0,0,0,0,0,0,0,0,0,0,0,0,0,0,0,0
424764,476_15_52,LEBANON,28370,9,ahmad ibrahim,0,0,0,0,0,0,0,0,0,0,0,0,0,0,0,0,0,0,0,0,0,0
424765,476_15_52,LEBANON,28371,10,nadim souaid,0,0,0,0,0,0,0,0,0,0,0,0,0,0,0,0,0,0,0,0,0,0
424766,476_15_52,LEBANON,8977,11,rodrigue akl,11,0,1,0,0,0,0,0,1,0,0,0,0,0,0,0,1,2,0,0,0,0
424767,476_15_52,LEBANON,18668,12,charles tabet,0,0,0,0,0,0,0,0,0,0,0,0,0,0,0,0,0,0,0,0,0,0
424768,476_15_52,LEBANON,18667,13,bassel bawji,30,7,17,41.2,5,14,35.7,2,3,66.7,1,1,100,6,7,13,0,3,3,1,1,17
424769,476_15_52,LEBANON,28372,14,jasmon jovan youngblood,38,5,15,33.3,4,9,44.4,1,6,16.7,1,3,33.3,1,5,6,5,3,3,2,1,12
424770,476_15_52,LEBANON,28373,15,omar el ayoubi,0,0,0,0,0,0,0,0,0,0,0,0,0,0,0,0,0,0,0,0,0,0
424771,476_15_52,LEBANON,0,TOTALS,LEBANON,200,27,67,40.3,21,43,48.8,6,24,25,10,18,55.6,17,23,40,10,13,13,3,3,70
424772,476_15_53,HONG KONG,28317,4,sheung ying so,3,0,0,0,0,0,0,0,0,0,0,0,0,0,1,1,0,0,1,0,0,0
424773,476_15_53,HONG KONG,28318,5,hoi to lau,10,0,1,0,0,1,0,0,0,0,0,0,0,0,0,0,0,2,0,1,2,0
424774,476_15_53,HONG KONG,28319,6,wai kong au-yeung,20,1,3,33.3,0,2,0,1,1,100,3,4,75,1,5,6,1,1,0,0,0,6
424775,476_15_53,HONG KONG,23387,7,ki lee,23,4,12,33.3,1,3,33.3,3,9,33.3,2,2,100,0,4,4,2,3,4,1,0,13
424776,476_15_53,HONG KONG,23388,8,siu wing chan,31,1,7,14.3,1,4,25,0,3,0,0,0,0,1,1,2,4,3,1,1,0,2
424777,476_15_53,HONG KONG,28320,9,shiu wah leung,8,0,0,0,0,0,0,0,0,0,0,0,0,0,2,2,1,0,1,0,0,0
424778,476_15_53,HONG KONG,28321,10,adam xu,22,1,3,33.3,1,2,50,0,1,0,0,0,0,0,1,1,2,4,1,2,0,2
424779,476_15_53,HONG KONG,3830,11,kam hing cheng,5,0,0,0,0,0,0,0,0,0,0,0,0,0,1,1,0,2,0,1,0,0
424780,476_15_53,HONG KONG,28322,12,ho chun lin,8,0,0,0,0,0,0,0,0,0,2,2,100,0,0,0,1,1,0,0,0,2
424781,476_15_53,HONG KONG,3834,13,chun wai wong,31,7,18,38.9,4,8,50,3,10,30,6,7,85.7,3,3,6,0,3,0,3,0,23
424782,476_15_53,HONG KONG,23391,14,duncan overbeck reid,32,6,20,30,6,20,30,0,0,0,2,2,100,2,5,7,1,3,4,1,2,14
424783,476_15_53,HONG KONG,3833,15,wai kit szeto,7,0,0,0,0,0,0,0,0,0,0,0,0,0,0,0,0,2,1,0,0,0
424784,476_15_53,HONG KONG,0,TOTALS,HONG KONG,200,20,64,31.2,13,40,32.5,7,24,29.2,15,17,88.2,10,26,36,12,24,15,10,4,62
424785,476_15_53,KAZAKHSTAN,23366,4,timur sultanov,16,0,3,0,0,1,0,0,2,0,0,0,0,0,4,4,0,1,0,2,0,0
424786,476_15_53,KAZAKHSTAN,23367,5,jerry johnson,0,0,0,0,0,0,0,0,0,0,0,0,0,0,0,0,0,0,0,0,0,0
424787,476_15_53,KAZAKHSTAN,23368,6,rustam murzagaliyev,24,2,4,50,2,4,50,0,0,0,2,4,50,0,2,2,1,4,1,1,0,6
424788,476_15_53,KAZAKHSTAN,14353,7,maxim marchuk,1,0,0,0,0,0,0,0,0,0,0,0,0,0,0,0,0,0,0,0,0,0
424789,476_15_53,KAZAKHSTAN,28378,8,maxim smirnov,0,0,0,0,0,0,0,0,0,0,0,0,0,0,0,0,0,0,0,0,0,0
424790,476_15_53,KAZAKHSTAN,28379,9,anatoliy kolesnikov,24,3,5,60,3,5,60,0,0,0,5,5,100,1,8,9,1,1,3,1,0,11
424791,476_15_53,KAZAKHSTAN,13764,10,pavel ilin,32,11,17,64.7,11,14,78.6,0,3,0,7,9,77.8,1,2,3,0,2,2,1,0,29
424792,476_15_53,KAZAKHSTAN,3813,11,anton ponomarev,30,2,12,16.7,2,10,20,0,2,0,3,4,75,5,6,11,2,2,2,1,2,7
424793,476_15_53,KAZAKHSTAN,28380,12,dmitriy klimov,19,3,6,50,2,2,100,1,4,25,3,6,50,0,8,8,1,5,3,1,0,10
424794,476_15_53,KAZAKHSTAN,9605,13,rustam yargaliyev,32,1,5,20,1,4,25,0,1,0,1,2,50,1,3,4,0,1,5,1,0,3
424795,476_15_53,KAZAKHSTAN,9603,14,dmitriy gavrilov,0,0,0,0,0,0,0,0,0,0,0,0,0,0,0,0,0,0,0,0,0,0
424796,476_15_53,KAZAKHSTAN,13766,15,alexandr zhigulin,23,1,2,50,1,2,50,0,0,0,0,0,0,0,0,0,1,4,2,0,0,2
424797,476_15_53,KAZAKHSTAN,0,TOTALS,KAZAKHSTAN,200,23,54,42.6,22,42,52.4,1,12,8.3,21,30,70,8,33,41,6,20,18,8,2,68
424798,476_15_54,JORDAN,18616,0,mah'd n.j. abdeen,0,0,0,0,0,0,0,0,0,0,0,0,0,0,0,0,0,0,0,0,0,0
424799,476_15_54,JORDAN,14432,4,malek kanaan,0,0,0,0,0,0,0,0,0,0,0,0,0,0,0,0,0,0,0,0,0,0
424800,476_15_54,JORDAN,28347,6,alex legion,32,5,16,31.2,3,10,30,2,6,33.3,1,1,100,3,5,8,5,3,0,2,0,13
424801,476_15_54,JORDAN,23313,7,ahmad f.l. alhamarsheh,17,0,4,0,0,2,0,0,2,0,2,2,100,1,4,5,1,2,0,1,1,2
424802,476_15_54,JORDAN,23312,9,hani alfaraj,17,0,3,0,0,1,0,0,2,0,0,0,0,0,1,1,1,0,1,1,0,0
424803,476_15_54,JORDAN,9626,10,osama daghles,27,4,7,57.1,1,3,33.3,3,4,75,0,0,0,0,2,2,3,0,2,3,0,11
424804,476_15_54,JORDAN,16589,13,mohammad hussein,35,12,18,66.7,12,18,66.7,0,0,0,2,4,50,3,6,9,1,4,1,1,1,26
424805,476_15_54,JORDAN,28348,20,ahmad mahmoud obeid,0,0,0,0,0,0,0,0,0,0,0,0,0,0,0,0,0,0,0,0,0,0
424806,476_15_54,JORDAN,3885,21,zaid abbas,28,5,15,33.3,5,9,55.6,0,6,0,6,10,60,4,8,12,5,2,2,3,1,16
424807,476_15_54,JORDAN,9623,23,mousa alawadi,22,3,7,42.9,2,3,66.7,1,4,25,2,3,66.7,1,0,1,1,4,0,0,0,9
424808,476_15_54,JORDAN,9627,33,wesam al-sous,22,6,13,46.2,1,3,33.3,5,10,50,0,0,0,1,1,2,2,2,0,2,0,17
424809,476_15_54,JORDAN,16588,41,ali jamal zaghab,0,0,0,0,0,0,0,0,0,0,0,0,0,0,0,0,0,0,0,0,0,0
424810,476_15_54,JORDAN,0,TOTALS,JORDAN,200,35,83,42.2,24,49,49,11,34,32.4,13,20,65,16,29,45,19,17,6,13,3,94
424811,476_15_54,PALESTINE,28327,4,ahmed haroon,33,2,5,40,1,3,33.3,1,2,50,4,4,100,1,5,6,0,0,0,0,0,9
424812,476_15_54,PALESTINE,28328,5,shadi khatib,6,0,2,0,0,2,0,0,0,0,0,0,0,0,0,0,1,2,0,0,0,0
424813,476_15_54,PALESTINE,28329,6,jamal abu shamala,34,9,20,45,5,10,50,4,10,40,2,2,100,2,7,9,1,2,0,0,0,24
424814,476_15_54,PALESTINE,28330,7,ahmed younis,20,2,7,28.6,1,5,20,1,2,50,2,2,100,2,4,6,1,3,2,0,0,7
424815,476_15_54,PALESTINE,28331,8,jehad othman b. yaghmour,7,0,0,0,0,0,0,0,0,0,0,0,0,0,3,3,0,0,1,0,0,0
424816,476_15_54,PALESTINE,28332,9,amin salman,0,0,0,0,0,0,0,0,0,0,0,0,0,0,0,0,0,0,0,0,0,0
424817,476_15_54,PALESTINE,28333,10,imad qahwash,32,5,12,41.7,4,10,40,1,2,50,2,2,100,1,6,7,5,4,9,3,0,13
424818,476_15_54,PALESTINE,28334,11,enar odeh,0,0,0,0,0,0,0,0,0,0,0,0,0,0,0,0,0,0,0,0,0,0
424819,476_15_54,PALESTINE,28335,12,sami owda,8,2,5,40,1,3,33.3,1,2,50,0,0,0,1,1,2,0,1,0,0,0,5
424820,476_15_54,PALESTINE,28336,13,sani sakakini,34,8,17,47.1,6,11,54.5,2,6,33.3,0,1,0,4,6,10,2,3,0,0,0,18
424821,476_15_54,PALESTINE,28337,14,hamza yousef,15,0,1,0,0,1,0,0,0,0,0,0,0,0,2,2,0,1,2,0,0,0
424822,476_15_54,PALESTINE,28338,15,salim sakakini,11,3,4,75,3,4,75,0,0,0,0,0,0,1,0,1,0,1,2,0,0,6
424823,476_15_54,PALESTINE,0,TOTALS,PALESTINE,200,31,73,42.5,21,49,42.9,10,24,41.7,10,11,90.9,13,36,49,10,17,16,3,0,82
424824,476_15_55,INDIA,23335,3,vinay kaushik,17,0,4,0,0,1,0,0,3,0,0,0,0,0,1,1,0,1,1,0,0,0
424825,476_15_55,INDIA,28354,4,rajesh prakash uppar,19,1,4,25,1,2,50,0,2,0,0,0,0,0,1,1,2,0,1,0,0,2
424826,476_15_55,INDIA,28355,7,siddhant sanjay shinde,11,0,1,0,0,0,0,0,1,0,0,0,0,0,2,2,1,0,3,0,0,0
424827,476_15_55,INDIA,14219,9,vishesh bhriguvanshi,15,2,6,33.3,2,4,50,0,2,0,1,1,100,0,1,1,2,1,0,0,0,5
424828,476_15_55,INDIA,18673,10,amritpal singh ,30,8,12,66.7,8,12,66.7,0,0,0,2,4,50,1,5,6,1,3,2,0,0,18
424829,476_15_55,INDIA,28356,13,vikas kumar ,8,3,4,75,3,3,100,0,1,0,0,0,0,0,0,0,0,0,0,0,0,6
424830,476_15_55,INDIA,18675,14,yadwinder singh,0,0,0,0,0,0,0,0,0,0,0,0,0,0,0,0,0,0,0,0,0,0
424831,476_15_55,INDIA,28357,15,arvind arumugam,25,2,5,40,2,4,50,0,1,0,0,0,0,0,2,2,0,5,3,1,0,4
424832,476_15_55,INDIA,18670,22,amjyot singh ,40,9,17,52.9,5,8,62.5,4,9,44.4,2,2,100,0,6,6,3,3,9,0,0,24
424833,476_15_55,INDIA,25645,66,akilan pari,17,3,4,75,2,2,100,1,2,50,0,0,0,2,1,3,0,2,0,0,0,7
424834,476_15_55,INDIA,28358,69,akashdeep hazra,0,0,0,0,0,0,0,0,0,0,0,0,0,0,0,0,0,0,0,0,0,0
424835,476_15_55,INDIA,28359,96,gurvinder singh gill,18,2,4,50,2,4,50,0,0,0,2,4,50,1,1,2,0,1,2,1,0,6
424836,476_15_55,INDIA,0,TOTALS,INDIA,200,30,61,49.2,25,40,62.5,5,21,23.8,7,11,63.6,5,21,26,9,16,22,2,0,72
424837,476_15_55,KOREA,11667,1,taesul kim,28,5,8,62.5,4,6,66.7,1,2,50,0,0,0,1,2,3,12,2,1,3,0,11
424838,476_15_55,KOREA,28345,3,junghyun lee,24,6,10,60,4,5,80,2,5,40,0,0,0,1,1,2,5,0,2,2,0,14
424839,476_15_55,KOREA,16672,4,seonggon moon,14,1,8,12.5,0,3,0,1,5,20,0,0,0,0,1,1,1,0,0,2,0,3
424840,476_15_55,KOREA,22972,5,junyong choi,30,3,4,75,1,1,100,2,3,66.7,3,5,60,1,8,9,9,2,2,4,0,11
424841,476_15_55,KOREA,9631,6,donggeun yang,0,0,0,0,0,0,0,0,0,0,0,0,0,0,0,0,0,0,0,0,0,0
424842,476_15_55,KOREA,18640,7,chan hee park,0,0,0,0,0,0,0,0,0,0,0,0,0,0,0,0,0,0,0,0,0,0
424843,476_15_55,KOREA,18643,10,sungmin cho,16,6,9,66.7,2,2,100,4,7,57.1,0,0,0,1,0,1,1,1,0,0,0,16
424844,476_15_55,KOREA,22971,11,sangjae kang,18,7,12,58.3,7,11,63.6,0,1,0,0,0,0,1,2,3,0,2,1,0,0,14
424845,476_15_55,KOREA,18644,15,jongkyu kim,30,5,9,55.6,5,9,55.6,0,0,0,4,7,57.1,5,5,10,0,1,3,2,0,14
424846,476_15_55,KOREA,28346,22,taeyoung moon,20,10,11,90.9,10,11,90.9,0,0,0,2,2,100,1,3,4,2,1,0,1,0,22
424847,476_15_55,KOREA,14338,32,jonghyun lee,20,5,7,71.4,5,7,71.4,0,0,0,2,3,66.7,2,4,6,3,2,1,2,1,12
424848,476_15_55,KOREA,18395,33,seounghyun lee,0,0,0,0,0,0,0,0,0,0,0,0,0,0,0,0,0,0,0,0,0,0
424849,476_15_55,KOREA,0,TOTALS,KOREA,200,48,78,61.5,38,55,69.1,10,23,43.5,11,17,64.7,13,28,41,33,11,10,16,1,117
424850,476_15_56,QATAR,28374,4,abdelrahman yehia abdelhaleem,16,3,5,60,1,2,50,2,3,66.7,0,0,0,1,1,2,0,5,0,0,0,8
424851,476_15_56,QATAR,28375,5,clinton johnson,38,9,18,50,8,17,47.1,1,1,100,10,12,83.3,3,7,10,6,2,2,1,0,29
424852,476_15_56,QATAR,6826,6,saad abdulrahman ali,0,0,0,0,0,0,0,0,0,0,0,0,0,0,0,0,0,0,0,0,0,0
424853,476_15_56,QATAR,3860,7,daoud mousa daoud,0,0,0,0,0,0,0,0,0,0,0,0,0,0,0,0,0,0,0,0,0,0
424854,476_15_56,QATAR,6827,8,suliman abdi khalid,0,0,0,0,0,0,0,0,0,0,0,0,0,0,0,0,0,0,0,0,0,0
424855,476_15_56,QATAR,28376,9,mohamed hassan a mohamed,28,3,13,23.1,0,2,0,3,11,27.3,2,4,50,2,3,5,1,3,2,0,0,11
424856,476_15_56,QATAR,28377,10,abdulrahman mohamed saad,34,2,10,20,2,6,33.3,0,4,0,3,6,50,2,5,7,0,3,1,2,0,7
424857,476_15_56,QATAR,6830,11,ali saeed erfan,25,4,9,44.4,3,5,60,1,4,25,2,3,66.7,0,3,3,0,1,2,0,0,11
424858,476_15_56,QATAR,6831,12,mohammed saleem abdulla,13,2,2,100,2,2,100,0,0,0,0,0,0,0,1,1,0,1,0,0,0,4
424859,476_15_56,QATAR,23331,13,mohd mohamed,0,0,0,0,0,0,0,0,0,0,0,0,0,0,0,0,0,0,0,0,0,0
424860,476_15_56,QATAR,18646,14,abduallah shaher matalkeh,19,3,5,60,3,5,60,0,0,0,0,0,0,1,1,2,2,3,1,0,0,6
424861,476_15_56,QATAR,18645,15,khalid abdalla adam,29,5,5,100,5,5,100,0,0,0,0,0,0,2,7,9,0,3,0,1,1,10
424862,476_15_56,QATAR,0,TOTALS,QATAR,200,31,67,46.3,24,44,54.5,7,23,30.4,17,25,68,12,28,40,9,21,9,4,1,86
424863,476_15_56,LEBANON,6780,4,jean abd el nour,3,0,0,0,0,0,0,0,0,0,0,0,0,0,0,0,0,0,0,0,0,0
424864,476_15_56,LEBANON,28366,5,amir saoud,15,4,7,57.1,0,0,0,4,7,57.1,2,4,50,0,2,2,0,1,2,1,0,14
424865,476_15_56,LEBANON,28367,6,mohamad ali haidar,12,2,9,22.2,2,7,28.6,0,2,0,0,1,0,2,1,3,0,3,0,0,0,4
424866,476_15_56,LEBANON,28368,7,wael arakji,27,8,11,72.7,8,11,72.7,0,0,0,5,7,71.4,0,5,5,5,3,1,1,0,21
424867,476_15_56,LEBANON,28369,8,joseph aby kheres,9,0,0,0,0,0,0,0,0,0,0,0,0,0,0,0,0,4,1,0,0,0
424868,476_15_56,LEBANON,28370,9,ahmad ibrahim,0,0,0,0,0,0,0,0,0,0,0,0,0,0,0,0,0,0,0,0,0,0
424869,476_15_56,LEBANON,28371,10,nadim souaid,18,3,7,42.9,3,4,75,0,3,0,1,4,25,0,3,3,0,0,0,2,0,7
424870,476_15_56,LEBANON,8977,11,rodrigue akl,15,1,2,50,1,2,50,0,0,0,0,0,0,0,0,0,2,2,0,0,0,2
424871,476_15_56,LEBANON,18668,12,charles tabet,17,1,1,100,1,1,100,0,0,0,2,2,100,0,1,1,0,3,0,0,0,4
424872,476_15_56,LEBANON,18667,13,bassel bawji,38,9,15,60,9,14,64.3,0,1,0,0,0,0,3,4,7,0,2,2,1,1,18
424873,476_15_56,LEBANON,28372,14,jasmon jovan youngblood,28,4,13,30.8,3,7,42.9,1,6,16.7,4,4,100,2,3,5,2,2,1,1,1,13
424874,476_15_56,LEBANON,28373,15,omar el ayoubi,18,2,3,66.7,0,0,0,2,3,66.7,0,0,0,1,2,3,1,0,0,1,0,6
424875,476_15_56,LEBANON,0,TOTALS,LEBANON,200,34,68,50,27,46,58.7,7,22,31.8,14,22,63.6,9,25,34,10,20,7,7,2,89
424876,476_15_57,CHINA,18850,4,ji wei zhao,17,2,5,40,2,4,50,0,1,0,3,4,75,1,3,4,3,2,2,1,0,7
424877,476_15_57,CHINA,50,5,wei liu,0,0,0,0,0,0,0,0,0,0,0,0,0,0,0,0,0,0,0,0,0,0
424878,476_15_57,CHINA,14374,6,ailun guo,27,2,3,66.7,2,3,66.7,0,0,0,5,6,83.3,0,3,3,6,2,2,2,0,9
424879,476_15_57,CHINA,28363,7,tailong zhao,0,0,0,0,0,0,0,0,0,0,0,0,0,0,0,0,0,0,0,0,0,0
424880,476_15_57,CHINA,14377,8,yanyuhang ding,28,3,8,37.5,2,4,50,1,4,25,3,4,75,2,3,5,0,3,2,0,1,10
424881,476_15_57,CHINA,14378,9,xiaochuan zhai,30,3,8,37.5,1,2,50,2,6,33.3,0,0,0,1,3,4,3,3,0,1,0,8
424882,476_15_57,CHINA,16587,10,peng zhou,27,5,6,83.3,3,3,100,2,3,66.7,0,2,0,1,2,3,0,4,0,2,0,12
424883,476_15_57,CHINA,56,11,jianlian yi,30,5,10,50,4,9,44.4,1,1,100,2,4,50,2,6,8,1,3,5,0,4,13
424884,476_15_57,CHINA,28364,12,gen li,17,1,4,25,0,2,0,1,2,50,0,0,0,1,0,1,0,1,1,0,0,3
424885,476_15_57,CHINA,18361,13,muhao li,0,0,0,0,0,0,0,0,0,0,0,0,0,0,0,0,0,0,0,0,0,0
424886,476_15_57,CHINA,16635,14,zhelin wang,10,1,1,100,1,1,100,0,0,0,0,0,0,0,2,2,0,3,2,0,0,2
424887,476_15_57,CHINA,18858,15,qi zhou,16,3,9,33.3,3,9,33.3,0,0,0,0,0,0,1,3,4,0,3,1,0,3,6
424888,476_15_57,CHINA,0,TOTALS,CHINA,200,25,54,46.3,18,37,48.6,7,17,41.2,13,20,65,10,28,38,13,24,16,6,8,70
424889,476_15_57,IRAN,14400,4,sajjad mashayekhi,12,1,3,33.3,1,3,33.3,0,0,0,0,0,0,0,2,2,1,2,1,0,0,2
424890,476_15_57,IRAN,22994,5,behnam yakhchalidehkordi,11,1,5,20,0,3,0,1,2,50,0,0,0,1,0,1,0,1,0,0,0,3
424891,476_15_57,IRAN,9684,6,javad davari,4,0,0,0,0,0,0,0,0,0,0,0,0,0,0,0,0,1,0,0,0,0
424892,476_15_57,IRAN,9685,7,mahdi kamrani,29,2,10,20,2,6,33.3,0,4,0,2,3,66.7,0,1,1,1,3,1,1,0,6
424893,476_15_57,IRAN,28339,8,saeid karekani,25,2,10,20,1,7,14.3,1,3,33.3,0,0,0,1,3,4,0,2,0,0,0,5
424894,476_15_57,IRAN,13743,9,mohammad hassanzadeh saberi a,3,0,0,0,0,0,0,0,0,0,0,0,0,0,0,0,0,0,0,0,0,0
424895,476_15_57,IRAN,9688,10,hamed afagh,0,0,0,0,0,0,0,0,0,0,0,0,0,0,0,0,0,0,0,0,0,0
424896,476_15_57,IRAN,9690,11,oshin sahakian,33,1,4,25,1,3,33.3,0,1,0,2,2,100,2,3,5,0,3,1,3,0,4
424897,476_15_57,IRAN,28340,12,asghar kardoustpoustinsaraei,9,1,2,50,1,2,50,0,0,0,0,0,0,2,0,2,0,1,0,0,1,2
424898,476_15_57,IRAN,13739,13,mohammad jamshidijafarabadi,10,0,3,0,0,2,0,0,1,0,1,2,50,1,1,2,0,2,0,0,0,1
424899,476_15_57,IRAN,11627,14,mohammadsamad nik,35,5,15,33.3,5,10,50,0,5,0,8,9,88.9,1,6,7,0,3,1,1,0,18
424900,476_15_57,IRAN,9693,15,hamed ehadadi,31,5,11,45.5,5,11,45.5,0,0,0,6,10,60,6,5,11,0,3,8,2,2,16
424901,476_15_57,IRAN,0,TOTALS,IRAN,200,18,63,28.6,16,47,34,2,16,12.5,19,26,73.1,18,23,41,2,21,12,7,3,57
424902,476_15_58,JAPAN,28341,0,yuta tabuse,27,3,8,37.5,3,6,50,0,2,0,3,3,100,0,1,1,1,1,2,2,0,9
424903,476_15_58,JAPAN,23322,6,makoto hiejima,36,9,21,42.9,9,19,47.4,0,2,0,10,10,100,1,6,7,2,1,4,2,0,28
424904,476_15_58,JAPAN,18625,8,atsuya ota,21,1,1,100,1,1,100,0,0,0,3,4,75,1,1,2,0,2,0,0,0,5
424905,476_15_58,JAPAN,28342,10,ryoma hashimoto,9,0,0,0,0,0,0,0,0,0,0,0,0,0,0,0,0,2,1,0,0,0
424906,476_15_58,JAPAN,3875,15,joji takeuchi,40,6,12,50,6,11,54.5,0,1,0,6,6,100,8,8,16,1,3,1,0,1,18
424907,476_15_58,JAPAN,18621,16,keijuro matsui,3,0,0,0,0,0,0,0,0,0,0,0,0,0,1,1,0,0,0,0,0,0
424908,476_15_58,JAPAN,28343,17,gaku arao,17,1,2,50,1,2,50,0,0,0,1,4,25,4,1,5,1,2,0,0,0,3
424909,476_15_58,JAPAN,23321,24,daiki tanaka,7,1,2,50,1,2,50,0,0,0,0,0,0,0,0,0,1,1,0,0,0,2
424910,476_15_58,JAPAN,28344,25,takatoshi furukawa,21,2,10,20,2,6,33.3,0,4,0,0,0,0,1,2,3,0,2,0,0,0,4
424911,476_15_58,JAPAN,25620,34,ryumo ono,1,0,1,0,0,1,0,0,0,0,0,0,0,0,0,0,0,0,0,0,0,0
424912,476_15_58,JAPAN,18623,42,kenta hirose,17,0,6,0,0,4,0,0,2,0,1,2,50,0,5,5,1,2,1,1,1,1
424913,476_15_58,JAPAN,0,TOTALS,JAPAN,200,23,63,36.5,23,52,44.2,0,11,0,24,29,82.8,15,26,41,7,16,9,5,2,70
424914,476_15_58,PHILIPPINES,25433,1,andray blatche,34,9,21,42.9,8,16,50,1,5,20,3,3,100,4,9,13,0,1,3,1,0,22
424915,476_15_58,PHILIPPINES,9700,5,gabriel norwood,26,1,5,20,1,2,50,0,3,0,0,0,0,0,5,5,1,2,0,2,1,2
424916,476_15_58,PHILIPPINES,23361,7,jayson william,31,8,14,57.1,4,5,80,4,9,44.4,0,0,0,1,1,2,7,2,2,2,0,20
424917,476_15_58,PHILIPPINES,28323,8,calvin abueva,16,3,6,50,3,6,50,0,0,0,0,0,0,0,5,5,0,3,4,0,0,6
424918,476_15_58,PHILIPPINES,28324,9,john intal,0,0,0,0,0,0,0,0,0,0,0,0,0,0,0,0,0,0,0,0,0,0
424919,476_15_58,PHILIPPINES,28325,11,terrence romeo,16,1,5,20,0,2,0,1,3,33.3,0,0,0,0,1,1,2,3,0,0,0,3
424920,476_15_58,PHILIPPINES,23365,15,jean marc pingris,19,1,1,100,1,1,100,0,0,0,0,0,0,1,0,1,0,3,0,0,0,2
424921,476_15_58,PHILIPPINES,28326,22,matthew ganuelas,6,0,0,0,0,0,0,0,0,0,0,0,0,0,0,0,1,1,0,0,0,0
424922,476_15_58,PHILIPPINES,14183,23,joachim gunther thoss,3,0,1,0,0,1,0,0,0,0,0,0,0,0,0,0,0,1,1,0,0,0
424923,476_15_58,PHILIPPINES,9697,25,donaldo hontiveros,25,6,9,66.7,0,0,0,6,9,66.7,0,0,0,0,1,1,0,4,0,1,1,18
424924,476_15_58,PHILIPPINES,18657,33,ranidel de ocampo,25,2,6,33.3,1,4,25,1,2,50,3,3,100,2,5,7,2,4,1,1,2,8
424925,476_15_58,PHILIPPINES,9698,88,pauliasi taulava,0,0,0,0,0,0,0,0,0,0,0,0,0,0,0,0,0,0,0,0,0,0
424926,476_15_58,PHILIPPINES,0,TOTALS,PHILIPPINES,200,31,68,45.6,18,37,48.6,13,31,41.9,6,6,100,9,28,37,13,24,11,7,4,81
424927,476_15_59,INDIA,23335,3,vinay kaushik,30,2,6,33.3,1,1,100,1,5,20,0,0,0,0,1,1,0,1,2,0,0,5
424928,476_15_59,INDIA,28354,4,rajesh prakash uppar,14,0,4,0,0,4,0,0,0,0,0,0,0,0,1,1,0,1,1,0,0,0
424929,476_15_59,INDIA,28355,7,siddhant sanjay shinde,3,0,1,0,0,0,0,0,1,0,0,0,0,0,1,1,0,0,2,0,0,0
424930,476_15_59,INDIA,14219,9,vishesh bhriguvanshi,39,4,12,33.3,2,3,66.7,2,9,22.2,0,0,0,0,4,4,7,2,5,3,0,10
424931,476_15_59,INDIA,18673,10,amritpal singh ,15,1,4,25,1,4,25,0,0,0,0,0,0,2,2,4,0,0,0,0,0,2
424932,476_15_59,INDIA,28356,13,vikas kumar ,7,1,3,33.3,1,2,50,0,1,0,0,0,0,1,0,1,0,0,0,1,0,2
424933,476_15_59,INDIA,18675,14,yadwinder singh,0,0,0,0,0,0,0,0,0,0,0,0,0,0,0,0,0,0,0,0,0,0
424934,476_15_59,INDIA,28357,15,arvind arumugam,27,7,11,63.6,7,11,63.6,0,0,0,2,2,100,3,6,9,1,3,2,2,1,16
424935,476_15_59,INDIA,18670,22,amjyot singh ,34,7,16,43.8,5,10,50,2,6,33.3,5,6,83.3,3,2,5,1,4,5,1,1,21
424936,476_15_59,INDIA,25645,66,akilan pari,18,0,2,0,0,0,0,0,2,0,0,0,0,0,0,0,1,1,0,1,0,0
424937,476_15_59,INDIA,28358,69,akashdeep hazra,0,0,0,0,0,0,0,0,0,0,0,0,0,0,0,0,0,0,0,0,0,0
424938,476_15_59,INDIA,28359,96,gurvinder singh gill,14,1,4,25,1,4,25,0,0,0,0,3,0,3,4,7,1,0,1,0,1,2
424939,476_15_59,INDIA,0,TOTALS,INDIA,200,23,63,36.5,18,39,46.2,5,24,20.8,7,11,63.6,13,21,34,11,12,19,8,3,58
424940,476_15_59,QATAR,28374,4,abdelrahman yehia abdelhaleem,23,2,4,50,1,2,50,1,2,50,0,0,0,1,5,6,0,3,3,1,1,5
424941,476_15_59,QATAR,28375,5,clinton johnson,0,0,0,0,0,0,0,0,0,0,0,0,0,0,0,0,0,0,0,0,0,0
424942,476_15_59,QATAR,6826,6,saad abdulrahman ali,0,0,0,0,0,0,0,0,0,0,0,0,0,0,0,0,0,0,0,0,0,0
424943,476_15_59,QATAR,3860,7,daoud mousa daoud,36,5,7,71.4,2,3,66.7,3,4,75,3,3,100,1,5,6,5,2,2,3,0,16
424944,476_15_59,QATAR,6827,8,suliman abdi khalid,0,0,0,0,0,0,0,0,0,0,0,0,0,0,0,0,0,0,0,0,0,0
424945,476_15_59,QATAR,28376,9,mohamed hassan a mohamed,39,10,18,55.6,3,5,60,7,13,53.8,1,2,50,0,4,4,6,1,2,1,0,28
424946,476_15_59,QATAR,28377,10,abdulrahman mohamed saad,5,2,3,66.7,2,3,66.7,0,0,0,1,1,100,0,1,1,3,0,0,0,0,5
424947,476_15_59,QATAR,6830,11,ali saeed erfan,17,2,4,50,2,3,66.7,0,1,0,0,2,0,1,1,2,2,1,1,0,0,4
424948,476_15_59,QATAR,6831,12,mohammed saleem abdulla,11,2,6,33.3,2,6,33.3,0,0,0,0,2,0,0,3,3,0,2,1,1,0,4
424949,476_15_59,QATAR,23331,13,mohd mohamed,0,0,0,0,0,0,0,0,0,0,0,0,0,0,0,0,0,0,0,0,0,0
424950,476_15_59,QATAR,18646,14,abduallah shaher matalkeh,40,7,15,46.7,7,15,46.7,0,0,0,2,4,50,6,3,9,3,1,2,0,0,16
424951,476_15_59,QATAR,18645,15,khalid abdalla adam,29,3,5,60,3,5,60,0,0,0,0,1,0,1,6,7,0,1,4,2,1,6
424952,476_15_59,QATAR,0,TOTALS,QATAR,200,33,62,53.2,22,42,52.4,11,20,55,7,15,46.7,10,29,39,19,11,15,8,2,84
424953,476_15_60,LEBANON,6780,4,jean abd el nour,0,0,0,0,0,0,0,0,0,0,0,0,0,0,0,0,0,0,0,0,0,0
424954,476_15_60,LEBANON,28366,5,amir saoud,35,6,16,37.5,2,4,50,4,12,33.3,2,2,100,0,0,0,2,1,1,4,1,18
424955,476_15_60,LEBANON,28367,6,mohamad ali haidar,0,0,0,0,0,0,0,0,0,0,0,0,0,0,0,0,0,0,0,0,0,0
424956,476_15_60,LEBANON,28368,7,wael arakji,25,1,5,20,1,5,20,0,0,0,0,2,0,0,2,2,6,4,1,1,0,2
424957,476_15_60,LEBANON,28369,8,joseph aby kheres,19,2,5,40,2,4,50,0,1,0,0,0,0,0,2,2,1,2,1,1,0,4
424958,476_15_60,LEBANON,28370,9,ahmad ibrahim,0,0,0,0,0,0,0,0,0,0,0,0,0,0,0,0,0,0,0,0,0,0
424959,476_15_60,LEBANON,28371,10,nadim souaid,14,0,3,0,0,2,0,0,1,0,2,2,100,0,1,1,1,2,1,1,0,2
424960,476_15_60,LEBANON,8977,11,rodrigue akl,25,2,4,50,1,1,100,1,3,33.3,0,0,0,0,1,1,5,2,3,4,0,5
424961,476_15_60,LEBANON,18668,12,charles tabet,26,8,12,66.7,8,12,66.7,0,0,0,0,0,0,4,4,8,0,0,2,1,0,16
424962,476_15_60,LEBANON,18667,13,bassel bawji,35,12,18,66.7,11,15,73.3,1,3,33.3,3,4,75,7,5,12,2,4,6,0,1,28
424963,476_15_60,LEBANON,28372,14,jasmon jovan youngblood,0,0,0,0,0,0,0,0,0,0,0,0,0,0,0,0,0,0,0,0,0,0
424964,476_15_60,LEBANON,28373,15,omar el ayoubi,21,6,9,66.7,5,6,83.3,1,3,33.3,0,0,0,0,1,1,2,0,0,2,1,13
424965,476_15_60,LEBANON,0,TOTALS,LEBANON,200,37,72,51.4,30,49,61.2,7,23,30.4,7,10,70,11,20,31,19,15,15,14,3,88
424966,476_15_60,KOREA,11667,1,taesul kim,20,0,4,0,0,3,0,0,1,0,0,0,0,0,1,1,5,1,2,2,0,0
424967,476_15_60,KOREA,28345,3,junghyun lee,5,2,2,100,0,0,0,2,2,100,0,0,0,0,0,0,1,0,2,0,0,6
424968,476_15_60,KOREA,16672,4,seonggon moon,0,0,0,0,0,0,0,0,0,0,0,0,0,0,0,0,0,0,0,0,0,0
424969,476_15_60,KOREA,22972,5,junyong choi,13,2,3,66.7,1,2,50,1,1,100,0,0,0,0,0,0,2,1,3,0,0,5
424970,476_15_60,KOREA,9631,6,donggeun yang,20,3,4,75,3,4,75,0,0,0,0,0,0,0,0,0,3,2,3,0,0,6
424971,476_15_60,KOREA,18640,7,chan hee park,0,0,0,0,0,0,0,0,0,0,0,0,0,0,0,0,0,0,0,0,0,0
424972,476_15_60,KOREA,18643,10,sungmin cho,30,6,14,42.9,2,3,66.7,4,11,36.4,0,0,0,1,2,3,4,3,1,6,0,16
424973,476_15_60,KOREA,22971,11,sangjae kang,24,5,7,71.4,5,7,71.4,0,0,0,2,3,66.7,2,4,6,3,1,1,0,1,12
424974,476_15_60,KOREA,18644,15,jongkyu kim,31,7,13,53.8,7,13,53.8,0,0,0,2,2,100,7,5,12,2,2,2,0,0,16
424975,476_15_60,KOREA,28346,22,taeyoung moon,31,4,13,30.8,4,13,30.8,0,0,0,3,4,75,0,5,5,3,2,1,2,0,11
424976,476_15_60,KOREA,14338,32,jonghyun lee,25,6,9,66.7,6,9,66.7,0,0,0,3,4,75,3,1,4,1,1,2,0,0,15
424977,476_15_60,KOREA,18395,33,seounghyun lee,0,0,0,0,0,0,0,0,0,0,0,0,0,0,0,0,0,0,0,0,0,0
424978,476_15_60,KOREA,0,TOTALS,KOREA,200,35,69,50.7,28,54,51.9,7,15,46.7,10,13,76.9,15,23,38,24,13,17,10,1,87
424979,476_15_61,IRAN,14400,4,sajjad mashayekhi,19,2,5,40,0,1,0,2,4,50,2,2,100,1,0,1,2,1,1,1,0,8
424980,476_15_61,IRAN,22994,5,behnam yakhchalidehkordi,15,0,5,0,0,1,0,0,4,0,2,2,100,3,1,4,2,3,1,2,0,2
424981,476_15_61,IRAN,9684,6,javad davari,0,0,0,0,0,0,0,0,0,0,0,0,0,0,0,0,0,0,0,0,0,0
424982,476_15_61,IRAN,9685,7,mahdi kamrani,35,1,3,33.3,0,0,0,1,3,33.3,0,0,0,0,2,2,2,0,1,2,0,3
424983,476_15_61,IRAN,28339,8,saeid karekani,9,0,4,0,0,1,0,0,3,0,0,0,0,0,2,2,1,1,0,0,0,0
424984,476_15_61,IRAN,13743,9,mohammad hassanzadeh saberi a,7,1,1,100,1,1,100,0,0,0,0,0,0,1,3,4,0,4,1,1,0,2
424985,476_15_61,IRAN,9688,10,hamed afagh,1,0,0,0,0,0,0,0,0,0,0,0,0,0,0,0,0,0,0,0,0,0
424986,476_15_61,IRAN,9690,11,oshin sahakian,17,0,2,0,0,1,0,0,1,0,1,2,50,2,2,4,0,1,1,1,0,1
424987,476_15_61,IRAN,28340,12,asghar kardoustpoustinsaraei,10,2,3,66.7,2,3,66.7,0,0,0,1,1,100,1,1,2,0,2,0,0,0,5
424988,476_15_61,IRAN,13739,13,mohammad jamshidijafarabadi,25,1,4,25,1,2,50,0,2,0,0,2,0,1,4,5,0,1,1,0,0,2
424989,476_15_61,IRAN,11627,14,mohammadsamad nik,32,12,23,52.2,4,6,66.7,8,17,47.1,3,4,75,0,1,1,0,2,2,1,0,35
424990,476_15_61,IRAN,9693,15,hamed ehadadi,30,3,9,33.3,3,8,37.5,0,1,0,4,8,50,3,4,7,5,2,2,1,1,10
424991,476_15_61,IRAN,0,TOTALS,IRAN,200,22,59,37.3,11,24,45.8,11,35,31.4,13,21,61.9,12,22,34,12,17,11,9,1,68
424992,476_15_61,JAPAN,28341,0,yuta tabuse,25,0,3,0,0,3,0,0,0,0,0,0,0,0,2,2,3,4,3,0,0,0
424993,476_15_61,JAPAN,23322,6,makoto hiejima,27,6,13,46.2,6,10,60,0,3,0,3,4,75,0,1,1,4,4,4,1,0,15
424994,476_15_61,JAPAN,18625,8,atsuya ota,18,0,2,0,0,2,0,0,0,0,2,2,100,0,2,2,0,0,1,1,0,2
424995,476_15_61,JAPAN,28342,10,ryoma hashimoto,10,0,3,0,0,1,0,0,2,0,0,0,0,0,1,1,1,1,2,0,0,0
424996,476_15_61,JAPAN,3875,15,joji takeuchi,38,4,6,66.7,3,5,60,1,1,100,3,4,75,1,9,10,1,3,1,1,0,12
424997,476_15_61,JAPAN,18621,16,keijuro matsui,27,6,11,54.5,0,1,0,6,10,60,0,0,0,2,3,5,2,2,3,2,0,18
424998,476_15_61,JAPAN,28343,17,gaku arao,19,0,0,0,0,0,0,0,0,0,0,2,0,1,2,3,1,4,1,0,0,0
424999,476_15_61,JAPAN,23321,24,daiki tanaka,13,1,3,33.3,1,1,100,0,2,0,0,0,0,0,0,0,1,0,1,0,0,2
425000,476_15_61,JAPAN,28344,25,takatoshi furukawa,15,5,8,62.5,2,3,66.7,3,5,60,1,2,50,1,0,1,0,1,0,0,0,14
425001,476_15_61,JAPAN,25620,34,ryumo ono,5,0,0,0,0,0,0,0,0,0,0,0,0,1,2,3,2,2,1,0,0,0
425002,476_15_61,JAPAN,18623,42,kenta hirose,3,0,2,0,0,1,0,0,1,0,0,0,0,0,0,0,0,0,0,0,0,0
425003,476_15_61,JAPAN,0,TOTALS,JAPAN,200,22,51,43.1,12,27,44.4,10,24,41.7,9,14,64.3,7,26,33,15,21,18,5,0,63
425004,476_15_62,CHINA,18850,4,ji wei zhao,23,1,4,25,0,1,0,1,3,33.3,0,0,0,1,1,2,1,4,0,0,0,3
425005,476_15_62,CHINA,50,5,wei liu,0,0,0,0,0,0,0,0,0,0,0,0,0,0,0,0,0,0,0,0,0,0
425006,476_15_62,CHINA,14374,6,ailun guo,31,5,12,41.7,3,8,37.5,2,4,50,7,10,70,0,6,6,2,4,3,1,1,19
425007,476_15_62,CHINA,28363,7,tailong zhao,0,0,0,0,0,0,0,0,0,0,0,0,0,0,0,0,0,0,0,0,0,0
425008,476_15_62,CHINA,14377,8,yanyuhang ding,21,3,8,37.5,1,3,33.3,2,5,40,1,1,100,1,1,2,3,0,2,0,0,9
425009,476_15_62,CHINA,14378,9,xiaochuan zhai,23,1,6,16.7,1,2,50,0,4,0,0,0,0,0,4,4,2,2,1,0,1,2
425010,476_15_62,CHINA,16587,10,peng zhou,16,3,6,50,2,3,66.7,1,3,33.3,0,0,0,1,1,2,1,5,0,0,0,7
425011,476_15_62,CHINA,56,11,jianlian yi,37,4,14,28.6,4,14,28.6,0,0,0,3,6,50,3,12,15,1,2,2,0,2,11
425012,476_15_62,CHINA,28364,12,gen li,13,3,4,75,0,0,0,3,4,75,0,0,0,0,0,0,1,4,0,0,0,9
425013,476_15_62,CHINA,18361,13,muhao li,0,0,0,0,0,0,0,0,0,0,0,0,0,0,0,0,0,0,0,0,0,0
425014,476_15_62,CHINA,16635,14,zhelin wang,4,0,1,0,0,1,0,0,0,0,2,4,50,1,0,1,0,2,1,0,0,2
425015,476_15_62,CHINA,18858,15,qi zhou,33,4,9,44.4,4,8,50,0,1,0,8,12,66.7,4,10,14,0,1,0,0,1,16
425016,476_15_62,CHINA,0,TOTALS,CHINA,200,24,64,37.5,15,40,37.5,9,24,37.5,21,33,63.6,11,35,46,11,24,10,1,5,78
425017,476_15_62,PHILIPPINES,25433,1,andray blatche,27,6,13,46.2,5,8,62.5,1,5,20,4,5,80,1,4,5,0,3,1,0,0,17
425018,476_15_62,PHILIPPINES,9700,5,gabriel norwood,32,3,4,75,2,3,66.7,1,1,100,0,0,0,0,2,2,1,0,2,2,2,7
425019,476_15_62,PHILIPPINES,23361,7,jayson william,27,3,14,21.4,2,11,18.2,1,3,33.3,1,2,50,1,5,6,1,4,2,1,0,8
425020,476_15_62,PHILIPPINES,28323,8,calvin abueva,11,3,8,37.5,3,7,42.9,0,1,0,3,8,37.5,3,2,5,0,5,0,0,1,9
425021,476_15_62,PHILIPPINES,28324,9,john intal,2,0,0,0,0,0,0,0,0,0,0,0,0,0,1,1,0,0,0,0,0,0
425022,476_15_62,PHILIPPINES,28325,11,terrence romeo,20,3,9,33.3,3,7,42.9,0,2,0,3,6,50,0,5,5,3,1,0,1,0,9
425023,476_15_62,PHILIPPINES,23365,15,jean marc pingris,14,0,0,0,0,0,0,0,0,0,0,0,0,1,1,2,0,2,0,0,0,0
425024,476_15_62,PHILIPPINES,28326,22,matthew ganuelas,7,0,0,0,0,0,0,0,0,0,0,0,0,1,0,1,0,2,0,0,0,0
425025,476_15_62,PHILIPPINES,14183,23,joachim gunther thoss,15,1,2,50,1,2,50,0,0,0,2,2,100,3,2,5,0,3,2,1,0,4
425026,476_15_62,PHILIPPINES,9697,25,donaldo hontiveros,21,2,6,33.3,0,0,0,2,6,33.3,0,0,0,0,3,3,0,4,0,0,0,6
425027,476_15_62,PHILIPPINES,18657,33,ranidel de ocampo,24,2,9,22.2,1,3,33.3,1,6,16.7,2,3,66.7,0,3,3,2,3,2,2,0,7
425028,476_15_62,PHILIPPINES,9698,88,pauliasi taulava,0,0,0,0,0,0,0,0,0,0,0,0,0,0,0,0,0,0,0,0,0,0
425029,476_15_62,PHILIPPINES,0,TOTALS,PHILIPPINES,200,23,65,35.4,17,41,41.5,6,24,25,15,26,57.7,11,32,43,7,28,9,7,3,67
428329,480_15_01,CUBA,25953,4,karel guzman,12,1,2,50,0,1,0,1,1,100,1,4,25,2,0,2,0,2,2,0,0,4
428330,480_15_01,CUBA,16888,5,osmel oliva,22,0,7,0,0,6,0,0,1,0,2,2,100,0,5,5,3,4,5,2,0,2
428331,480_15_01,CUBA,25804,6,javier justiz,19,4,14,28.6,4,14,28.6,0,0,0,0,3,0,2,4,6,0,2,2,0,2,8
428332,480_15_01,CUBA,16887,7,yaser rodriguez,19,2,3,66.7,2,2,100,0,1,0,0,0,0,0,1,1,2,0,0,1,0,4
428333,480_15_01,CUBA,28743,9,lisvan valdes,8,0,1,0,0,1,0,0,0,0,2,2,100,0,2,2,2,1,2,0,0,2
428334,480_15_01,CUBA,7259,10,william granda,26,2,6,33.3,2,4,50,0,2,0,0,0,0,1,2,3,3,2,2,1,0,4
428335,480_15_01,CUBA,25954,11,yuniskel molina,19,0,5,0,0,4,0,0,1,0,0,0,0,0,2,2,1,0,0,0,0,0
428336,480_15_01,CUBA,393,12,yoan haiti,24,1,4,25,0,3,0,1,1,100,2,4,50,0,3,3,1,3,2,0,1,5
428337,480_15_01,CUBA,25805,13,esteban martinez,11,1,3,33.3,1,3,33.3,0,0,0,0,0,0,0,1,1,0,3,3,0,0,2
428338,480_15_01,CUBA,7260,14,orestes torres,17,3,8,37.5,2,7,28.6,1,1,100,2,3,66.7,2,5,7,1,1,2,2,0,9
428339,480_15_01,CUBA,25806,15,jasiel rivero,22,4,9,44.4,4,9,44.4,0,0,0,2,3,66.7,5,2,7,0,4,1,0,0,10
428340,480_15_01,CUBA,28744,16,yoel cubilla,1,1,1,100,1,1,100,0,0,0,0,0,0,0,0,0,0,0,0,0,0,2
428341,480_15_01,CUBA,0,TOTALS,CUBA,200,19,63,30.2,16,55,29.1,3,8,37.5,11,21,52.4,16,30,46,13,22,22,6,3,52
428342,480_15_01,VENEZUELA,514,4,miguel marriaga,16,0,5,0,0,4,0,0,1,0,0,0,0,1,2,3,0,3,0,1,0,0
428343,480_15_01,VENEZUELA,16828,5,gregory vargas,10,1,3,33.3,1,2,50,0,1,0,0,0,0,0,3,3,1,1,0,0,0,2
428344,480_15_01,VENEZUELA,21053,6,john cox,19,3,6,50,3,5,60,0,1,0,0,0,0,1,2,3,0,2,0,0,1,6
428345,480_15_01,VENEZUELA,16829,8,david cubillan,16,2,4,50,2,2,100,0,2,0,6,8,75,1,2,3,2,2,6,1,0,10
428346,480_15_01,VENEZUELA,9857,10,jose vargas,13,4,6,66.7,4,6,66.7,0,0,0,2,4,50,0,1,1,1,2,0,1,0,10
428347,480_15_01,VENEZUELA,28745,11,cesar garcia,19,3,8,37.5,3,3,100,0,5,0,0,0,0,1,2,3,1,2,1,1,1,6
428348,480_15_01,VENEZUELA,9984,12,javinger vargas,17,3,7,42.9,2,2,100,1,5,20,0,0,0,1,4,5,1,3,1,2,1,7
428349,480_15_01,VENEZUELA,25751,14,miguel ruiz,14,1,3,33.3,1,3,33.3,0,0,0,1,2,50,1,3,4,1,3,0,0,0,3
428350,480_15_01,VENEZUELA,19026,15,windi graterol,17,1,5,20,1,3,33.3,0,2,0,1,2,50,3,2,5,0,2,1,1,2,3
428351,480_15_01,VENEZUELA,19021,19,heissler guillent,21,5,7,71.4,3,4,75,2,3,66.7,2,2,100,0,1,1,7,0,2,1,0,14
428352,480_15_01,VENEZUELA,19023,21,dwight lewis,22,1,6,16.7,0,2,0,1,4,25,1,2,50,0,5,5,0,2,1,3,0,4
428353,480_15_01,VENEZUELA,19022,43,nestor colmenares,16,3,4,75,3,4,75,0,0,0,2,4,50,1,3,4,1,1,0,1,1,8
428354,480_15_01,VENEZUELA,0,TOTALS,VENEZUELA,200,27,64,42.2,23,40,57.5,4,24,16.7,15,24,62.5,11,33,44,15,23,13,12,6,73
428355,480_15_02,URUGUAY,28746,4,santiago vidal,0,0,0,0,0,0,0,0,0,0,0,0,0,0,0,0,0,0,0,0,0,0
428356,480_15_02,URUGUAY,7588,5,bruno fitipaldo,33,4,13,30.8,1,6,16.7,3,7,42.9,1,3,33.3,1,2,3,3,2,1,5,0,12
428357,480_15_02,URUGUAY,298,6,mauricio aguiar,31,2,8,25,0,4,0,2,4,50,4,4,100,0,5,5,2,2,3,0,0,10
428358,480_15_02,URUGUAY,7590,7,mathias calfani,24,3,9,33.3,3,8,37.5,0,1,0,5,8,62.5,3,5,8,1,4,1,1,0,11
428359,480_15_02,URUGUAY,12235,10,marcel souberbielle,4,0,1,0,0,0,0,0,1,0,0,0,0,0,0,0,0,2,0,1,0,0
428360,480_15_02,URUGUAY,296,11,martin osimani,28,1,6,16.7,1,4,25,0,2,0,3,3,100,1,3,4,0,1,3,1,0,5
428361,480_15_02,URUGUAY,14992,13,hernando caceres,0,0,0,0,0,0,0,0,0,0,0,0,0,0,0,0,0,0,0,0,0,0
428362,480_15_02,URUGUAY,4134,14,nicolas borsellino,21,3,6,50,3,6,50,0,0,0,3,4,75,5,3,8,1,4,1,1,0,9
428363,480_15_02,URUGUAY,12278,21,luciano parodi,21,4,8,50,4,5,80,0,3,0,3,3,100,1,0,1,5,1,0,0,0,11
428364,480_15_02,URUGUAY,19040,22,reque newsome,18,3,8,37.5,3,8,37.5,0,0,0,2,6,33.3,1,1,2,0,2,1,0,1,8
428365,480_15_02,URUGUAY,23760,33,kiril wachsmann,16,2,4,50,2,4,50,0,0,0,1,1,100,2,4,6,0,3,1,1,0,5
428366,480_15_02,URUGUAY,28747,41,demian alvarez,3,0,0,0,0,0,0,0,0,0,0,0,0,0,0,0,0,1,1,0,0,0
428367,480_15_02,URUGUAY,0,TOTALS,URUGUAY,200,22,63,34.9,17,45,37.8,5,18,27.8,22,32,68.8,17,26,43,12,23,13,10,1,71
428368,480_15_02,BRAZIL,28748,4,ricardo fischer,19,0,2,0,0,1,0,0,1,0,2,2,100,0,1,1,2,1,2,1,0,2
428369,480_15_02,BRAZIL,7622,5,rafael luz,23,1,3,33.3,1,2,50,0,1,0,0,0,0,1,1,2,4,4,5,2,0,2
428370,480_15_02,BRAZIL,19019,6,augusto lima,18,2,5,40,2,5,40,0,0,0,0,3,0,1,4,5,0,3,0,0,3,4
428371,480_15_02,BRAZIL,15053,7,deryk ramos,0,0,0,0,0,0,0,0,0,0,0,0,0,0,0,0,0,0,0,0,0,0
428372,480_15_02,BRAZIL,7625,8,vitor benite,34,3,15,20,3,9,33.3,0,6,0,1,2,50,1,5,6,2,3,0,3,0,7
428373,480_15_02,BRAZIL,14737,9,leo meindl,7,0,0,0,0,0,0,0,0,0,0,0,0,0,0,0,0,4,2,0,0,0
428374,480_15_02,BRAZIL,14634,10,carlos olivinha,10,0,4,0,0,2,0,0,2,0,0,0,0,1,1,2,1,2,1,0,0,0
428375,480_15_02,BRAZIL,28749,11,rafael mineiro,10,0,3,0,0,1,0,0,2,0,2,2,100,2,2,4,0,2,0,0,1,2
428376,480_15_02,BRAZIL,4104,12,guilherme giovannoni,27,3,6,50,2,3,66.7,1,3,33.3,2,2,100,1,2,3,3,4,0,1,1,9
428377,480_15_02,BRAZIL,9843,13,j p batista,15,3,4,75,3,4,75,0,0,0,2,5,40,2,3,5,0,5,3,0,0,8
428378,480_15_02,BRAZIL,28750,14,viera marquinhos,34,7,14,50,6,8,75,1,6,16.7,6,9,66.7,3,6,9,2,2,5,1,0,21
428379,480_15_02,BRAZIL,483,15,marcus toledo,3,1,1,100,1,1,100,0,0,0,0,0,0,1,1,2,0,1,2,0,0,2
428380,480_15_02,BRAZIL,0,TOTALS,BRAZIL,200,20,57,35.1,18,36,50,2,21,9.5,15,25,60,13,29,42,14,31,21,8,5,57
428381,480_15_03,ARGENTINA,80,4,luis scola,30,9,16,56.2,9,16,56.2,0,0,0,4,9,44.4,5,9,14,5,4,2,1,0,22
428382,480_15_03,ARGENTINA,25731,5,nicolas richotti,0,0,0,0,0,0,0,0,0,0,0,0,0,0,0,0,0,0,0,0,0,0
428383,480_15_03,ARGENTINA,21037,7,facundo campazzo,19,2,4,50,2,3,66.7,0,1,0,1,2,50,0,2,2,5,4,1,1,0,5
428384,480_15_03,ARGENTINA,12228,8,nicolas laprovittola,26,3,12,25,3,7,42.9,0,5,0,2,2,100,0,3,3,5,3,2,0,0,8
428385,480_15_03,ARGENTINA,25732,9,nicolas brussino,0,0,0,0,0,0,0,0,0,0,0,0,0,0,0,0,0,0,0,0,0,0
428386,480_15_03,ARGENTINA,14903,12,marcos delia,7,1,1,100,1,1,100,0,0,0,0,0,0,0,1,1,0,0,2,0,0,2
428387,480_15_03,ARGENTINA,82,13,andres nocioni,34,5,14,35.7,4,7,57.1,1,7,14.3,3,6,50,3,9,12,1,4,3,0,0,14
428388,480_15_03,ARGENTINA,15007,14,gabriel deck,10,2,3,66.7,2,3,66.7,0,0,0,0,0,0,0,1,1,0,1,0,0,0,4
428389,480_15_03,ARGENTINA,21197,15,selem safar,33,4,7,57.1,0,0,0,4,7,57.1,2,3,66.7,0,4,4,1,2,2,0,0,14
428390,480_15_03,ARGENTINA,459,19,leo mainoldi,8,1,4,25,0,0,0,1,4,25,0,0,0,1,1,2,0,1,0,0,0,3
428391,480_15_03,ARGENTINA,12296,29,patricio garino,33,6,7,85.7,4,5,80,2,2,100,5,5,100,2,1,3,1,2,1,3,2,19
428392,480_15_03,ARGENTINA,16652,83,tayavek gallizzi,0,0,0,0,0,0,0,0,0,0,0,0,0,0,0,0,0,0,0,0,0,0
428393,480_15_03,ARGENTINA,0,TOTALS,ARGENTINA,200,33,68,48.5,25,42,59.5,8,26,30.8,17,27,63,13,32,45,18,22,13,5,2,91
428394,480_15_03,PUERTO RICO,23748,1,ramon clemente,12,1,2,50,1,2,50,0,0,0,0,1,0,1,1,2,2,3,1,1,0,2
428395,480_15_03,PUERTO RICO,14636,2,guillermo diaz,11,0,3,0,0,2,0,0,1,0,0,0,0,0,0,0,1,0,1,0,0,0
428396,480_15_03,PUERTO RICO,19036,5,jose juan barea,24,6,11,54.5,2,4,50,4,7,57.1,4,4,100,0,3,3,10,4,4,2,0,20
428397,480_15_03,PUERTO RICO,23749,6,richard chaney,30,5,7,71.4,5,7,71.4,0,0,0,3,3,100,1,6,7,2,3,0,2,0,13
428398,480_15_03,PUERTO RICO,28751,7,javier gonzalez,2,0,0,0,0,0,0,0,0,0,0,0,0,0,0,0,0,1,0,0,0,0
428399,480_15_03,PUERTO RICO,3479,8,angel vassallo,23,3,11,27.3,1,5,20,2,6,33.3,2,3,66.7,1,3,4,1,5,1,0,0,10
428400,480_15_03,PUERTO RICO,8997,9,jorge bryan diaz,20,3,7,42.9,3,7,42.9,0,0,0,0,0,0,1,2,3,0,3,1,0,2,6
428401,480_15_03,PUERTO RICO,103,10,larry ayuso,22,2,6,33.3,1,2,50,1,4,25,1,2,50,0,2,2,1,1,1,0,0,6
428402,480_15_03,PUERTO RICO,23750,11,luis villafane,0,0,0,0,0,0,0,0,0,0,0,0,0,0,0,0,0,0,0,0,0,0
428403,480_15_03,PUERTO RICO,16592,13,renaldo balkman,24,6,10,60,6,10,60,0,0,0,3,5,60,1,4,5,0,4,1,0,1,15
428404,480_15_03,PUERTO RICO,19067,23,john holland,14,3,6,50,1,4,25,2,2,100,0,0,0,0,0,0,0,0,0,0,0,8
428405,480_15_03,PUERTO RICO,25443,31,carlos rivera,18,2,5,40,2,4,50,0,1,0,2,2,100,0,2,2,2,2,1,0,0,6
428406,480_15_03,PUERTO RICO,0,TOTALS,PUERTO RICO,200,31,68,45.6,22,47,46.8,9,21,42.9,15,20,75,6,25,31,19,26,12,5,3,86
428407,480_15_04,DOMINICAN REPUBLIC,19011,4,edgar sosa,26,7,13,53.8,3,5,60,4,8,50,0,0,0,2,3,5,4,2,4,0,0,18
428408,480_15_04,DOMINICAN REPUBLIC,25436,5,victor liz,12,1,3,33.3,1,1,100,0,2,0,2,3,66.7,2,0,2,0,0,0,1,0,4
428409,480_15_04,DOMINICAN REPUBLIC,28752,6,rigoberto mendoza,13,2,2,100,2,2,100,0,0,0,2,2,100,1,2,3,1,2,2,0,0,6
428410,480_15_04,DOMINICAN REPUBLIC,21234,7,angel suero,11,0,1,0,0,0,0,0,1,0,2,2,100,0,1,1,0,0,1,0,0,2
428411,480_15_04,DOMINICAN REPUBLIC,23761,8,edward santana,15,2,3,66.7,2,3,66.7,0,0,0,0,0,0,0,0,0,0,1,2,0,0,4
428412,480_15_04,DOMINICAN REPUBLIC,4116,9,francisco garcia,26,4,8,50,2,4,50,2,4,50,0,0,0,0,0,0,2,1,1,0,0,10
428413,480_15_04,DOMINICAN REPUBLIC,23762,10,james feldeine,23,1,10,10,0,8,0,1,2,50,2,2,100,2,2,4,3,0,1,0,0,5
428414,480_15_04,DOMINICAN REPUBLIC,19070,11,eloy vargas,16,0,5,0,0,5,0,0,0,0,3,6,50,2,3,5,1,3,0,0,0,3
428415,480_15_04,DOMINICAN REPUBLIC,19016,12,orlando sanchez,21,1,4,25,1,2,50,0,2,0,0,0,0,2,6,8,1,2,1,0,0,2
428416,480_15_04,DOMINICAN REPUBLIC,9947,13,eulis baez,18,2,5,40,2,4,50,0,1,0,2,4,50,0,5,5,0,0,1,0,1,6
428417,480_15_04,DOMINICAN REPUBLIC,4114,14,luis flores,8,1,4,25,0,3,0,1,1,100,0,0,0,0,1,1,0,3,0,0,0,3
428418,480_15_04,DOMINICAN REPUBLIC,28753,15,juan jose garcia,12,1,3,33.3,1,3,33.3,0,0,0,1,2,50,0,2,2,1,2,0,0,0,3
428419,480_15_04,DOMINICAN REPUBLIC,0,TOTALS,DOMINICAN REPUBLIC,200,22,61,36.1,14,40,35,8,21,38.1,14,21,66.7,12,27,39,13,16,13,1,1,66
428420,480_15_04,MEXICO,16880,4,paul stoll,13,1,3,33.3,0,0,0,1,3,33.3,1,2,50,0,0,0,0,2,0,0,0,4
428421,480_15_04,MEXICO,23812,5,marco ramos,2,0,0,0,0,0,0,0,0,0,0,0,0,0,1,1,0,2,0,0,0,0
428422,480_15_04,MEXICO,28754,6,juan toscano,33,5,10,50,4,6,66.7,1,4,25,0,0,0,2,7,9,7,2,2,0,0,11
428423,480_15_04,MEXICO,23756,7,jorge gutierrez,27,4,10,40,3,8,37.5,1,2,50,2,2,100,1,3,4,6,5,1,2,0,11
428424,480_15_04,MEXICO,9836,8,gustavo ayon,32,7,16,43.8,7,16,43.8,0,0,0,4,6,66.7,2,9,11,3,3,1,1,1,18
428425,480_15_04,MEXICO,23813,9,francisco cruz,0,0,0,0,0,0,0,0,0,0,0,0,0,0,0,0,0,0,0,0,0,0
428426,480_15_04,MEXICO,21214,10,gabriel giron,8,0,2,0,0,1,0,0,1,0,1,2,50,1,0,1,0,1,0,1,0,1
428427,480_15_04,MEXICO,9834,11,pedro meza,0,0,0,0,0,0,0,0,0,0,0,0,0,0,0,0,0,0,0,0,0,0
428428,480_15_04,MEXICO,9835,12,hector hernandez,36,5,13,38.5,3,5,60,2,8,25,0,0,0,0,7,7,3,3,1,1,3,12
428429,480_15_04,MEXICO,21215,13,orlando mendez,37,9,17,52.9,3,9,33.3,6,8,75,0,0,0,2,1,3,4,1,1,1,0,24
428430,480_15_04,MEXICO,25446,14,adrian zamora,0,0,0,0,0,0,0,0,0,0,0,0,0,0,0,0,0,0,0,0,0,0
428431,480_15_04,MEXICO,25444,15,israel gutierrez,12,1,4,25,1,4,25,0,0,0,1,2,50,6,1,7,0,4,0,1,0,3
428432,480_15_04,MEXICO,0,TOTALS,MEXICO,200,32,75,42.7,21,49,42.9,11,26,42.3,9,14,64.3,17,30,47,23,23,6,7,4,84
428433,480_15_05,PANAMA,4091,4,joel munoz,15,1,2,50,0,1,0,1,1,100,0,0,0,1,1,2,3,3,1,1,0,3
428434,480_15_05,PANAMA,25940,5,trevor gaskins,25,2,12,16.7,1,4,25,1,8,12.5,0,0,0,1,1,2,6,3,4,0,0,5
428435,480_15_05,PANAMA,4139,6,danilo pinnock,15,2,6,33.3,1,3,33.3,1,3,33.3,0,0,0,1,2,3,3,3,1,0,0,5
428436,480_15_05,PANAMA,28755,7,jamelle horne,6,0,2,0,0,2,0,0,0,0,0,0,0,0,1,1,0,0,1,1,0,0
428437,480_15_05,PANAMA,4526,8,jonathan king,0,0,0,0,0,0,0,0,0,0,0,0,0,0,0,0,0,0,0,0,0,0
428438,480_15_05,PANAMA,6822,9,jamaal levy,18,4,5,80,4,4,100,0,1,0,0,0,0,1,1,2,2,3,1,1,0,8
428439,480_15_05,PANAMA,19035,10,josimar ayarza,20,0,6,0,0,2,0,0,4,0,0,0,0,0,3,3,2,0,2,1,0,0
428440,480_15_05,PANAMA,401,11,michael hicks,32,6,11,54.5,3,6,50,3,5,60,6,10,60,3,3,6,4,4,2,1,0,21
428441,480_15_05,PANAMA,4529,12,ernesto oglivie,16,5,7,71.4,5,6,83.3,0,1,0,0,0,0,2,1,3,1,1,0,0,0,10
428442,480_15_05,PANAMA,14640,13,leonardo pomare,21,8,10,80,8,10,80,0,0,0,1,1,100,1,5,6,1,3,1,2,1,17
428443,480_15_05,PANAMA,25810,14,jaime lloreda,26,3,7,42.9,3,7,42.9,0,0,0,2,6,33.3,4,7,11,2,4,1,0,1,8
428444,480_15_05,PANAMA,6820,15,ruben garces,8,0,1,0,0,1,0,0,0,0,1,2,50,2,2,4,0,3,3,1,0,1
428445,480_15_05,PANAMA,0,TOTALS,PANAMA,200,31,69,44.9,25,46,54.3,6,23,26.1,10,19,52.6,19,32,51,24,27,17,8,2,78
428446,480_15_05,URUGUAY,28746,4,santiago vidal,0,0,0,0,0,0,0,0,0,0,0,0,0,0,0,0,0,0,0,0,0,0
428447,480_15_05,URUGUAY,7588,5,bruno fitipaldo,34,6,14,42.9,4,5,80,2,9,22.2,4,4,100,2,0,2,3,2,4,2,0,18
428448,480_15_05,URUGUAY,298,6,mauricio aguiar,28,4,12,33.3,3,6,50,1,6,16.7,2,5,40,0,1,1,2,2,2,0,0,11
428449,480_15_05,URUGUAY,7590,7,mathias calfani,24,4,8,50,4,8,50,0,0,0,3,6,50,2,5,7,5,4,1,1,0,11
428450,480_15_05,URUGUAY,12235,10,marcel souberbielle,4,0,0,0,0,0,0,0,0,0,0,2,0,0,0,0,1,0,0,1,0,0
428451,480_15_05,URUGUAY,296,11,martin osimani,36,3,9,33.3,2,4,50,1,5,20,4,4,100,0,2,2,7,3,1,1,0,11
428452,480_15_05,URUGUAY,14992,13,hernando caceres,0,0,0,0,0,0,0,0,0,0,0,0,0,0,0,0,0,0,0,0,0,0
428453,480_15_05,URUGUAY,4134,14,nicolas borsellino,20,5,9,55.6,4,8,50,1,1,100,0,0,0,1,5,6,1,3,1,0,0,11
428454,480_15_05,URUGUAY,12278,21,luciano parodi,16,0,4,0,0,0,0,0,4,0,0,0,0,2,2,4,1,2,2,2,0,0
428455,480_15_05,URUGUAY,19040,22,reque newsome,15,2,4,50,2,4,50,0,0,0,2,2,100,1,4,5,0,1,0,1,1,6
428456,480_15_05,URUGUAY,23760,33,kiril wachsmann,16,0,3,0,0,3,0,0,0,0,0,0,0,0,3,3,0,2,2,0,0,0
428457,480_15_05,URUGUAY,28747,41,demian alvarez,8,1,1,100,0,0,0,1,1,100,0,0,0,0,0,0,1,2,0,0,1,3
428458,480_15_05,URUGUAY,0,TOTALS,URUGUAY,200,25,64,39.1,19,38,50,6,26,23.1,15,23,65.2,12,23,35,21,22,13,8,2,71
428459,480_15_06,CANADA,16951,4,philip scrubb,15,2,8,25,2,7,28.6,0,1,0,1,1,100,1,0,1,5,1,1,0,0,5
428460,480_15_06,CANADA,8989,5,cory joseph,25,3,9,33.3,3,8,37.5,0,1,0,2,2,100,0,2,2,7,3,0,2,0,8
428461,480_15_06,CANADA,28756,6,melvin ejim,13,1,2,50,1,2,50,0,0,0,5,7,71.4,1,1,2,0,3,0,0,0,7
428462,480_15_06,CANADA,23739,7,andrew nicholson,10,1,1,100,1,1,100,0,0,0,0,0,0,1,2,3,0,2,2,0,0,2
428463,480_15_06,CANADA,16670,8,andrew wiggins,30,5,9,55.6,4,5,80,1,4,25,2,3,66.7,0,6,6,3,4,2,1,0,13
428464,480_15_06,CANADA,14711,9,nikolas stauskas,20,2,5,40,1,2,50,1,3,33.3,2,2,100,0,1,1,2,1,0,1,0,7
428465,480_15_06,CANADA,14713,10,anthony bennett,21,6,9,66.7,5,7,71.4,1,2,50,0,2,0,1,5,6,0,4,2,0,1,13
428466,480_15_06,CANADA,3485,11,aaron doornekamp,4,0,2,0,0,1,0,0,1,0,0,0,0,1,2,3,1,1,0,0,0,0
428467,480_15_06,CANADA,23740,12,brady heslip,23,4,8,50,1,4,25,3,4,75,0,0,0,0,1,1,0,1,0,0,0,11
428468,480_15_06,CANADA,12219,13,kelly olynyk,23,4,13,30.8,4,9,44.4,0,4,0,3,3,100,5,5,10,4,3,3,0,1,11
428469,480_15_06,CANADA,28757,14,dwight powell,10,2,4,50,2,4,50,0,0,0,3,6,50,2,2,4,0,1,2,0,0,7
428470,480_15_06,CANADA,7510,15,robert sacre,6,1,3,33.3,1,3,33.3,0,0,0,1,2,50,0,0,0,0,1,1,0,0,3
428471,480_15_06,CANADA,0,TOTALS,CANADA,200,31,73,42.5,25,53,47.2,6,20,30,19,28,67.9,14,30,44,22,25,13,4,2,87
428472,480_15_06,ARGENTINA,80,4,luis scola,34,13,26,50,13,23,56.5,0,3,0,9,14,64.3,5,8,13,2,3,1,2,0,35
428473,480_15_06,ARGENTINA,25731,5,nicolas richotti,9,0,1,0,0,1,0,0,0,0,0,0,0,0,0,0,2,0,0,1,0,0
428474,480_15_06,ARGENTINA,21037,7,facundo campazzo,18,4,5,80,4,5,80,0,0,0,2,2,100,0,3,3,6,4,2,2,0,10
428475,480_15_06,ARGENTINA,12228,8,nicolas laprovittola,22,8,12,66.7,7,10,70,1,2,50,3,3,100,1,3,4,4,2,2,0,0,20
428476,480_15_06,ARGENTINA,25732,9,nicolas brussino,2,0,0,0,0,0,0,0,0,0,0,0,0,1,0,1,0,0,0,0,0,0
428477,480_15_06,ARGENTINA,14903,12,marcos delia,10,0,1,0,0,1,0,0,0,0,0,0,0,1,4,5,2,1,0,0,2,0
428478,480_15_06,ARGENTINA,82,13,andres nocioni,28,5,15,33.3,3,8,37.5,2,7,28.6,3,3,100,1,4,5,0,3,0,0,0,15
428479,480_15_06,ARGENTINA,15007,14,gabriel deck,13,1,1,100,1,1,100,0,0,0,0,0,0,1,3,4,0,3,1,0,0,2
428480,480_15_06,ARGENTINA,21197,15,selem safar,19,0,3,0,0,2,0,0,1,0,2,3,66.7,0,1,1,1,3,2,0,0,2
428481,480_15_06,ARGENTINA,459,19,leo mainoldi,10,2,7,28.6,0,2,0,2,5,40,0,0,0,1,1,2,0,3,0,0,0,6
428482,480_15_06,ARGENTINA,12296,29,patricio garino,27,1,4,25,1,3,33.3,0,1,0,0,0,0,2,1,3,0,1,1,1,0,2
428483,480_15_06,ARGENTINA,16652,83,tayavek gallizzi,8,1,2,50,1,2,50,0,0,0,0,0,0,1,3,4,0,2,0,0,0,2
428484,480_15_06,ARGENTINA,0,TOTALS,ARGENTINA,200,35,77,45.5,30,58,51.7,5,19,26.3,19,25,76,15,33,48,17,25,10,6,2,94
428485,480_15_07,BRAZIL,28748,4,ricardo fischer,25,4,9,44.4,2,5,40,2,4,50,0,0,0,3,2,5,2,2,0,1,0,10
428486,480_15_07,BRAZIL,7622,5,rafael luz,15,1,4,25,1,3,33.3,0,1,0,1,3,33.3,0,0,0,3,3,3,0,1,3
428487,480_15_07,BRAZIL,19019,6,augusto lima,16,3,4,75,3,4,75,0,0,0,0,0,0,1,4,5,1,3,2,0,1,6
428488,480_15_07,BRAZIL,15053,7,deryk ramos,0,0,0,0,0,0,0,0,0,0,0,0,0,0,0,0,0,0,0,0,0,0
428489,480_15_07,BRAZIL,7625,8,vitor benite,36,5,17,29.4,3,10,30,2,7,28.6,1,1,100,2,4,6,3,3,0,0,0,13
428490,480_15_07,BRAZIL,14737,9,leo meindl,18,2,6,33.3,2,3,66.7,0,3,0,1,2,50,2,1,3,3,4,1,0,0,5
428491,480_15_07,BRAZIL,14634,10,carlos olivinha,16,1,5,20,1,4,25,0,1,0,0,0,0,2,2,4,1,1,1,1,0,2
428492,480_15_07,BRAZIL,28749,11,rafael mineiro,6,0,2,0,0,1,0,0,1,0,0,0,0,0,1,1,0,1,1,0,0,0
428493,480_15_07,BRAZIL,4104,12,guilherme giovannoni,19,2,3,66.7,1,1,100,1,2,50,0,0,0,0,5,5,3,2,1,0,0,5
428494,480_15_07,BRAZIL,9843,13,j p batista,24,4,8,50,4,8,50,0,0,0,2,2,100,2,7,9,2,4,1,1,0,10
428495,480_15_07,BRAZIL,28750,14,viera marquinhos,26,5,11,45.5,3,5,60,2,6,33.3,5,7,71.4,1,1,2,2,5,3,1,1,17
428496,480_15_07,BRAZIL,483,15,marcus toledo,0,0,0,0,0,0,0,0,0,0,0,0,0,0,0,0,0,0,0,0,0,0
428497,480_15_07,BRAZIL,0,TOTALS,BRAZIL,200,27,69,39.1,20,44,45.5,7,25,28,10,15,66.7,13,28,41,20,28,13,4,3,71
428498,480_15_07,DOMINICAN REPUBLIC,19011,4,edgar sosa,23,3,9,33.3,3,6,50,0,3,0,5,7,71.4,1,1,2,3,4,4,0,0,11
428499,480_15_07,DOMINICAN REPUBLIC,25436,5,victor liz,0,0,0,0,0,0,0,0,0,0,0,0,0,0,0,0,0,0,0,0,0,0
428500,480_15_07,DOMINICAN REPUBLIC,28752,6,rigoberto mendoza,15,5,6,83.3,3,4,75,2,2,100,2,2,100,1,2,3,2,0,2,0,0,14
428501,480_15_07,DOMINICAN REPUBLIC,21234,7,angel suero,11,0,3,0,0,2,0,0,1,0,1,2,50,0,1,1,0,3,0,0,0,1
428502,480_15_07,DOMINICAN REPUBLIC,23761,8,edward santana,15,0,4,0,0,4,0,0,0,0,0,0,0,2,8,10,0,1,1,1,1,0
428503,480_15_07,DOMINICAN REPUBLIC,4116,9,francisco garcia,29,0,6,0,0,3,0,0,3,0,5,6,83.3,0,2,2,2,2,1,2,0,5
428504,480_15_07,DOMINICAN REPUBLIC,23762,10,james feldeine,32,6,12,50,2,6,33.3,4,6,66.7,4,4,100,1,2,3,2,1,2,1,0,20
428505,480_15_07,DOMINICAN REPUBLIC,19070,11,eloy vargas,16,1,2,50,1,2,50,0,0,0,2,4,50,0,4,4,0,3,3,0,1,4
428506,480_15_07,DOMINICAN REPUBLIC,19016,12,orlando sanchez,19,0,3,0,0,2,0,0,1,0,0,0,0,0,1,1,0,2,1,0,0,0
428507,480_15_07,DOMINICAN REPUBLIC,9947,13,eulis baez,18,1,4,25,1,4,25,0,0,0,2,2,100,0,2,2,2,0,0,1,0,4
428508,480_15_07,DOMINICAN REPUBLIC,4114,14,luis flores,7,0,0,0,0,0,0,0,0,0,0,0,0,0,1,1,1,1,1,0,0,0
428509,480_15_07,DOMINICAN REPUBLIC,28753,15,juan jose garcia,15,3,6,50,3,5,60,0,1,0,0,2,0,0,3,3,1,0,0,0,0,6
428510,480_15_07,DOMINICAN REPUBLIC,0,TOTALS,DOMINICAN REPUBLIC,200,19,55,34.5,13,38,34.2,6,17,35.3,21,29,72.4,12,30,42,13,17,16,5,2,65
428511,480_15_08,PUERTO RICO,23748,1,ramon clemente,12,0,2,0,0,2,0,0,0,0,1,2,50,2,2,4,0,5,1,0,0,1
428512,480_15_08,PUERTO RICO,14636,2,guillermo diaz,11,2,4,50,1,3,33.3,1,1,100,1,1,100,0,1,1,0,0,0,0,0,6
428513,480_15_08,PUERTO RICO,19036,5,jose juan barea,20,7,12,58.3,4,6,66.7,3,6,50,2,2,100,1,3,4,6,1,2,0,0,19
428514,480_15_08,PUERTO RICO,23749,6,richard chaney,18,2,2,100,1,1,100,1,1,100,6,6,100,0,3,3,3,2,2,4,0,11
428515,480_15_08,PUERTO RICO,28751,7,javier gonzalez,9,2,3,66.7,2,2,100,0,1,0,1,2,50,1,0,1,2,1,1,2,0,5
428516,480_15_08,PUERTO RICO,3479,8,angel vassallo,27,6,11,54.5,4,4,100,2,7,28.6,2,2,100,1,5,6,1,3,3,1,0,16
428517,480_15_08,PUERTO RICO,8997,9,jorge bryan diaz,21,3,7,42.9,3,7,42.9,0,0,0,1,2,50,2,5,7,1,5,0,2,1,7
428518,480_15_08,PUERTO RICO,103,10,larry ayuso,19,3,9,33.3,2,6,33.3,1,3,33.3,0,1,0,0,1,1,1,2,1,0,0,7
428519,480_15_08,PUERTO RICO,23750,11,luis villafane,13,0,0,0,0,0,0,0,0,0,0,2,0,1,1,2,1,2,0,1,1,0
428520,480_15_08,PUERTO RICO,16592,13,renaldo balkman,28,5,11,45.5,4,10,40,1,1,100,3,4,75,1,5,6,2,3,2,1,1,14
428521,480_15_08,PUERTO RICO,19067,23,john holland,8,0,1,0,0,1,0,0,0,0,2,2,100,0,1,1,0,0,0,0,0,2
428522,480_15_08,PUERTO RICO,25443,31,carlos rivera,14,1,4,25,1,3,33.3,0,1,0,1,2,50,0,2,2,4,2,0,1,0,3
428523,480_15_08,PUERTO RICO,0,TOTALS,PUERTO RICO,200,31,66,47,22,45,48.9,9,21,42.9,20,28,71.4,11,30,41,21,26,12,12,3,91
428524,480_15_08,CUBA,25953,4,karel guzman,21,2,5,40,2,5,40,0,0,0,2,2,100,4,3,7,2,2,4,3,0,6
428525,480_15_08,CUBA,16888,5,osmel oliva,23,1,6,16.7,1,5,20,0,1,0,0,0,0,2,0,2,4,4,1,0,0,2
428526,480_15_08,CUBA,25804,6,javier justiz,20,2,9,22.2,2,9,22.2,0,0,0,3,6,50,4,2,6,0,2,2,0,1,7
428527,480_15_08,CUBA,16887,7,yaser rodriguez,14,0,2,0,0,2,0,0,0,0,0,0,0,1,1,2,2,2,3,0,0,0
428528,480_15_08,CUBA,28743,9,lisvan valdes,15,0,5,0,0,1,0,0,4,0,1,2,50,1,1,2,0,1,0,0,0,1
428529,480_15_08,CUBA,7259,10,william granda,19,1,5,20,0,3,0,1,2,50,0,0,0,0,0,0,0,2,0,0,0,3
428530,480_15_08,CUBA,25954,11,yuniskel molina,9,0,1,0,0,1,0,0,0,0,0,0,0,0,0,0,0,3,2,0,0,0
428531,480_15_08,CUBA,393,12,yoan haiti,29,5,11,45.5,3,8,37.5,2,3,66.7,6,6,100,1,12,13,4,5,4,1,0,18
428532,480_15_08,CUBA,25805,13,esteban martinez,3,0,0,0,0,0,0,0,0,0,0,0,0,0,0,0,0,0,0,0,0,0
428533,480_15_08,CUBA,7260,14,orestes torres,13,0,2,0,0,1,0,0,1,0,2,2,100,1,4,5,0,1,1,0,0,2
428534,480_15_08,CUBA,25806,15,jasiel rivero,34,7,16,43.8,5,13,38.5,2,3,66.7,4,9,44.4,3,3,6,1,3,2,1,2,20
428535,480_15_08,CUBA,28744,16,yoel cubilla,2,0,0,0,0,0,0,0,0,0,2,2,100,0,1,1,0,0,0,0,0,2
428536,480_15_08,CUBA,0,TOTALS,CUBA,200,18,62,29,13,48,27.1,5,14,35.7,20,29,69,18,27,45,13,25,20,5,3,61
428537,480_15_09,DOMINICAN REPUBLIC,19011,4,edgar sosa,23,4,7,57.1,3,6,50,1,1,100,2,2,100,1,1,2,6,0,1,1,0,11
428538,480_15_09,DOMINICAN REPUBLIC,25436,5,victor liz,5,0,1,0,0,1,0,0,0,0,0,0,0,0,0,0,0,2,1,1,0,0
428539,480_15_09,DOMINICAN REPUBLIC,28752,6,rigoberto mendoza,24,2,4,50,2,3,66.7,0,1,0,1,2,50,1,5,6,2,3,3,1,0,5
428540,480_15_09,DOMINICAN REPUBLIC,21234,7,angel suero,0,0,0,0,0,0,0,0,0,0,0,0,0,0,0,0,0,0,0,0,0,0
428541,480_15_09,DOMINICAN REPUBLIC,23761,8,edward santana,17,4,8,50,4,8,50,0,0,0,1,1,100,2,5,7,0,2,0,0,0,9
428542,480_15_09,DOMINICAN REPUBLIC,4116,9,francisco garcia,22,3,9,33.3,1,1,100,2,8,25,0,0,0,0,3,3,3,3,3,0,2,8
428543,480_15_09,DOMINICAN REPUBLIC,23762,10,james feldeine,31,6,16,37.5,3,9,33.3,3,7,42.9,1,3,33.3,0,2,2,5,1,4,2,1,16
428544,480_15_09,DOMINICAN REPUBLIC,19070,11,eloy vargas,21,2,9,22.2,2,9,22.2,0,0,0,3,6,50,3,6,9,0,2,1,2,1,7
428545,480_15_09,DOMINICAN REPUBLIC,19016,12,orlando sanchez,18,2,3,66.7,1,2,50,1,1,100,0,2,0,0,5,5,2,2,1,1,0,5
428546,480_15_09,DOMINICAN REPUBLIC,9947,13,eulis baez,21,4,9,44.4,2,2,100,2,7,28.6,3,4,75,0,3,3,3,5,0,0,0,13
428547,480_15_09,DOMINICAN REPUBLIC,4114,14,luis flores,0,0,0,0,0,0,0,0,0,0,0,0,0,0,0,0,0,0,0,0,0,0
428548,480_15_09,DOMINICAN REPUBLIC,28753,15,juan jose garcia,18,4,5,80,3,4,75,1,1,100,0,0,0,4,3,7,0,3,1,1,0,9
428549,480_15_09,DOMINICAN REPUBLIC,0,TOTALS,DOMINICAN REPUBLIC,200,31,71,43.7,21,45,46.7,10,26,38.5,11,20,55,14,35,49,21,23,15,9,4,83
428550,480_15_09,PANAMA,4091,4,joel munoz,9,0,1,0,0,0,0,0,1,0,0,0,0,0,1,1,0,2,1,0,0,0
428551,480_15_09,PANAMA,25940,5,trevor gaskins,31,3,13,23.1,2,8,25,1,5,20,0,0,0,1,6,7,5,4,4,2,0,7
428552,480_15_09,PANAMA,4139,6,danilo pinnock,30,2,7,28.6,1,2,50,1,5,20,2,2,100,1,3,4,1,0,0,0,0,7
428553,480_15_09,PANAMA,28755,7,jamelle horne,2,0,0,0,0,0,0,0,0,0,0,0,0,0,0,0,0,0,0,0,0,0
428554,480_15_09,PANAMA,4526,8,jonathan king,1,0,0,0,0,0,0,0,0,0,0,0,0,0,0,0,0,0,0,0,0,0
428555,480_15_09,PANAMA,6822,9,jamaal levy,14,0,1,0,0,0,0,0,1,0,3,5,60,1,2,3,0,0,0,1,0,3
428556,480_15_09,PANAMA,19035,10,josimar ayarza,25,3,13,23.1,1,4,25,2,9,22.2,7,9,77.8,1,4,5,1,2,1,0,0,15
428557,480_15_09,PANAMA,401,11,michael hicks,27,4,14,28.6,4,10,40,0,4,0,4,4,100,1,3,4,1,4,3,1,1,12
428558,480_15_09,PANAMA,4529,12,ernesto oglivie,8,0,0,0,0,0,0,0,0,0,2,2,100,1,2,3,0,0,1,0,0,2
428559,480_15_09,PANAMA,14640,13,leonardo pomare,21,2,5,40,2,5,40,0,0,0,0,0,0,4,3,7,2,4,3,0,1,4
428560,480_15_09,PANAMA,25810,14,jaime lloreda,29,6,13,46.2,6,12,50,0,1,0,4,6,66.7,4,6,10,2,2,2,4,0,16
428561,480_15_09,PANAMA,6820,15,ruben garces,4,0,1,0,0,1,0,0,0,0,0,0,0,0,0,0,0,0,0,0,0,0
428562,480_15_09,PANAMA,0,TOTALS,PANAMA,200,20,68,29.4,16,42,38.1,4,26,15.4,22,28,78.6,16,30,46,12,18,15,8,2,66
428563,480_15_10,CUBA,25953,4,karel guzman,29,0,7,0,0,4,0,0,3,0,2,2,100,2,1,3,2,3,1,0,0,2
428564,480_15_10,CUBA,16888,5,osmel oliva,6,0,1,0,0,0,0,0,1,0,0,0,0,0,0,0,0,0,0,0,0,0
428565,480_15_10,CUBA,25804,6,javier justiz,14,2,5,40,2,5,40,0,0,0,0,0,0,2,6,8,0,5,2,0,1,4
428566,480_15_10,CUBA,16887,7,yaser rodriguez,29,1,6,16.7,1,4,25,0,2,0,0,0,0,0,5,5,4,2,0,0,0,2
428567,480_15_10,CUBA,28743,9,lisvan valdes,17,2,10,20,2,7,28.6,0,3,0,2,2,100,3,1,4,1,5,0,1,0,6
428568,480_15_10,CUBA,7259,10,william granda,23,2,11,18.2,1,7,14.3,1,4,25,2,4,50,0,2,2,6,2,0,0,0,7
428569,480_15_10,CUBA,25954,11,yuniskel molina,6,0,1,0,0,1,0,0,0,0,0,0,0,0,0,0,0,0,0,0,0,0
428570,480_15_10,CUBA,393,12,yoan haiti,20,4,8,50,2,5,40,2,3,66.7,0,0,0,1,1,2,0,3,1,0,0,10
428571,480_15_10,CUBA,25805,13,esteban martinez,9,0,3,0,0,3,0,0,0,0,2,2,100,0,0,0,0,0,0,0,0,2
428572,480_15_10,CUBA,7260,14,orestes torres,8,1,8,12.5,1,7,14.3,0,1,0,0,0,0,0,1,1,0,0,2,0,0,2
428573,480_15_10,CUBA,25806,15,jasiel rivero,31,7,13,53.8,5,10,50,2,3,66.7,4,5,80,1,6,7,1,5,1,0,2,20
428574,480_15_10,CUBA,28744,16,yoel cubilla,8,2,3,66.7,2,3,66.7,0,0,0,0,0,0,1,1,2,0,3,0,0,0,4
428575,480_15_10,CUBA,0,TOTALS,CUBA,200,21,76,27.6,16,56,28.6,5,20,25,12,15,80,12,30,42,14,28,7,1,3,59
428576,480_15_10,CANADA,16951,4,philip scrubb,20,3,6,50,1,3,33.3,2,3,66.7,1,2,50,0,5,5,5,0,1,0,0,9
428577,480_15_10,CANADA,8989,5,cory joseph,20,3,5,60,3,5,60,0,0,0,0,0,0,1,3,4,6,0,1,0,0,6
428578,480_15_10,CANADA,28756,6,melvin ejim,13,2,5,40,2,4,50,0,1,0,1,2,50,1,5,6,0,1,0,0,2,5
428579,480_15_10,CANADA,23739,7,andrew nicholson,13,1,2,50,1,1,100,0,1,0,0,0,0,0,4,4,1,2,0,0,1,2
428580,480_15_10,CANADA,16670,8,andrew wiggins,21,5,11,45.5,4,7,57.1,1,4,25,4,5,80,4,2,6,1,0,1,1,2,15
428581,480_15_10,CANADA,14711,9,nikolas stauskas,23,5,11,45.5,4,4,100,1,7,14.3,4,4,100,0,6,6,4,2,0,0,0,15
428582,480_15_10,CANADA,14713,10,anthony bennett,14,4,7,57.1,4,6,66.7,0,1,0,1,3,33.3,1,3,4,1,0,0,0,0,9
428583,480_15_10,CANADA,3485,11,aaron doornekamp,15,2,3,66.7,1,1,100,1,2,50,2,2,100,1,8,9,5,3,1,2,0,7
428584,480_15_10,CANADA,23740,12,brady heslip,17,4,10,40,0,3,0,4,7,57.1,0,0,0,0,0,0,3,3,0,0,0,12
428585,480_15_10,CANADA,12219,13,kelly olynyk,16,2,6,33.3,2,6,33.3,0,0,0,2,2,100,1,2,3,1,4,0,1,1,6
428586,480_15_10,CANADA,28757,14,dwight powell,13,3,5,60,3,5,60,0,0,0,4,6,66.7,0,2,2,1,1,1,0,2,10
428587,480_15_10,CANADA,7510,15,robert sacre,14,1,2,50,1,2,50,0,0,0,3,5,60,0,3,3,1,0,0,0,0,5
428588,480_15_10,CANADA,0,TOTALS,CANADA,200,35,73,47.9,26,47,55.3,9,26,34.6,22,31,71,14,44,58,29,16,5,4,8,101
428589,480_15_11,VENEZUELA,514,4,miguel marriaga,2,0,0,0,0,0,0,0,0,0,0,0,0,0,0,0,0,1,0,0,0,0
428590,480_15_11,VENEZUELA,16828,5,gregory vargas,23,2,5,40,2,2,100,0,3,0,3,4,75,0,3,3,6,3,3,2,0,7
428591,480_15_11,VENEZUELA,21053,6,john cox,29,5,12,41.7,4,9,44.4,1,3,33.3,0,0,0,2,4,6,2,1,1,0,0,11
428592,480_15_11,VENEZUELA,16829,8,david cubillan,5,0,3,0,0,2,0,0,1,0,0,0,0,0,0,0,0,1,2,0,0,0
428593,480_15_11,VENEZUELA,9857,10,jose vargas,30,5,8,62.5,3,5,60,2,3,66.7,0,0,0,1,3,4,1,2,0,2,0,12
428594,480_15_11,VENEZUELA,28745,11,cesar garcia,1,0,0,0,0,0,0,0,0,0,0,0,0,0,0,0,0,0,1,0,0,0
428595,480_15_11,VENEZUELA,9984,12,javinger vargas,10,3,3,100,0,0,0,3,3,100,0,0,0,0,0,0,0,0,0,0,0,9
428596,480_15_11,VENEZUELA,25751,14,miguel ruiz,16,2,2,100,2,2,100,0,0,0,2,2,100,3,2,5,2,2,0,0,2,6
428597,480_15_11,VENEZUELA,19026,15,windi graterol,22,5,9,55.6,3,5,60,2,4,50,1,2,50,1,2,3,2,0,4,0,2,13
428598,480_15_11,VENEZUELA,19021,19,heissler guillent,19,2,3,66.7,1,2,50,1,1,100,1,4,25,0,1,1,4,2,1,0,0,6
428599,480_15_11,VENEZUELA,19023,21,dwight lewis,11,0,4,0,0,1,0,0,3,0,0,0,0,0,0,0,1,3,0,0,0,0
428600,480_15_11,VENEZUELA,19022,43,nestor colmenares,32,5,8,62.5,5,7,71.4,0,1,0,0,2,0,1,4,5,3,2,2,2,1,10
428601,480_15_11,VENEZUELA,0,TOTALS,VENEZUELA,200,29,57,50.9,20,35,57.1,9,22,40.9,7,14,50,11,23,34,21,17,15,6,5,74
428602,480_15_11,PUERTO RICO,23748,1,ramon clemente,18,1,3,33.3,1,3,33.3,0,0,0,0,0,0,2,3,5,1,0,1,0,0,2
428603,480_15_11,PUERTO RICO,14636,2,guillermo diaz,3,0,1,0,0,0,0,0,1,0,0,0,0,0,1,1,0,0,0,0,0,0
428604,480_15_11,PUERTO RICO,19036,5,jose juan barea,27,7,14,50,4,9,44.4,3,5,60,3,4,75,1,2,3,5,2,1,2,0,20
428605,480_15_11,PUERTO RICO,23749,6,richard chaney,9,0,0,0,0,0,0,0,0,0,1,2,50,0,0,0,0,2,1,0,0,1
428606,480_15_11,PUERTO RICO,28751,7,javier gonzalez,6,1,2,50,1,1,100,0,1,0,0,0,0,0,1,1,2,1,0,0,0,2
428607,480_15_11,PUERTO RICO,3479,8,angel vassallo,31,3,6,50,1,1,100,2,5,40,0,0,0,0,3,3,2,2,1,1,0,8
428608,480_15_11,PUERTO RICO,8997,9,jorge bryan diaz,34,3,4,75,3,4,75,0,0,0,2,3,66.7,2,2,4,3,3,4,0,0,8
428609,480_15_11,PUERTO RICO,103,10,larry ayuso,16,1,3,33.3,1,2,50,0,1,0,0,0,0,0,0,0,1,3,1,1,0,2
428610,480_15_11,PUERTO RICO,23750,11,luis villafane,0,0,0,0,0,0,0,0,0,0,0,0,0,0,0,0,0,0,0,0,0,0
428611,480_15_11,PUERTO RICO,16592,13,renaldo balkman,30,9,14,64.3,9,13,69.2,0,1,0,0,0,0,0,1,1,0,4,5,4,1,18
428612,480_15_11,PUERTO RICO,19067,23,john holland,7,0,1,0,0,0,0,0,1,0,0,0,0,0,2,2,1,1,1,0,0,0
428613,480_15_11,PUERTO RICO,25443,31,carlos rivera,19,0,3,0,0,2,0,0,1,0,2,2,100,0,0,0,2,2,1,2,0,2
428614,480_15_11,PUERTO RICO,0,TOTALS,PUERTO RICO,200,25,51,49,20,35,57.1,5,16,31.2,8,11,72.7,5,19,24,17,20,16,10,1,63
428615,480_15_12,MEXICO,16880,4,paul stoll,11,0,2,0,0,1,0,0,1,0,0,0,0,0,1,1,2,0,0,1,0,0
428616,480_15_12,MEXICO,23812,5,marco ramos,6,1,4,25,1,2,50,0,2,0,0,0,0,4,1,5,0,0,0,0,0,2
428617,480_15_12,MEXICO,28754,6,juan toscano,35,2,9,22.2,1,6,16.7,1,3,33.3,0,0,0,3,1,4,3,5,2,1,1,5
428618,480_15_12,MEXICO,23756,7,jorge gutierrez,29,5,10,50,5,8,62.5,0,2,0,3,4,75,1,6,7,4,1,3,1,0,13
428619,480_15_12,MEXICO,9836,8,gustavo ayon,39,12,19,63.2,12,19,63.2,0,0,0,3,4,75,7,6,13,1,3,4,5,0,27
428620,480_15_12,MEXICO,23813,9,francisco cruz,13,1,3,33.3,1,2,50,0,1,0,0,0,0,0,0,0,1,1,2,0,0,2
428621,480_15_12,MEXICO,21214,10,gabriel giron,0,0,0,0,0,0,0,0,0,0,0,0,0,0,0,0,0,0,0,0,0,0
428622,480_15_12,MEXICO,9834,11,pedro meza,0,0,0,0,0,0,0,0,0,0,0,0,0,0,0,0,0,0,0,0,0,0
428623,480_15_12,MEXICO,9835,12,hector hernandez,31,1,10,10,1,3,33.3,0,7,0,4,4,100,0,4,4,2,3,1,2,1,6
428624,480_15_12,MEXICO,21215,13,orlando mendez,26,1,6,16.7,1,3,33.3,0,3,0,6,7,85.7,0,3,3,1,4,0,1,0,8
428625,480_15_12,MEXICO,25446,14,adrian zamora,0,0,0,0,0,0,0,0,0,0,0,0,0,0,0,0,0,0,0,0,0,0
428626,480_15_12,MEXICO,25444,15,israel gutierrez,9,1,2,50,1,2,50,0,0,0,0,0,0,2,1,3,0,1,1,0,0,2
428627,480_15_12,MEXICO,0,TOTALS,MEXICO,200,24,65,36.9,23,46,50,1,19,5.3,16,19,84.2,20,24,44,14,18,14,11,2,65
428628,480_15_12,BRAZIL,28748,4,ricardo fischer,13,0,0,0,0,0,0,0,0,0,0,0,0,1,1,2,4,0,2,0,0,0
428629,480_15_12,BRAZIL,7622,5,rafael luz,27,1,7,14.3,1,5,20,0,2,0,0,0,0,1,3,4,1,3,2,0,0,2
428630,480_15_12,BRAZIL,19019,6,augusto lima,23,3,8,37.5,3,8,37.5,0,0,0,2,2,100,4,2,6,1,3,1,3,0,8
428631,480_15_12,BRAZIL,15053,7,deryk ramos,0,0,0,0,0,0,0,0,0,0,0,0,0,0,0,0,0,0,0,0,0,0
428632,480_15_12,BRAZIL,7625,8,vitor benite,34,5,12,41.7,2,8,25,3,4,75,10,12,83.3,0,4,4,2,2,2,1,0,23
428633,480_15_12,BRAZIL,14737,9,leo meindl,19,1,3,33.3,1,3,33.3,0,0,0,2,2,100,0,1,1,2,3,2,0,0,4
428634,480_15_12,BRAZIL,14634,10,carlos olivinha,11,1,1,100,1,1,100,0,0,0,1,1,100,0,1,1,0,1,1,0,0,3
428635,480_15_12,BRAZIL,28749,11,rafael mineiro,20,2,4,50,2,3,66.7,0,1,0,1,2,50,0,3,3,0,2,1,0,1,5
428636,480_15_12,BRAZIL,4104,12,guilherme giovannoni,15,2,6,33.3,1,3,33.3,1,3,33.3,0,0,0,1,0,1,1,2,0,0,0,5
428637,480_15_12,BRAZIL,9843,13,j p batista,10,3,7,42.9,3,7,42.9,0,0,0,0,0,0,0,2,2,0,3,1,0,0,6
428638,480_15_12,BRAZIL,28750,14,viera marquinhos,26,0,3,0,0,0,0,0,3,0,2,2,100,0,4,4,1,1,2,1,0,2
428639,480_15_12,BRAZIL,483,15,marcus toledo,0,0,0,0,0,0,0,0,0,0,0,0,0,0,0,0,0,0,0,0,0,0
428640,480_15_12,BRAZIL,0,TOTALS,BRAZIL,200,18,51,35.3,14,38,36.8,4,13,30.8,18,21,85.7,9,22,31,12,20,18,5,1,58
428641,480_15_13,URUGUAY,28746,4,santiago vidal,14,0,3,0,0,1,0,0,2,0,2,2,100,2,2,4,2,0,0,0,0,2
428642,480_15_13,URUGUAY,7588,5,bruno fitipaldo,28,6,14,42.9,3,4,75,3,10,30,3,4,75,1,1,2,3,3,3,0,0,18
428643,480_15_13,URUGUAY,298,6,mauricio aguiar,29,6,17,35.3,6,13,46.2,0,4,0,3,6,50,0,3,3,3,4,0,0,0,15
428644,480_15_13,URUGUAY,7590,7,mathias calfani,11,1,2,50,1,2,50,0,0,0,0,0,0,0,0,0,0,3,1,0,0,2
428645,480_15_13,URUGUAY,12235,10,marcel souberbielle,2,0,1,0,0,0,0,0,1,0,0,0,0,0,0,0,0,0,0,0,0,0
428646,480_15_13,URUGUAY,296,11,martin osimani,27,1,7,14.3,1,2,50,0,5,0,0,0,0,2,0,2,2,0,4,0,0,2
428647,480_15_13,URUGUAY,14992,13,hernando caceres,5,0,1,0,0,0,0,0,1,0,0,0,0,0,2,2,0,3,0,0,0,0
428648,480_15_13,URUGUAY,4134,14,nicolas borsellino,18,6,10,60,6,9,66.7,0,1,0,1,1,100,3,1,4,2,4,0,1,0,13
428649,480_15_13,URUGUAY,12278,21,luciano parodi,14,2,3,66.7,2,3,66.7,0,0,0,0,0,0,0,1,1,2,3,1,1,0,4
428650,480_15_13,URUGUAY,19040,22,reque newsome,24,4,5,80,4,5,80,0,0,0,1,2,50,1,5,6,0,3,3,0,4,9
428651,480_15_13,URUGUAY,23760,33,kiril wachsmann,22,0,2,0,0,2,0,0,0,0,3,6,50,5,7,12,1,0,2,0,1,3
428652,480_15_13,URUGUAY,28747,41,demian alvarez,7,1,3,33.3,1,2,50,0,1,0,0,0,0,0,1,1,0,3,0,0,0,2
428653,480_15_13,URUGUAY,0,TOTALS,URUGUAY,200,27,68,39.7,24,43,55.8,3,25,12,13,21,61.9,16,25,41,15,26,14,2,5,70
428654,480_15_13,DOMINICAN REPUBLIC,19011,4,edgar sosa,32,4,11,36.4,2,5,40,2,6,33.3,4,4,100,1,4,5,3,2,2,2,0,14
428655,480_15_13,DOMINICAN REPUBLIC,25436,5,victor liz,20,2,4,50,1,2,50,1,2,50,2,2,100,0,2,2,3,2,1,1,0,7
428656,480_15_13,DOMINICAN REPUBLIC,28752,6,rigoberto mendoza,20,4,6,66.7,3,3,100,1,3,33.3,0,0,0,0,1,1,2,1,2,1,0,9
428657,480_15_13,DOMINICAN REPUBLIC,21234,7,angel suero,0,0,0,0,0,0,0,0,0,0,0,0,0,0,0,0,0,0,0,0,0,0
428658,480_15_13,DOMINICAN REPUBLIC,23761,8,edward santana,26,4,7,57.1,4,7,57.1,0,0,0,8,12,66.7,0,4,4,0,2,2,1,0,16
428659,480_15_13,DOMINICAN REPUBLIC,4116,9,francisco garcia,22,2,8,25,0,0,0,2,8,25,0,0,0,0,3,3,1,4,0,2,1,6
428660,480_15_13,DOMINICAN REPUBLIC,23762,10,james feldeine,30,6,9,66.7,2,3,66.7,4,6,66.7,1,2,50,0,2,2,5,2,1,1,0,17
428661,480_15_13,DOMINICAN REPUBLIC,19070,11,eloy vargas,19,3,5,60,3,5,60,0,0,0,1,2,50,1,3,4,0,5,2,1,0,7
428662,480_15_13,DOMINICAN REPUBLIC,19016,12,orlando sanchez,0,0,0,0,0,0,0,0,0,0,0,0,0,0,0,0,0,0,0,0,0,0
428663,480_15_13,DOMINICAN REPUBLIC,9947,13,eulis baez,31,5,7,71.4,3,3,100,2,4,50,2,3,66.7,2,5,7,7,3,1,1,0,14
428664,480_15_13,DOMINICAN REPUBLIC,4114,14,luis flores,0,0,0,0,0,0,0,0,0,0,0,0,0,0,0,0,0,0,0,0,0,0
428665,480_15_13,DOMINICAN REPUBLIC,28753,15,juan jose garcia,0,0,0,0,0,0,0,0,0,0,0,0,0,0,0,0,0,0,0,0,0,0
428666,480_15_13,DOMINICAN REPUBLIC,0,TOTALS,DOMINICAN REPUBLIC,200,30,57,52.6,18,28,64.3,12,29,41.4,18,25,72,5,27,32,21,21,12,10,1,90
428667,480_15_14,ARGENTINA,80,4,luis scola,23,5,10,50,5,10,50,0,0,0,1,2,50,1,7,8,1,1,3,0,3,11
428668,480_15_14,ARGENTINA,25731,5,nicolas richotti,14,1,4,25,1,3,33.3,0,1,0,2,4,50,0,1,1,3,0,0,0,1,4
428669,480_15_14,ARGENTINA,21037,7,facundo campazzo,16,3,7,42.9,3,7,42.9,0,0,0,2,2,100,0,0,0,3,0,0,1,0,8
428670,480_15_14,ARGENTINA,12228,8,nicolas laprovittola,19,4,9,44.4,1,4,25,3,5,60,0,1,0,0,2,2,7,1,1,1,0,11
428671,480_15_14,ARGENTINA,25732,9,nicolas brussino,21,2,5,40,1,1,100,1,4,25,1,2,50,0,4,4,0,2,2,1,0,6
428672,480_15_14,ARGENTINA,14903,12,marcos delia,15,3,5,60,3,5,60,0,0,0,2,2,100,1,3,4,0,2,0,1,0,8
428673,480_15_14,ARGENTINA,82,13,andres nocioni,22,4,11,36.4,2,4,50,2,7,28.6,0,0,0,1,12,13,2,1,2,1,1,10
428674,480_15_14,ARGENTINA,15007,14,gabriel deck,19,4,4,100,4,4,100,0,0,0,3,4,75,1,2,3,1,1,0,1,1,11
428675,480_15_14,ARGENTINA,21197,15,selem safar,12,3,5,60,1,1,100,2,4,50,0,0,0,0,1,1,4,1,1,0,0,8
428676,480_15_14,ARGENTINA,459,19,leo mainoldi,12,3,4,75,1,1,100,2,3,66.7,0,0,0,0,2,2,2,2,0,0,1,8
428677,480_15_14,ARGENTINA,12296,29,patricio garino,17,4,5,80,4,5,80,0,0,0,1,1,100,0,0,0,0,2,1,1,1,9
428678,480_15_14,ARGENTINA,16652,83,tayavek gallizzi,10,0,3,0,0,3,0,0,0,0,2,2,100,0,0,0,1,3,1,0,0,2
428679,480_15_14,ARGENTINA,0,TOTALS,ARGENTINA,200,36,72,50,26,48,54.2,10,24,41.7,14,20,70,5,38,43,24,16,11,7,8,96
428680,480_15_14,CUBA,25953,4,karel guzman,21,1,3,33.3,1,3,33.3,0,0,0,1,2,50,0,2,2,2,2,0,1,0,3
428681,480_15_14,CUBA,16888,5,osmel oliva,24,4,12,33.3,2,8,25,2,4,50,0,0,0,0,6,6,3,3,1,2,0,10
428682,480_15_14,CUBA,25804,6,javier justiz,21,5,15,33.3,5,15,33.3,0,0,0,1,3,33.3,4,9,13,1,3,3,0,0,11
428683,480_15_14,CUBA,16887,7,yaser rodriguez,22,0,2,0,0,0,0,0,2,0,0,0,0,0,1,1,2,1,0,0,0,0
428684,480_15_14,CUBA,28743,9,lisvan valdes,30,1,10,10,1,5,20,0,5,0,3,4,75,0,2,2,4,2,1,4,0,5
428685,480_15_14,CUBA,7259,10,william granda,5,0,1,0,0,1,0,0,0,0,0,0,0,0,0,0,1,1,0,1,1,0
428686,480_15_14,CUBA,25954,11,yuniskel molina,14,1,6,16.7,1,6,16.7,0,0,0,0,0,0,0,0,0,1,0,1,0,0,2
428687,480_15_14,CUBA,393,12,yoan haiti,24,2,6,33.3,2,4,50,0,2,0,2,2,100,3,8,11,5,2,5,1,0,6
428688,480_15_14,CUBA,25805,13,esteban martinez,0,0,0,0,0,0,0,0,0,0,0,0,0,0,0,0,0,0,0,0,0,0
428689,480_15_14,CUBA,7260,14,orestes torres,5,0,3,0,0,2,0,0,1,0,0,0,0,0,1,1,0,1,0,0,0,0
428690,480_15_14,CUBA,25806,15,jasiel rivero,32,12,21,57.1,12,18,66.7,0,3,0,1,3,33.3,6,0,6,0,3,3,0,1,25
428691,480_15_14,CUBA,28744,16,yoel cubilla,4,1,1,100,1,1,100,0,0,0,0,0,0,1,1,2,1,0,1,0,0,2
428692,480_15_14,CUBA,0,TOTALS,CUBA,200,27,80,33.8,25,63,39.7,2,17,11.8,8,14,57.1,16,32,48,20,18,17,9,2,64
428693,480_15_15,CANADA,16951,4,philip scrubb,10,2,5,40,1,2,50,1,3,33.3,0,0,0,0,1,1,1,0,3,0,0,5
428694,480_15_15,CANADA,8989,5,cory joseph,30,4,8,50,4,7,57.1,0,1,0,2,2,100,1,6,7,5,1,2,1,2,10
428695,480_15_15,CANADA,28756,6,melvin ejim,14,1,5,20,1,4,25,0,1,0,4,4,100,0,2,2,2,3,1,1,0,6
428696,480_15_15,CANADA,23739,7,andrew nicholson,8,1,2,50,1,1,100,0,1,0,0,0,0,1,1,2,0,0,2,0,0,2
428697,480_15_15,CANADA,16670,8,andrew wiggins,29,4,12,33.3,4,11,36.4,0,1,0,5,8,62.5,3,4,7,4,2,5,1,2,13
428698,480_15_15,CANADA,14711,9,nikolas stauskas,29,5,8,62.5,1,3,33.3,4,5,80,2,2,100,0,1,1,2,1,1,0,1,16
428699,480_15_15,CANADA,14713,10,anthony bennett,23,5,7,71.4,5,7,71.4,0,0,0,0,0,0,2,8,10,3,2,2,0,0,10
428700,480_15_15,CANADA,3485,11,aaron doornekamp,11,1,1,100,1,1,100,0,0,0,0,0,0,0,2,2,0,3,1,0,0,2
428701,480_15_15,CANADA,23740,12,brady heslip,12,0,1,0,0,0,0,0,1,0,0,0,0,1,2,3,1,1,0,0,0,0
428702,480_15_15,CANADA,12219,13,kelly olynyk,29,5,8,62.5,4,5,80,1,3,33.3,3,4,75,1,7,8,6,0,5,1,1,14
428703,480_15_15,CANADA,28757,14,dwight powell,5,2,2,100,2,2,100,0,0,0,0,0,0,1,3,4,0,1,0,0,0,4
428704,480_15_15,CANADA,7510,15,robert sacre,0,0,0,0,0,0,0,0,0,0,0,0,0,0,0,0,0,0,0,0,0,0
428705,480_15_15,CANADA,0,TOTALS,CANADA,200,30,59,50.8,24,43,55.8,6,16,37.5,16,20,80,12,40,52,24,14,22,4,6,82
428706,480_15_15,VENEZUELA,514,4,miguel marriaga,13,0,3,0,0,3,0,0,0,0,0,0,0,0,2,2,0,1,0,0,2,0
428707,480_15_15,VENEZUELA,16828,5,gregory vargas,15,2,6,33.3,2,5,40,0,1,0,0,0,0,0,1,1,2,3,1,1,0,4
428708,480_15_15,VENEZUELA,21053,6,john cox,12,1,7,14.3,0,2,0,1,5,20,0,0,0,1,1,2,1,1,1,1,0,3
428709,480_15_15,VENEZUELA,16829,8,david cubillan,19,2,8,25,1,6,16.7,1,2,50,0,0,0,1,2,3,2,2,0,2,0,5
428710,480_15_15,VENEZUELA,9857,10,jose vargas,21,4,12,33.3,3,7,42.9,1,5,20,2,3,66.7,0,0,0,3,3,0,0,0,11
428711,480_15_15,VENEZUELA,28745,11,cesar garcia,4,0,1,0,0,0,0,0,1,0,0,0,0,0,0,0,0,0,0,0,0,0
428712,480_15_15,VENEZUELA,9984,12,javinger vargas,12,0,2,0,0,0,0,0,2,0,0,0,0,0,2,2,0,2,2,0,0,0
428713,480_15_15,VENEZUELA,25751,14,miguel ruiz,20,1,2,50,1,2,50,0,0,0,0,0,0,3,0,3,1,3,1,4,0,2
428714,480_15_15,VENEZUELA,19026,15,windi graterol,16,1,8,12.5,0,3,0,1,5,20,0,0,0,2,2,4,1,3,2,1,0,3
428715,480_15_15,VENEZUELA,19021,19,heissler guillent,15,0,3,0,0,1,0,0,2,0,1,2,50,1,1,2,2,0,1,1,0,1
428716,480_15_15,VENEZUELA,19023,21,dwight lewis,24,6,11,54.5,5,8,62.5,1,3,33.3,4,4,100,0,0,0,0,1,0,2,0,17
428717,480_15_15,VENEZUELA,19022,43,nestor colmenares,28,6,11,54.5,4,8,50,2,3,66.7,2,4,50,2,4,6,2,3,0,2,1,16
428718,480_15_15,VENEZUELA,0,TOTALS,VENEZUELA,200,23,74,31.1,16,45,35.6,7,29,24.1,9,13,69.2,14,19,33,14,22,9,14,3,62
428719,480_15_16,PANAMA,4091,4,joel munoz,22,1,2,50,1,2,50,0,0,0,0,0,0,0,0,0,6,3,2,1,0,2
428720,480_15_16,PANAMA,25940,5,trevor gaskins,18,2,4,50,1,1,100,1,3,33.3,0,0,0,0,2,2,0,1,1,0,0,5
428721,480_15_16,PANAMA,4139,6,danilo pinnock,16,2,5,40,1,3,33.3,1,2,50,0,0,0,0,0,0,2,1,0,1,0,5
428722,480_15_16,PANAMA,28755,7,jamelle horne,18,2,7,28.6,2,6,33.3,0,1,0,4,4,100,1,4,5,2,1,0,0,1,8
428723,480_15_16,PANAMA,4526,8,jonathan king,0,0,0,0,0,0,0,0,0,0,0,0,0,0,0,0,0,0,0,0,0,0
428724,480_15_16,PANAMA,6822,9,jamaal levy,13,0,2,0,0,1,0,0,1,0,0,0,0,2,1,3,0,1,0,0,0,0
428725,480_15_16,PANAMA,19035,10,josimar ayarza,0,0,0,0,0,0,0,0,0,0,0,0,0,0,0,0,0,0,0,0,0,0
428726,480_15_16,PANAMA,401,11,michael hicks,25,2,6,33.3,2,4,50,0,2,0,1,3,33.3,0,1,1,2,2,2,0,0,5
428727,480_15_16,PANAMA,4529,12,ernesto oglivie,23,5,8,62.5,5,8,62.5,0,0,0,2,2,100,2,3,5,1,3,0,0,0,12
428728,480_15_16,PANAMA,14640,13,leonardo pomare,27,2,8,25,2,8,25,0,0,0,4,4,100,1,6,7,3,1,2,0,0,8
428729,480_15_16,PANAMA,25810,14,jaime lloreda,19,7,10,70,7,9,77.8,0,1,0,2,6,33.3,2,2,4,2,2,2,0,0,16
428730,480_15_16,PANAMA,6820,15,ruben garces,19,3,7,42.9,3,7,42.9,0,0,0,1,2,50,3,4,7,0,0,1,0,0,7
428731,480_15_16,PANAMA,0,TOTALS,PANAMA,200,26,59,44.1,24,49,49,2,10,20,14,21,66.7,12,23,35,18,15,10,2,1,68
428732,480_15_16,MEXICO,16880,4,paul stoll,26,6,8,75,0,0,0,6,8,75,2,2,100,1,2,3,7,2,0,3,0,20
428733,480_15_16,MEXICO,23812,5,marco ramos,19,2,3,66.7,2,2,100,0,1,0,0,0,0,1,0,1,3,2,0,0,1,4
428734,480_15_16,MEXICO,28754,6,juan toscano,19,3,7,42.9,2,5,40,1,2,50,2,2,100,2,0,2,4,4,1,1,0,9
428735,480_15_16,MEXICO,23756,7,jorge gutierrez,15,1,4,25,1,4,25,0,0,0,0,0,0,0,1,1,3,1,1,0,0,2
428736,480_15_16,MEXICO,9836,8,gustavo ayon,35,8,10,80,8,10,80,0,0,0,0,1,0,3,8,11,5,3,2,0,1,16
428737,480_15_16,MEXICO,23813,9,francisco cruz,31,4,10,40,4,6,66.7,0,4,0,2,2,100,1,5,6,4,1,2,0,0,10
428738,480_15_16,MEXICO,21214,10,gabriel giron,5,0,2,0,0,0,0,0,2,0,0,0,0,0,0,0,0,1,1,1,0,0
428739,480_15_16,MEXICO,9834,11,pedro meza,0,0,0,0,0,0,0,0,0,0,0,0,0,0,0,0,0,0,0,0,0,0
428740,480_15_16,MEXICO,9835,12,hector hernandez,35,6,16,37.5,3,6,50,3,10,30,0,0,0,0,5,5,2,1,0,1,0,15
428741,480_15_16,MEXICO,21215,13,orlando mendez,9,1,4,25,0,0,0,1,4,25,0,0,0,0,1,1,0,0,0,0,0,3
428742,480_15_16,MEXICO,25446,14,adrian zamora,0,0,0,0,0,0,0,0,0,0,0,0,0,0,0,0,0,0,0,0,0,0
428743,480_15_16,MEXICO,25444,15,israel gutierrez,8,1,1,100,0,0,0,1,1,100,0,0,0,0,1,1,0,5,0,0,0,3
428744,480_15_16,MEXICO,0,TOTALS,MEXICO,200,32,65,49.2,20,33,60.6,12,32,37.5,6,7,85.7,11,25,36,28,20,9,6,2,82
428745,480_15_17,VENEZUELA,514,4,miguel marriaga,5,0,1,0,0,0,0,0,1,0,0,0,0,1,1,2,0,0,1,0,0,0
428746,480_15_17,VENEZUELA,16828,5,gregory vargas,26,9,13,69.2,9,10,90,0,3,0,3,3,100,2,1,3,3,2,4,5,0,21
428747,480_15_17,VENEZUELA,21053,6,john cox,28,4,11,36.4,3,6,50,1,5,20,0,0,0,0,2,2,1,2,2,0,0,9
428748,480_15_17,VENEZUELA,16829,8,david cubillan,20,3,7,42.9,1,2,50,2,5,40,0,0,0,1,1,2,2,2,0,0,0,8
428749,480_15_17,VENEZUELA,9857,10,jose vargas,31,4,11,36.4,2,6,33.3,2,5,40,1,1,100,1,2,3,3,2,1,0,1,11
428750,480_15_17,VENEZUELA,28745,11,cesar garcia,0,0,0,0,0,0,0,0,0,0,0,0,0,0,0,0,0,0,0,0,0,0
428751,480_15_17,VENEZUELA,9984,12,javinger vargas,9,1,3,33.3,1,1,100,0,2,0,1,1,100,1,3,4,0,1,0,1,0,3
428752,480_15_17,VENEZUELA,25751,14,miguel ruiz,22,2,4,50,2,4,50,0,0,0,0,0,0,1,2,3,1,1,0,1,0,4
428753,480_15_17,VENEZUELA,19026,15,windi graterol,16,2,8,25,1,5,20,1,3,33.3,0,0,0,1,6,7,2,2,1,0,1,5
428754,480_15_17,VENEZUELA,19021,19,heissler guillent,6,0,2,0,0,2,0,0,0,0,0,0,0,0,0,0,2,0,0,0,0,0
428755,480_15_17,VENEZUELA,19023,21,dwight lewis,13,2,4,50,2,3,66.7,0,1,0,1,2,50,1,2,3,0,0,0,3,0,5
428756,480_15_17,VENEZUELA,19022,43,nestor colmenares,24,1,3,33.3,1,2,50,0,1,0,0,0,0,0,2,2,3,5,2,0,2,2
428757,480_15_17,VENEZUELA,0,TOTALS,VENEZUELA,200,28,67,41.8,22,41,53.7,6,26,23.1,6,7,85.7,11,25,36,17,18,14,10,4,68
428758,480_15_17,ARGENTINA,80,4,luis scola,36,8,17,47.1,7,15,46.7,1,2,50,9,11,81.8,2,8,10,2,3,3,2,1,26
428759,480_15_17,ARGENTINA,25731,5,nicolas richotti,0,0,0,0,0,0,0,0,0,0,0,0,0,0,0,0,0,0,0,0,0,0
428760,480_15_17,ARGENTINA,21037,7,facundo campazzo,36,4,8,50,3,6,50,1,2,50,0,2,0,0,1,1,6,3,5,1,0,9
428761,480_15_17,ARGENTINA,12228,8,nicolas laprovittola,17,2,4,50,1,3,33.3,1,1,100,0,0,0,1,2,3,4,0,2,0,0,5
428762,480_15_17,ARGENTINA,25732,9,nicolas brussino,0,0,0,0,0,0,0,0,0,0,0,0,0,0,0,0,0,0,0,0,0,0
428763,480_15_17,ARGENTINA,14903,12,marcos delia,0,0,0,0,0,0,0,0,0,0,0,0,0,0,0,0,0,0,0,0,0,0
428764,480_15_17,ARGENTINA,82,13,andres nocioni,34,7,12,58.3,5,8,62.5,2,4,50,5,5,100,2,7,9,2,2,1,2,0,21
428765,480_15_17,ARGENTINA,15007,14,gabriel deck,10,1,2,50,1,2,50,0,0,0,0,0,0,0,0,0,0,1,0,0,0,2
428766,480_15_17,ARGENTINA,21197,15,selem safar,22,1,3,33.3,1,2,50,0,1,0,0,0,0,0,3,3,2,2,1,1,0,2
428767,480_15_17,ARGENTINA,459,19,leo mainoldi,14,0,3,0,0,0,0,0,3,0,0,0,0,0,2,2,0,1,0,0,0,0
428768,480_15_17,ARGENTINA,12296,29,patricio garino,31,5,9,55.6,4,5,80,1,4,25,1,2,50,0,3,3,4,3,1,1,0,12
428769,480_15_17,ARGENTINA,16652,83,tayavek gallizzi,0,0,0,0,0,0,0,0,0,0,0,0,0,0,0,0,0,0,0,0,0,0
428770,480_15_17,ARGENTINA,0,TOTALS,ARGENTINA,200,28,58,48.3,22,41,53.7,6,17,35.3,15,20,75,6,29,35,20,15,13,7,1,77
428771,480_15_18,BRAZIL,28748,4,ricardo fischer,15,0,4,0,0,0,0,0,4,0,5,6,83.3,1,0,1,3,2,2,1,0,5
428772,480_15_18,BRAZIL,7622,5,rafael luz,25,1,3,33.3,1,2,50,0,1,0,0,0,0,0,2,2,7,3,1,1,0,2
428773,480_15_18,BRAZIL,19019,6,augusto lima,20,3,7,42.9,3,7,42.9,0,0,0,2,2,100,6,3,9,1,4,1,1,1,8
428774,480_15_18,BRAZIL,15053,7,deryk ramos,0,0,0,0,0,0,0,0,0,0,0,0,0,0,0,0,0,0,0,0,0,0
428775,480_15_18,BRAZIL,7625,8,vitor benite,33,7,18,38.9,4,10,40,3,8,37.5,4,6,66.7,3,0,3,1,2,0,2,0,21
428776,480_15_18,BRAZIL,14737,9,leo meindl,14,2,5,40,1,3,33.3,1,2,50,0,2,0,0,0,0,0,3,1,2,0,5
428777,480_15_18,BRAZIL,14634,10,carlos olivinha,12,1,6,16.7,0,3,0,1,3,33.3,1,2,50,2,3,5,0,2,0,0,0,4
428778,480_15_18,BRAZIL,28749,11,rafael mineiro,13,1,4,25,1,2,50,0,2,0,0,2,0,1,3,4,1,4,0,0,0,2
428779,480_15_18,BRAZIL,4104,12,guilherme giovannoni,16,2,5,40,2,2,100,0,3,0,0,0,0,0,2,2,0,5,0,0,0,4
428780,480_15_18,BRAZIL,9843,13,j p batista,18,2,9,22.2,2,9,22.2,0,0,0,2,2,100,5,2,7,1,3,1,0,0,6
428781,480_15_18,BRAZIL,28750,14,viera marquinhos,33,4,9,44.4,3,5,60,1,4,25,6,6,100,0,6,6,1,0,3,2,0,15
428782,480_15_18,BRAZIL,483,15,marcus toledo,0,0,0,0,0,0,0,0,0,0,0,0,0,0,0,0,0,0,0,0,0,0
428783,480_15_18,BRAZIL,0,TOTALS,BRAZIL,200,23,70,32.9,17,43,39.5,6,27,22.2,20,28,71.4,18,25,43,15,28,11,9,1,72
428784,480_15_18,PANAMA,4091,4,joel munoz,19,1,3,33.3,1,3,33.3,0,0,0,1,2,50,0,2,2,4,2,2,1,0,3
428785,480_15_18,PANAMA,25940,5,trevor gaskins,25,7,13,53.8,3,6,50,4,7,57.1,5,5,100,0,6,6,6,2,2,0,0,23
428786,480_15_18,PANAMA,4139,6,danilo pinnock,0,0,0,0,0,0,0,0,0,0,0,0,0,0,0,0,0,0,0,0,0,0
428787,480_15_18,PANAMA,28755,7,jamelle horne,11,2,4,50,2,4,50,0,0,0,2,4,50,2,2,4,0,2,2,0,0,6
428788,480_15_18,PANAMA,4526,8,jonathan king,1,0,0,0,0,0,0,0,0,0,0,0,0,0,0,0,0,0,0,0,0,0
428789,480_15_18,PANAMA,6822,9,jamaal levy,12,0,2,0,0,0,0,0,2,0,0,0,0,0,2,2,2,1,0,1,0,0
428790,480_15_18,PANAMA,19035,10,josimar ayarza,23,2,7,28.6,2,7,28.6,0,0,0,1,1,100,0,0,0,1,0,0,0,1,5
428791,480_15_18,PANAMA,401,11,michael hicks,29,5,12,41.7,5,10,50,0,2,0,9,11,81.8,2,5,7,1,4,4,1,0,19
428792,480_15_18,PANAMA,4529,12,ernesto oglivie,14,1,2,50,1,2,50,0,0,0,0,0,0,0,1,1,0,1,1,0,1,2
428793,480_15_18,PANAMA,14640,13,leonardo pomare,27,3,5,60,3,5,60,0,0,0,0,0,0,1,2,3,2,3,3,3,6,6
428794,480_15_18,PANAMA,25810,14,jaime lloreda,19,4,8,50,4,8,50,0,0,0,2,6,33.3,5,4,9,0,3,0,0,0,10
428795,480_15_18,PANAMA,6820,15,ruben garces,21,6,8,75,6,8,75,0,0,0,3,4,75,3,5,8,2,2,0,0,1,15
428796,480_15_18,PANAMA,0,TOTALS,PANAMA,200,31,64,48.4,27,53,50.9,4,11,36.4,23,33,69.7,16,34,50,18,20,15,6,9,89
428797,480_15_19,PUERTO RICO,23748,1,ramon clemente,26,5,9,55.6,5,8,62.5,0,1,0,6,9,66.7,4,3,7,6,4,1,1,1,16
428798,480_15_19,PUERTO RICO,14636,2,guillermo diaz,1,0,0,0,0,0,0,0,0,0,0,0,0,0,0,0,0,0,0,0,0,0
428799,480_15_19,PUERTO RICO,19036,5,jose juan barea,26,8,16,50,5,9,55.6,3,7,42.9,1,4,25,0,7,7,7,4,2,1,0,20
428800,480_15_19,PUERTO RICO,23749,6,richard chaney,0,0,0,0,0,0,0,0,0,0,0,0,0,0,0,0,0,0,0,0,0,0
428801,480_15_19,PUERTO RICO,28751,7,javier gonzalez,10,3,8,37.5,3,6,50,0,2,0,0,0,0,1,0,1,1,1,1,1,0,6
428802,480_15_19,PUERTO RICO,3479,8,angel vassallo,31,3,13,23.1,2,8,25,1,5,20,1,3,33.3,1,2,3,0,2,0,0,0,8
428803,480_15_19,PUERTO RICO,8997,9,jorge bryan diaz,23,3,5,60,3,3,100,0,2,0,1,3,33.3,0,3,3,2,5,2,0,0,7
428804,480_15_19,PUERTO RICO,103,10,larry ayuso,22,6,11,54.5,2,3,66.7,4,8,50,2,2,100,0,1,1,2,1,0,0,0,18
428805,480_15_19,PUERTO RICO,23750,11,luis villafane,5,0,0,0,0,0,0,0,0,0,0,0,0,0,1,1,0,1,0,1,0,0
428806,480_15_19,PUERTO RICO,16592,13,renaldo balkman,25,4,14,28.6,4,14,28.6,0,0,0,1,2,50,6,5,11,4,5,0,1,1,9
428807,480_15_19,PUERTO RICO,19067,23,john holland,9,1,2,50,0,0,0,1,2,50,0,0,0,0,0,0,0,3,0,0,0,3
428808,480_15_19,PUERTO RICO,25443,31,carlos rivera,23,2,3,66.7,1,1,100,1,2,50,0,2,0,0,2,2,1,4,2,1,0,5
428809,480_15_19,PUERTO RICO,0,TOTALS,PUERTO RICO,200,35,81,43.2,25,52,48.1,10,29,34.5,12,25,48,14,26,40,23,30,8,6,2,92
428810,480_15_19,CANADA,16951,4,philip scrubb,21,4,7,57.1,2,4,50,2,3,66.7,2,2,100,0,0,0,3,4,2,1,0,12
428811,480_15_19,CANADA,8989,5,cory joseph,20,3,8,37.5,2,6,33.3,1,2,50,8,10,80,2,3,5,5,4,4,0,0,15
428812,480_15_19,CANADA,28756,6,melvin ejim,11,2,7,28.6,2,4,50,0,3,0,0,0,0,4,4,8,2,3,2,0,0,4
428813,480_15_19,CANADA,23739,7,andrew nicholson,10,1,3,33.3,0,1,0,1,2,50,0,0,0,1,2,3,1,3,1,1,0,3
428814,480_15_19,CANADA,16670,8,andrew wiggins,24,5,9,55.6,4,6,66.7,1,3,33.3,8,13,61.5,1,2,3,1,3,0,0,0,19
428815,480_15_19,CANADA,14711,9,nikolas stauskas,23,5,10,50,2,5,40,3,5,60,2,2,100,0,5,5,4,1,0,0,0,15
428816,480_15_19,CANADA,14713,10,anthony bennett,21,2,5,40,1,2,50,1,3,33.3,4,4,100,2,7,9,3,2,2,0,0,9
428817,480_15_19,CANADA,3485,11,aaron doornekamp,17,1,3,33.3,1,2,50,0,1,0,0,0,0,1,5,6,1,4,0,0,0,2
428818,480_15_19,CANADA,23740,12,brady heslip,18,4,7,57.1,1,1,100,3,6,50,2,4,50,0,0,0,1,1,1,0,0,13
428819,480_15_19,CANADA,12219,13,kelly olynyk,25,5,10,50,4,8,50,1,2,50,4,5,80,3,6,9,4,1,0,0,4,15
428820,480_15_19,CANADA,28757,14,dwight powell,0,0,0,0,0,0,0,0,0,0,0,0,0,0,0,0,0,0,0,0,0,0
428821,480_15_19,CANADA,7510,15,robert sacre,11,1,2,50,1,2,50,0,0,0,3,4,75,2,1,3,0,2,0,0,1,5
428822,480_15_19,CANADA,0,TOTALS,CANADA,200,33,71,46.5,20,41,48.8,13,30,43.3,33,44,75,19,39,58,25,28,13,2,5,112
428823,480_15_20,MEXICO,16880,4,paul stoll,24,2,3,66.7,0,0,0,2,3,66.7,0,0,0,0,0,0,5,2,4,0,0,6
428824,480_15_20,MEXICO,23812,5,marco ramos,13,2,3,66.7,2,2,100,0,1,0,0,0,0,0,3,3,0,3,0,0,0,4
428825,480_15_20,MEXICO,28754,6,juan toscano,24,1,5,20,1,3,33.3,0,2,0,2,2,100,0,5,5,1,2,0,0,0,4
428826,480_15_20,MEXICO,23756,7,jorge gutierrez,32,3,12,25,3,9,33.3,0,3,0,5,6,83.3,0,6,6,3,2,1,0,0,11
428827,480_15_20,MEXICO,9836,8,gustavo ayon,33,7,12,58.3,7,12,58.3,0,0,0,9,10,90,4,10,14,6,4,2,6,1,23
428828,480_15_20,MEXICO,23813,9,francisco cruz,31,4,8,50,3,6,50,1,2,50,0,0,0,0,3,3,0,4,2,0,0,9
428829,480_15_20,MEXICO,21214,10,gabriel giron,0,0,0,0,0,0,0,0,0,0,0,0,0,0,0,0,0,0,0,0,0,0
428830,480_15_20,MEXICO,9834,11,pedro meza,0,0,0,0,0,0,0,0,0,0,0,0,0,0,0,0,0,0,0,0,0,0
428831,480_15_20,MEXICO,9835,12,hector hernandez,31,6,11,54.5,5,7,71.4,1,4,25,4,4,100,1,1,2,1,2,3,0,0,17
428832,480_15_20,MEXICO,21215,13,orlando mendez,0,0,0,0,0,0,0,0,0,0,0,0,0,0,0,0,0,0,0,0,0,0
428833,480_15_20,MEXICO,25446,14,adrian zamora,5,2,2,100,2,2,100,0,0,0,0,0,0,0,1,1,0,1,0,0,0,4
428834,480_15_20,MEXICO,25444,15,israel gutierrez,7,0,1,0,0,1,0,0,0,0,0,0,0,1,1,2,2,2,0,1,0,0
428835,480_15_20,MEXICO,0,TOTALS,MEXICO,200,27,57,47.4,23,42,54.8,4,15,26.7,20,22,90.9,9,31,40,18,22,14,7,1,78
428836,480_15_20,URUGUAY,28746,4,santiago vidal,6,0,0,0,0,0,0,0,0,0,0,0,0,0,0,0,0,1,1,0,0,0
428837,480_15_20,URUGUAY,7588,5,bruno fitipaldo,35,3,8,37.5,0,2,0,3,6,50,1,2,50,0,0,0,4,2,2,0,0,10
428838,480_15_20,URUGUAY,298,6,mauricio aguiar,30,4,8,50,3,7,42.9,1,1,100,6,10,60,0,1,1,1,1,1,0,0,15
428839,480_15_20,URUGUAY,7590,7,mathias calfani,32,4,8,50,4,7,57.1,0,1,0,2,2,100,2,8,10,1,2,0,2,0,10
428840,480_15_20,URUGUAY,12235,10,marcel souberbielle,1,0,0,0,0,0,0,0,0,0,0,0,0,0,0,0,0,0,0,0,0,0
428841,480_15_20,URUGUAY,296,11,martin osimani,32,3,8,37.5,1,4,25,2,4,50,1,2,50,0,2,2,4,3,2,0,0,9
428842,480_15_20,URUGUAY,14992,13,hernando caceres,0,0,0,0,0,0,0,0,0,0,0,0,0,0,0,0,0,0,0,0,0,0
428843,480_15_20,URUGUAY,4134,14,nicolas borsellino,15,1,3,33.3,1,2,50,0,1,0,3,4,75,0,2,2,1,3,4,1,0,5
428844,480_15_20,URUGUAY,12278,21,luciano parodi,18,1,6,16.7,0,3,0,1,3,33.3,0,0,0,0,2,2,3,3,1,2,0,3
428845,480_15_20,URUGUAY,19040,22,reque newsome,19,4,6,66.7,4,6,66.7,0,0,0,1,2,50,0,3,3,0,2,2,0,0,9
428846,480_15_20,URUGUAY,23760,33,kiril wachsmann,14,1,6,16.7,1,6,16.7,0,0,0,0,0,0,2,1,3,1,1,1,0,0,2
428847,480_15_20,URUGUAY,28747,41,demian alvarez,0,0,0,0,0,0,0,0,0,0,0,0,0,0,0,0,0,0,0,0,0,0
428848,480_15_20,URUGUAY,0,TOTALS,URUGUAY,200,21,53,39.6,14,37,37.8,7,16,43.8,14,22,63.6,5,22,27,15,18,14,5,0,63
428849,480_15_21,DOMINICAN REPUBLIC,19011,4,edgar sosa,33,8,16,50,8,12,66.7,0,4,0,5,8,62.5,1,1,2,5,3,0,3,0,21
428850,480_15_21,DOMINICAN REPUBLIC,25436,5,victor liz,11,1,3,33.3,0,2,0,1,1,100,2,2,100,1,0,1,0,2,1,0,1,5
428851,480_15_21,DOMINICAN REPUBLIC,28752,6,rigoberto mendoza,18,0,1,0,0,1,0,0,0,0,2,2,100,0,2,2,0,0,1,3,0,2
428852,480_15_21,DOMINICAN REPUBLIC,21234,7,angel suero,0,0,0,0,0,0,0,0,0,0,0,0,0,0,0,0,0,0,0,0,0,0
428853,480_15_21,DOMINICAN REPUBLIC,23761,8,edward santana,13,2,5,40,2,5,40,0,0,0,0,0,0,1,3,4,0,1,1,0,1,4
428854,480_15_21,DOMINICAN REPUBLIC,4116,9,francisco garcia,30,0,4,0,0,1,0,0,3,0,0,0,0,0,3,3,4,3,0,1,0,0
428855,480_15_21,DOMINICAN REPUBLIC,23762,10,james feldeine,32,4,9,44.4,2,4,50,2,5,40,3,6,50,0,1,1,2,1,1,0,0,13
428856,480_15_21,DOMINICAN REPUBLIC,19070,11,eloy vargas,19,3,6,50,3,6,50,0,0,0,5,7,71.4,0,2,2,0,2,2,1,0,11
428857,480_15_21,DOMINICAN REPUBLIC,19016,12,orlando sanchez,23,3,3,100,1,1,100,2,2,100,0,0,0,1,6,7,1,2,2,1,1,8
428858,480_15_21,DOMINICAN REPUBLIC,9947,13,eulis baez,22,2,7,28.6,2,5,40,0,2,0,0,0,0,0,5,5,0,1,4,0,0,4
428859,480_15_21,DOMINICAN REPUBLIC,4114,14,luis flores,0,0,0,0,0,0,0,0,0,0,0,0,0,0,0,0,0,0,0,0,0,0
428860,480_15_21,DOMINICAN REPUBLIC,28753,15,juan jose garcia,0,0,0,0,0,0,0,0,0,0,0,0,0,0,0,0,0,0,0,0,0,0
428861,480_15_21,DOMINICAN REPUBLIC,0,TOTALS,DOMINICAN REPUBLIC,200,23,54,42.6,18,37,48.6,5,17,29.4,17,25,68,4,25,29,12,16,12,9,3,68
428862,480_15_21,VENEZUELA,514,4,miguel marriaga,3,0,1,0,0,1,0,0,0,0,0,0,0,0,1,1,1,2,0,0,0,0
428863,480_15_21,VENEZUELA,16828,5,gregory vargas,26,3,5,60,3,4,75,0,1,0,3,4,75,0,5,5,6,4,2,1,0,9
428864,480_15_21,VENEZUELA,21053,6,john cox,28,3,12,25,1,7,14.3,2,5,40,2,2,100,0,2,2,3,1,1,2,0,10
428865,480_15_21,VENEZUELA,16829,8,david cubillan,19,2,9,22.2,1,4,25,1,5,20,0,1,0,0,1,1,1,2,2,1,0,5
428866,480_15_21,VENEZUELA,9857,10,jose vargas,18,1,6,16.7,0,3,0,1,3,33.3,0,0,0,1,1,2,1,5,1,0,1,3
428867,480_15_21,VENEZUELA,28745,11,cesar garcia,0,0,0,0,0,0,0,0,0,0,0,0,0,0,0,0,0,0,0,0,0,0
428868,480_15_21,VENEZUELA,9984,12,javinger vargas,7,0,0,0,0,0,0,0,0,0,0,0,0,0,1,1,0,0,0,0,1,0
428869,480_15_21,VENEZUELA,25751,14,miguel ruiz,22,2,3,66.7,2,3,66.7,0,0,0,0,0,0,8,9,17,0,2,3,0,0,4
428870,480_15_21,VENEZUELA,19026,15,windi graterol,17,5,8,62.5,5,7,71.4,0,1,0,1,2,50,0,4,4,1,3,1,2,0,11
428871,480_15_21,VENEZUELA,19021,19,heissler guillent,17,3,5,60,0,2,0,3,3,100,0,0,0,1,0,1,5,3,2,1,0,9
428872,480_15_21,VENEZUELA,19023,21,dwight lewis,15,1,3,33.3,1,2,50,0,1,0,0,0,0,1,1,2,1,3,1,1,0,2
428873,480_15_21,VENEZUELA,19022,43,nestor colmenares,28,8,13,61.5,8,13,61.5,0,0,0,3,6,50,2,4,6,0,1,1,0,1,19
428874,480_15_21,VENEZUELA,0,TOTALS,VENEZUELA,200,28,65,43.1,21,46,45.7,7,19,36.8,9,15,60,14,31,45,19,26,15,8,3,72
428875,480_15_22,ARGENTINA,80,4,luis scola,37,10,16,62.5,10,15,66.7,0,1,0,6,9,66.7,4,9,13,2,3,2,1,2,26
428876,480_15_22,ARGENTINA,25731,5,nicolas richotti,13,3,5,60,1,3,33.3,2,2,100,0,0,0,0,1,1,1,2,0,0,0,8
428877,480_15_22,ARGENTINA,21037,7,facundo campazzo,31,5,12,41.7,1,2,50,4,10,40,1,2,50,0,1,1,8,4,1,1,1,15
428878,480_15_22,ARGENTINA,12228,8,nicolas laprovittola,17,2,4,50,2,3,66.7,0,1,0,3,5,60,1,0,1,4,5,2,1,0,7
428879,480_15_22,ARGENTINA,25732,9,nicolas brussino,2,0,1,0,0,0,0,0,1,0,0,0,0,0,0,0,0,1,0,0,0,0
428880,480_15_22,ARGENTINA,14903,12,marcos delia,2,0,0,0,0,0,0,0,0,0,0,0,0,0,1,1,0,0,0,0,0,0
428881,480_15_22,ARGENTINA,82,13,andres nocioni,31,5,15,33.3,2,6,33.3,3,9,33.3,9,12,75,2,6,8,1,4,0,1,0,22
428882,480_15_22,ARGENTINA,15007,14,gabriel deck,10,0,1,0,0,1,0,0,0,0,0,0,0,0,0,0,0,1,0,0,0,0
428883,480_15_22,ARGENTINA,21197,15,selem safar,14,0,3,0,0,0,0,0,3,0,0,0,0,0,0,0,0,1,0,0,0,0
428884,480_15_22,ARGENTINA,459,19,leo mainoldi,18,2,5,40,0,0,0,2,5,40,0,0,0,1,1,2,0,2,0,0,0,6
428885,480_15_22,ARGENTINA,12296,29,patricio garino,25,2,8,25,2,4,50,0,4,0,2,2,100,2,2,4,2,4,1,0,0,6
428886,480_15_22,ARGENTINA,16652,83,tayavek gallizzi,0,0,0,0,0,0,0,0,0,0,0,0,0,0,0,0,0,0,0,0,0,0
428887,480_15_22,ARGENTINA,0,TOTALS,ARGENTINA,200,29,70,41.4,18,34,52.9,11,36,30.6,21,30,70,12,25,37,18,27,6,4,3,90
428888,480_15_22,URUGUAY,28746,4,santiago vidal,1,0,0,0,0,0,0,0,0,0,0,0,0,0,0,0,0,0,0,0,0,0
428889,480_15_22,URUGUAY,7588,5,bruno fitipaldo,31,5,12,41.7,4,8,50,1,4,25,4,4,100,0,2,2,7,3,2,1,0,15
428890,480_15_22,URUGUAY,298,6,mauricio aguiar,29,7,11,63.6,7,9,77.8,0,2,0,3,9,33.3,0,4,4,2,2,1,0,0,17
428891,480_15_22,URUGUAY,7590,7,mathias calfani,31,9,11,81.8,9,11,81.8,0,0,0,2,3,66.7,3,14,17,0,4,2,1,1,20
428892,480_15_22,URUGUAY,12235,10,marcel souberbielle,9,0,0,0,0,0,0,0,0,0,0,0,0,0,0,0,0,1,0,0,0,0
428893,480_15_22,URUGUAY,296,11,martin osimani,28,3,8,37.5,2,6,33.3,1,2,50,2,4,50,0,4,4,8,4,3,1,0,9
428894,480_15_22,URUGUAY,14992,13,hernando caceres,1,0,0,0,0,0,0,0,0,0,0,0,0,0,0,0,0,0,0,0,0,0
428895,480_15_22,URUGUAY,4134,14,nicolas borsellino,17,3,9,33.3,3,9,33.3,0,0,0,2,3,66.7,3,1,4,1,3,2,1,0,8
428896,480_15_22,URUGUAY,12278,21,luciano parodi,22,1,6,16.7,1,5,20,0,1,0,0,0,0,0,3,3,0,3,0,1,0,2
428897,480_15_22,URUGUAY,19040,22,reque newsome,14,2,4,50,2,4,50,0,0,0,4,4,100,1,1,2,0,4,1,0,1,8
428898,480_15_22,URUGUAY,23760,33,kiril wachsmann,17,3,4,75,3,4,75,0,0,0,2,2,100,1,1,2,0,3,1,0,0,8
428899,480_15_22,URUGUAY,28747,41,demian alvarez,0,0,0,0,0,0,0,0,0,0,0,0,0,0,0,0,0,0,0,0,0,0
428900,480_15_22,URUGUAY,0,TOTALS,URUGUAY,200,33,65,50.8,31,56,55.4,2,9,22.2,19,29,65.5,11,34,45,18,27,12,5,2,87
428901,480_15_23,CANADA,16951,4,philip scrubb,16,3,7,42.9,2,4,50,1,3,33.3,3,3,100,0,3,3,1,1,1,0,0,10
428902,480_15_23,CANADA,8989,5,cory joseph,18,4,9,44.4,4,8,50,0,1,0,7,10,70,2,2,4,3,1,0,1,1,15
428903,480_15_23,CANADA,28756,6,melvin ejim,10,0,2,0,0,2,0,0,0,0,0,0,0,5,3,8,2,1,0,0,0,0
428904,480_15_23,CANADA,23739,7,andrew nicholson,14,2,6,33.3,2,4,50,0,2,0,0,0,0,3,3,6,1,0,1,1,0,4
428905,480_15_23,CANADA,16670,8,andrew wiggins,18,6,7,85.7,4,5,80,2,2,100,3,4,75,2,1,3,2,2,1,0,0,17
428906,480_15_23,CANADA,14711,9,nikolas stauskas,29,4,9,44.4,2,3,66.7,2,6,33.3,6,6,100,0,6,6,5,1,1,1,0,16
428907,480_15_23,CANADA,14713,10,anthony bennett,20,3,6,50,3,4,75,0,2,0,0,0,0,1,8,9,1,0,1,1,1,6
428908,480_15_23,CANADA,3485,11,aaron doornekamp,18,1,6,16.7,0,1,0,1,5,20,0,0,0,1,1,2,2,2,0,0,0,3
428909,480_15_23,CANADA,23740,12,brady heslip,20,8,15,53.3,1,2,50,7,13,53.8,0,0,0,0,1,1,0,0,1,0,0,23
428910,480_15_23,CANADA,12219,13,kelly olynyk,16,1,3,33.3,0,1,0,1,2,50,2,2,100,3,6,9,2,2,2,1,0,5
428911,480_15_23,CANADA,28757,14,dwight powell,6,1,2,50,1,2,50,0,0,0,0,0,0,1,0,1,0,5,2,0,0,2
428912,480_15_23,CANADA,7510,15,robert sacre,13,0,3,0,0,3,0,0,0,0,2,2,100,0,1,1,1,2,1,1,2,2
428913,480_15_23,CANADA,0,TOTALS,CANADA,200,33,75,44,19,39,48.7,14,36,38.9,23,27,85.2,20,35,55,20,17,11,6,4,103
428914,480_15_23,PANAMA,4091,4,joel munoz,25,3,4,75,2,2,100,1,2,50,1,1,100,0,1,1,6,3,1,0,0,8
428915,480_15_23,PANAMA,25940,5,trevor gaskins,14,1,9,11.1,1,5,20,0,4,0,0,0,0,0,0,0,1,1,3,1,0,2
428916,480_15_23,PANAMA,4139,6,danilo pinnock,0,0,0,0,0,0,0,0,0,0,0,0,0,0,0,0,0,0,0,0,0,0
428917,480_15_23,PANAMA,28755,7,jamelle horne,27,2,6,33.3,1,5,20,1,1,100,0,0,0,1,5,6,1,3,1,0,0,5
428918,480_15_23,PANAMA,4526,8,jonathan king,18,3,6,50,1,1,100,2,5,40,5,6,83.3,0,0,0,1,2,0,0,0,13
428919,480_15_23,PANAMA,6822,9,jamaal levy,26,3,8,37.5,1,3,33.3,2,5,40,0,0,0,0,5,5,4,2,1,0,0,8
428920,480_15_23,PANAMA,19035,10,josimar ayarza,0,0,0,0,0,0,0,0,0,0,0,0,0,0,0,0,0,0,0,0,0,0
428921,480_15_23,PANAMA,401,11,michael hicks,20,2,11,18.2,1,7,14.3,1,4,25,0,0,0,2,2,4,0,3,3,1,0,5
428922,480_15_23,PANAMA,4529,12,ernesto oglivie,27,2,7,28.6,2,6,33.3,0,1,0,5,6,83.3,1,2,3,0,3,0,1,0,9
428923,480_15_23,PANAMA,14640,13,leonardo pomare,19,3,7,42.9,3,7,42.9,0,0,0,0,0,0,2,1,3,1,2,0,1,1,6
428924,480_15_23,PANAMA,25810,14,jaime lloreda,12,4,8,50,4,6,66.7,0,2,0,2,2,100,1,4,5,1,1,4,2,0,10
428925,480_15_23,PANAMA,6820,15,ruben garces,13,0,3,0,0,3,0,0,0,0,0,0,0,1,0,1,0,0,1,0,1,0
428926,480_15_23,PANAMA,0,TOTALS,PANAMA,200,23,69,33.3,16,45,35.6,7,24,29.2,13,15,86.7,12,22,34,15,20,14,6,2,66
428927,480_15_24,MEXICO,16880,4,paul stoll,28,3,5,60,0,0,0,3,5,60,3,4,75,0,1,1,7,3,0,2,0,12
428928,480_15_24,MEXICO,23812,5,marco ramos,17,1,5,20,1,2,50,0,3,0,1,2,50,0,1,1,1,2,0,0,0,3
428929,480_15_24,MEXICO,28754,6,juan toscano,13,2,7,28.6,2,5,40,0,2,0,0,2,0,2,4,6,2,1,1,0,0,4
428930,480_15_24,MEXICO,23756,7,jorge gutierrez,32,5,13,38.5,5,12,41.7,0,1,0,5,7,71.4,3,3,6,9,3,6,2,0,15
428931,480_15_24,MEXICO,9836,8,gustavo ayon,31,4,6,66.7,4,6,66.7,0,0,0,1,1,100,2,10,12,2,5,6,0,1,9
428932,480_15_24,MEXICO,23813,9,francisco cruz,30,6,10,60,3,5,60,3,5,60,0,0,0,1,0,1,6,3,1,1,1,15
428933,480_15_24,MEXICO,21214,10,gabriel giron,2,0,0,0,0,0,0,0,0,0,0,0,0,0,0,0,0,1,0,0,0,0
428934,480_15_24,MEXICO,9834,11,pedro meza,0,0,0,0,0,0,0,0,0,0,0,0,0,0,0,0,0,0,0,0,0,0
428935,480_15_24,MEXICO,9835,12,hector hernandez,36,10,20,50,6,12,50,4,8,50,4,4,100,3,9,12,0,2,2,0,0,28
428936,480_15_24,MEXICO,21215,13,orlando mendez,0,0,0,0,0,0,0,0,0,0,0,0,0,0,0,0,0,0,0,0,0,0
428937,480_15_24,MEXICO,25446,14,adrian zamora,10,3,5,60,3,5,60,0,0,0,0,0,0,1,1,2,0,2,0,0,1,6
428938,480_15_24,MEXICO,25444,15,israel gutierrez,0,0,0,0,0,0,0,0,0,0,0,0,0,0,0,0,0,0,0,0,0,0
428939,480_15_24,MEXICO,0,TOTALS,MEXICO,200,34,71,47.9,24,47,51.1,10,24,41.7,14,20,70,15,31,46,27,22,16,5,3,92
428940,480_15_24,PUERTO RICO,23748,1,ramon clemente,11,1,2,50,1,2,50,0,0,0,0,0,0,1,2,3,0,5,1,1,1,2
428941,480_15_24,PUERTO RICO,14636,2,guillermo diaz,5,0,0,0,0,0,0,0,0,0,0,0,0,0,0,0,0,0,2,0,0,0
428942,480_15_24,PUERTO RICO,19036,5,jose juan barea,34,4,14,28.6,4,9,44.4,0,5,0,4,4,100,0,2,2,10,3,3,2,0,12
428943,480_15_24,PUERTO RICO,23749,6,richard chaney,6,1,4,25,1,3,33.3,0,1,0,0,0,0,1,2,3,0,0,0,0,0,2
428944,480_15_24,PUERTO RICO,28751,7,javier gonzalez,2,0,1,0,0,1,0,0,0,0,0,0,0,0,1,1,1,0,0,0,0,0
428945,480_15_24,PUERTO RICO,3479,8,angel vassallo,37,8,15,53.3,5,9,55.6,3,6,50,8,11,72.7,2,4,6,2,3,4,0,3,27
428946,480_15_24,PUERTO RICO,8997,9,jorge bryan diaz,21,3,7,42.9,3,7,42.9,0,0,0,1,2,50,2,5,7,0,1,0,0,2,7
428947,480_15_24,PUERTO RICO,103,10,larry ayuso,7,2,6,33.3,0,1,0,2,5,40,0,0,0,0,1,1,0,1,0,0,0,6
428948,480_15_24,PUERTO RICO,23750,11,luis villafane,0,0,0,0,0,0,0,0,0,0,0,0,0,0,0,0,0,0,0,0,0,0
428949,480_15_24,PUERTO RICO,16592,13,renaldo balkman,28,4,11,36.4,4,11,36.4,0,0,0,0,1,0,2,2,4,0,3,0,1,2,8
428950,480_15_24,PUERTO RICO,19067,23,john holland,17,1,2,50,0,0,0,1,2,50,2,2,100,0,1,1,1,0,0,1,0,5
428951,480_15_24,PUERTO RICO,25443,31,carlos rivera,31,6,10,60,4,7,57.1,2,3,66.7,3,4,75,2,1,3,5,4,1,0,0,17
428952,480_15_24,PUERTO RICO,0,TOTALS,PUERTO RICO,200,30,72,41.7,22,50,44,8,22,36.4,18,24,75,13,25,38,19,21,11,5,8,86
428953,480_15_25,PANAMA,4091,4,joel munoz,15,1,4,25,1,2,50,0,2,0,0,0,0,1,2,3,1,3,1,0,1,2
428954,480_15_25,PANAMA,25940,5,trevor gaskins,25,3,13,23.1,1,6,16.7,2,7,28.6,0,0,0,2,5,7,2,3,0,1,0,8
428955,480_15_25,PANAMA,4139,6,danilo pinnock,0,0,0,0,0,0,0,0,0,0,0,0,0,0,0,0,0,0,0,0,0,0
428956,480_15_25,PANAMA,28755,7,jamelle horne,5,0,0,0,0,0,0,0,0,0,0,0,0,0,0,0,0,0,0,0,0,0
428957,480_15_25,PANAMA,4526,8,jonathan king,15,2,6,33.3,0,2,0,2,4,50,1,2,50,0,1,1,1,3,0,0,0,7
428958,480_15_25,PANAMA,6822,9,jamaal levy,20,2,7,28.6,0,2,0,2,5,40,0,0,0,0,3,3,2,1,1,0,1,6
428959,480_15_25,PANAMA,19035,10,josimar ayarza,0,0,0,0,0,0,0,0,0,0,0,0,0,0,0,0,0,0,0,0,0,0
428960,480_15_25,PANAMA,401,11,michael hicks,33,4,18,22.2,3,13,23.1,1,5,20,6,7,85.7,1,3,4,1,3,1,1,0,15
428961,480_15_25,PANAMA,4529,12,ernesto oglivie,16,0,4,0,0,4,0,0,0,0,0,0,0,2,2,4,1,1,1,1,0,0
428962,480_15_25,PANAMA,14640,13,leonardo pomare,24,2,9,22.2,2,9,22.2,0,0,0,2,2,100,2,3,5,1,0,1,0,0,6
428963,480_15_25,PANAMA,25810,14,jaime lloreda,26,3,5,60,3,5,60,0,0,0,1,6,16.7,4,2,6,1,2,3,1,0,7
428964,480_15_25,PANAMA,6820,15,ruben garces,20,2,8,25,2,8,25,0,0,0,2,4,50,3,8,11,0,1,1,0,0,6
428965,480_15_25,PANAMA,0,TOTALS,PANAMA,200,19,74,25.7,12,51,23.5,7,23,30.4,12,21,57.1,16,30,46,10,17,9,4,2,57
428966,480_15_25,ARGENTINA,80,4,luis scola,27,7,12,58.3,7,12,58.3,0,0,0,2,4,50,0,4,4,3,3,2,1,0,16
428967,480_15_25,ARGENTINA,25731,5,nicolas richotti,23,2,8,25,1,5,20,1,3,33.3,0,0,0,0,5,5,3,2,1,0,0,5
428968,480_15_25,ARGENTINA,21037,7,facundo campazzo,15,3,5,60,2,4,50,1,1,100,1,2,50,0,3,3,6,4,2,1,0,8
428969,480_15_25,ARGENTINA,12228,8,nicolas laprovittola,25,3,8,37.5,1,2,50,2,6,33.3,1,2,50,0,2,2,5,1,1,2,0,9
428970,480_15_25,ARGENTINA,25732,9,nicolas brussino,7,1,2,50,0,1,0,1,1,100,0,0,0,0,0,0,1,0,0,0,0,3
428971,480_15_25,ARGENTINA,14903,12,marcos delia,14,2,4,50,2,4,50,0,0,0,1,4,25,0,3,3,1,0,0,0,2,5
428972,480_15_25,ARGENTINA,82,13,andres nocioni,20,4,8,50,2,4,50,2,4,50,0,0,0,0,9,9,0,4,3,0,1,10
428973,480_15_25,ARGENTINA,15007,14,gabriel deck,12,3,3,100,2,2,100,1,1,100,0,0,0,2,3,5,1,1,0,0,0,7
428974,480_15_25,ARGENTINA,21197,15,selem safar,15,3,6,50,1,1,100,2,5,40,0,0,0,0,1,1,1,0,1,0,0,8
428975,480_15_25,ARGENTINA,459,19,leo mainoldi,10,1,4,25,0,0,0,1,4,25,0,0,0,0,3,3,0,0,0,1,0,3
428976,480_15_25,ARGENTINA,12296,29,patricio garino,17,2,4,50,2,4,50,0,0,0,2,2,100,0,3,3,1,3,0,2,0,6
428977,480_15_25,ARGENTINA,16652,83,tayavek gallizzi,16,2,2,100,2,2,100,0,0,0,0,0,0,0,4,4,0,5,1,0,2,4
428978,480_15_25,ARGENTINA,0,TOTALS,ARGENTINA,200,33,66,50,22,41,53.7,11,25,44,7,14,50,5,43,48,22,23,11,7,5,84
428979,480_15_26,PUERTO RICO,23748,1,ramon clemente,22,6,8,75,6,7,85.7,0,1,0,3,3,100,2,4,6,1,1,3,1,0,15
428980,480_15_26,PUERTO RICO,14636,2,guillermo diaz,1,0,0,0,0,0,0,0,0,0,0,0,0,0,0,0,0,0,0,0,0,0
428981,480_15_26,PUERTO RICO,19036,5,jose juan barea,35,12,21,57.1,7,13,53.8,5,8,62.5,8,8,100,1,6,7,9,3,5,3,0,37
428982,480_15_26,PUERTO RICO,23749,6,richard chaney,20,3,5,60,3,4,75,0,1,0,2,3,66.7,1,5,6,1,3,2,0,0,8
428983,480_15_26,PUERTO RICO,28751,7,javier gonzalez,2,0,0,0,0,0,0,0,0,0,0,0,0,0,1,1,0,0,1,0,0,0
428984,480_15_26,PUERTO RICO,3479,8,angel vassallo,27,3,16,18.8,3,9,33.3,0,7,0,6,7,85.7,1,2,3,1,3,0,0,1,12
428985,480_15_26,PUERTO RICO,8997,9,jorge bryan diaz,14,1,2,50,1,2,50,0,0,0,0,0,0,2,1,3,1,1,1,1,0,2
428986,480_15_26,PUERTO RICO,103,10,larry ayuso,0,0,0,0,0,0,0,0,0,0,0,0,0,0,0,0,0,0,0,0,0,0
428987,480_15_26,PUERTO RICO,23750,11,luis villafane,0,0,0,0,0,0,0,0,0,0,0,0,0,0,0,0,0,0,0,0,0,0
428988,480_15_26,PUERTO RICO,16592,13,renaldo balkman,26,6,13,46.2,5,12,41.7,1,1,100,0,0,0,0,3,3,2,4,1,3,0,13
428989,480_15_26,PUERTO RICO,19067,23,john holland,22,2,5,40,2,3,66.7,0,2,0,0,0,0,0,2,2,2,1,1,2,1,4
428990,480_15_26,PUERTO RICO,25443,31,carlos rivera,31,2,5,40,2,5,40,0,0,0,3,5,60,1,2,3,3,1,0,1,0,7
428991,480_15_26,PUERTO RICO,0,TOTALS,PUERTO RICO,200,35,75,46.7,29,55,52.7,6,20,30,22,26,84.6,10,29,39,20,17,16,11,2,98
428992,480_15_26,DOMINICAN REPUBLIC,19011,4,edgar sosa,31,5,11,45.5,3,7,42.9,2,4,50,1,1,100,0,5,5,4,4,4,1,1,13
428993,480_15_26,DOMINICAN REPUBLIC,25436,5,victor liz,6,0,1,0,0,0,0,0,1,0,2,2,100,0,0,0,0,0,1,0,0,2
428994,480_15_26,DOMINICAN REPUBLIC,28752,6,rigoberto mendoza,19,2,6,33.3,2,4,50,0,2,0,0,0,0,0,6,6,2,5,0,2,0,4
428995,480_15_26,DOMINICAN REPUBLIC,21234,7,angel suero,0,0,0,0,0,0,0,0,0,0,0,0,0,0,0,0,0,0,0,0,0,0
428996,480_15_26,DOMINICAN REPUBLIC,23761,8,edward santana,21,4,6,66.7,4,6,66.7,0,0,0,3,4,75,2,2,4,1,3,5,2,0,11
428997,480_15_26,DOMINICAN REPUBLIC,4116,9,francisco garcia,30,10,16,62.5,7,9,77.8,3,7,42.9,2,2,100,0,3,3,4,4,1,0,0,25
428998,480_15_26,DOMINICAN REPUBLIC,23762,10,james feldeine,34,7,15,46.7,5,8,62.5,2,7,28.6,4,4,100,0,3,3,3,2,2,2,0,20
428999,480_15_26,DOMINICAN REPUBLIC,19070,11,eloy vargas,12,1,1,100,1,1,100,0,0,0,2,2,100,0,2,2,2,1,1,1,1,4
429000,480_15_26,DOMINICAN REPUBLIC,19016,12,orlando sanchez,17,2,3,66.7,2,3,66.7,0,0,0,0,0,0,1,5,6,0,3,2,0,0,4
429001,480_15_26,DOMINICAN REPUBLIC,9947,13,eulis baez,28,4,9,44.4,3,4,75,1,5,20,0,0,0,0,5,5,2,2,1,1,2,9
429002,480_15_26,DOMINICAN REPUBLIC,4114,14,luis flores,2,0,0,0,0,0,0,0,0,0,0,0,0,0,0,0,0,0,0,0,0,0
429003,480_15_26,DOMINICAN REPUBLIC,28753,15,juan jose garcia,0,0,0,0,0,0,0,0,0,0,0,0,0,0,0,0,0,0,0,0,0,0
429004,480_15_26,DOMINICAN REPUBLIC,0,TOTALS,DOMINICAN REPUBLIC,200,35,68,51.5,27,42,64.3,8,26,30.8,14,15,93.3,5,33,38,18,24,17,9,4,92
429005,480_15_27,URUGUAY,28746,4,santiago vidal,16,1,4,25,1,3,33.3,0,1,0,1,2,50,0,2,2,3,2,2,0,0,3
429006,480_15_27,URUGUAY,7588,5,bruno fitipaldo,19,3,5,60,1,1,100,2,4,50,2,2,100,0,1,1,5,1,1,0,0,10
429007,480_15_27,URUGUAY,298,6,mauricio aguiar,0,0,0,0,0,0,0,0,0,0,0,0,0,0,0,0,0,0,0,0,0,0
429008,480_15_27,URUGUAY,7590,7,mathias calfani,18,4,8,50,4,7,57.1,0,1,0,1,2,50,0,0,0,2,3,3,1,0,9
429009,480_15_27,URUGUAY,12235,10,marcel souberbielle,21,3,5,60,2,3,66.7,1,2,50,0,0,0,1,1,2,2,4,1,0,0,7
429010,480_15_27,URUGUAY,296,11,martin osimani,14,0,7,0,0,3,0,0,4,0,0,0,0,0,1,1,1,1,1,0,0,0
429011,480_15_27,URUGUAY,14992,13,hernando caceres,11,2,6,33.3,0,2,0,2,4,50,0,0,0,0,1,1,0,4,0,0,0,6
429012,480_15_27,URUGUAY,4134,14,nicolas borsellino,21,5,7,71.4,3,5,60,2,2,100,3,7,42.9,1,1,2,2,1,0,0,0,15
429013,480_15_27,URUGUAY,12278,21,luciano parodi,17,6,9,66.7,4,4,100,2,5,40,0,1,0,0,1,1,2,1,2,2,0,14
429014,480_15_27,URUGUAY,19040,22,reque newsome,17,2,4,50,2,4,50,0,0,0,2,7,28.6,2,1,3,1,2,0,0,1,6
429015,480_15_27,URUGUAY,23760,33,kiril wachsmann,17,0,2,0,0,2,0,0,0,0,3,6,50,0,4,4,1,1,0,0,0,3
429016,480_15_27,URUGUAY,28747,41,demian alvarez,28,3,6,50,1,1,100,2,5,40,1,2,50,0,3,3,3,3,0,0,0,9
429017,480_15_27,URUGUAY,0,TOTALS,URUGUAY,200,29,63,46,18,35,51.4,11,28,39.3,13,29,44.8,7,20,27,22,23,10,3,1,82
429018,480_15_27,CANADA,16951,4,philip scrubb,20,3,7,42.9,1,1,100,2,6,33.3,2,2,100,0,2,2,3,3,0,0,0,10
429019,480_15_27,CANADA,8989,5,cory joseph,20,2,3,66.7,2,3,66.7,0,0,0,0,0,0,0,1,1,6,2,0,1,0,4
429020,480_15_27,CANADA,28756,6,melvin ejim,13,4,5,80,4,5,80,0,0,0,3,3,100,4,2,6,1,3,1,1,0,11
429021,480_15_27,CANADA,23739,7,andrew nicholson,17,6,8,75,3,5,60,3,3,100,0,0,0,3,7,10,6,2,0,0,0,15
429022,480_15_27,CANADA,16670,8,andrew wiggins,23,7,13,53.8,5,9,55.6,2,4,50,2,3,66.7,1,5,6,1,1,4,2,0,18
429023,480_15_27,CANADA,14711,9,nikolas stauskas,19,3,5,60,0,2,0,3,3,100,5,5,100,0,4,4,4,1,1,0,1,14
429024,480_15_27,CANADA,14713,10,anthony bennett,19,3,4,75,3,3,100,0,1,0,4,6,66.7,0,3,3,1,1,0,1,1,10
429025,480_15_27,CANADA,3485,11,aaron doornekamp,17,0,4,0,0,2,0,0,2,0,1,2,50,1,6,7,2,2,0,0,1,1
429026,480_15_27,CANADA,23740,12,brady heslip,21,4,10,40,1,4,25,3,6,50,2,2,100,0,0,0,2,1,1,1,0,13
429027,480_15_27,CANADA,12219,13,kelly olynyk,3,1,1,100,1,1,100,0,0,0,0,0,0,1,0,1,0,4,2,0,0,2
429028,480_15_27,CANADA,28757,14,dwight powell,16,3,8,37.5,3,8,37.5,0,0,0,3,4,75,2,2,4,0,3,2,0,0,9
429029,480_15_27,CANADA,7510,15,robert sacre,11,1,2,50,1,2,50,0,0,0,0,0,0,1,1,2,1,4,0,0,0,2
429030,480_15_27,CANADA,0,TOTALS,CANADA,200,37,70,52.9,24,45,53.3,13,25,52,22,27,81.5,16,35,51,27,27,11,6,3,109
429031,480_15_28,VENEZUELA,514,4,miguel marriaga,11,1,1,100,1,1,100,0,0,0,0,1,0,1,0,1,1,2,0,0,0,2
429032,480_15_28,VENEZUELA,16828,5,gregory vargas,27,5,12,41.7,4,8,50,1,4,25,0,0,0,3,1,4,3,1,0,0,0,11
429033,480_15_28,VENEZUELA,21053,6,john cox,29,8,15,53.3,6,8,75,2,7,28.6,4,7,57.1,1,2,3,0,3,0,1,0,22
429034,480_15_28,VENEZUELA,16829,8,david cubillan,22,5,11,45.5,2,7,28.6,3,4,75,1,2,50,0,1,1,3,1,0,1,0,14
429035,480_15_28,VENEZUELA,9857,10,jose vargas,28,1,9,11.1,0,3,0,1,6,16.7,0,0,0,0,3,3,3,3,1,1,0,3
429036,480_15_28,VENEZUELA,28745,11,cesar garcia,1,0,1,0,0,0,0,0,1,0,0,0,0,0,0,0,0,0,0,0,0,0
429037,480_15_28,VENEZUELA,9984,12,javinger vargas,2,0,2,0,0,0,0,0,2,0,0,0,0,0,2,2,0,0,0,0,0,0
429038,480_15_28,VENEZUELA,25751,14,miguel ruiz,10,0,0,0,0,0,0,0,0,0,0,0,0,0,1,1,0,2,0,2,0,0
429039,480_15_28,VENEZUELA,19026,15,windi graterol,19,2,7,28.6,2,6,33.3,0,1,0,0,0,0,2,3,5,1,2,1,1,0,4
429040,480_15_28,VENEZUELA,19021,19,heissler guillent,9,1,2,50,1,1,100,0,1,0,0,0,0,0,0,0,2,1,0,0,0,2
429041,480_15_28,VENEZUELA,19023,21,dwight lewis,14,1,4,25,1,3,33.3,0,1,0,0,0,0,1,4,5,0,0,1,1,0,2
429042,480_15_28,VENEZUELA,19022,43,nestor colmenares,26,3,11,27.3,3,10,30,0,1,0,4,5,80,8,2,10,1,3,2,2,1,10
429043,480_15_28,VENEZUELA,0,TOTALS,VENEZUELA,200,27,75,36,20,47,42.6,7,28,25,9,15,60,21,19,40,14,18,6,9,1,70
429044,480_15_28,MEXICO,16880,4,paul stoll,22,3,4,75,1,1,100,2,3,66.7,1,1,100,0,2,2,1,1,1,1,0,9
429045,480_15_28,MEXICO,23812,5,marco ramos,3,0,1,0,0,0,0,0,1,0,0,0,0,0,1,1,0,0,1,0,0,0
429046,480_15_28,MEXICO,28754,6,juan toscano,23,3,5,60,2,4,50,1,1,100,0,0,0,1,5,6,3,2,1,0,1,7
429047,480_15_28,MEXICO,23756,7,jorge gutierrez,34,6,16,37.5,6,15,40,0,1,0,8,8,100,2,5,7,4,4,3,0,0,20
429048,480_15_28,MEXICO,9836,8,gustavo ayon,34,5,9,55.6,5,9,55.6,0,0,0,4,6,66.7,2,9,11,3,3,6,0,1,14
429049,480_15_28,MEXICO,23813,9,francisco cruz,30,2,6,33.3,1,3,33.3,1,3,33.3,0,0,0,0,1,1,1,3,3,0,0,5
429050,480_15_28,MEXICO,21214,10,gabriel giron,18,4,4,100,2,2,100,2,2,100,1,2,50,1,2,3,1,3,0,0,2,11
429051,480_15_28,MEXICO,9834,11,pedro meza,0,0,0,0,0,0,0,0,0,0,0,0,0,0,0,0,0,0,0,0,0,0
429052,480_15_28,MEXICO,9835,12,hector hernandez,29,3,6,50,2,5,40,1,1,100,0,0,0,0,4,4,1,1,1,0,0,7
429053,480_15_28,MEXICO,21215,13,orlando mendez,0,0,0,0,0,0,0,0,0,0,0,0,0,0,0,0,0,0,0,0,0,0
429054,480_15_28,MEXICO,25446,14,adrian zamora,8,0,0,0,0,0,0,0,0,0,0,0,0,0,1,1,3,1,0,1,0,0
429055,480_15_28,MEXICO,25444,15,israel gutierrez,0,0,0,0,0,0,0,0,0,0,0,0,0,0,0,0,0,0,0,0,0,0
429056,480_15_28,MEXICO,0,TOTALS,MEXICO,200,26,51,51,19,39,48.7,7,12,58.3,14,17,82.4,8,31,39,17,18,16,2,4,73
429057,480_15_29,ARGENTINA,80,4,luis scola,30,8,12,66.7,8,12,66.7,0,0,0,1,3,33.3,6,8,14,6,2,4,2,1,17
429058,480_15_29,ARGENTINA,25731,5,nicolas richotti,5,0,2,0,0,1,0,0,1,0,0,0,0,0,1,1,1,0,1,1,0,0
429059,480_15_29,ARGENTINA,21037,7,facundo campazzo,26,6,14,42.9,2,9,22.2,4,5,80,2,2,100,1,4,5,5,3,2,1,0,18
429060,480_15_29,ARGENTINA,12228,8,nicolas laprovittola,23,2,9,22.2,1,3,33.3,1,6,16.7,0,0,0,0,1,1,5,2,1,1,0,5
429061,480_15_29,ARGENTINA,25732,9,nicolas brussino,0,0,0,0,0,0,0,0,0,0,0,0,0,0,0,0,0,0,0,0,0,0
429062,480_15_29,ARGENTINA,14903,12,marcos delia,10,0,1,0,0,1,0,0,0,0,0,2,0,1,2,3,1,1,0,0,0,0
429063,480_15_29,ARGENTINA,82,13,andres nocioni,27,8,18,44.4,4,8,50,4,10,40,5,6,83.3,0,5,5,2,3,1,1,0,25
429064,480_15_29,ARGENTINA,15007,14,gabriel deck,12,3,6,50,3,6,50,0,0,0,0,0,0,4,0,4,0,2,1,0,0,6
429065,480_15_29,ARGENTINA,21197,15,selem safar,27,5,9,55.6,3,3,100,2,6,33.3,0,0,0,0,1,1,1,2,0,0,0,12
429066,480_15_29,ARGENTINA,459,19,leo mainoldi,7,1,4,25,0,0,0,1,4,25,0,0,0,1,4,5,0,1,0,0,0,3
429067,480_15_29,ARGENTINA,12296,29,patricio garino,30,2,4,50,0,1,0,2,3,66.7,0,0,0,0,2,2,3,3,0,0,2,6
429068,480_15_29,ARGENTINA,16652,83,tayavek gallizzi,3,0,0,0,0,0,0,0,0,0,0,0,0,0,1,1,0,1,0,0,0,0
429069,480_15_29,ARGENTINA,0,TOTALS,ARGENTINA,200,35,79,44.3,21,44,47.7,14,35,40,8,13,61.5,15,29,44,24,20,10,6,3,92
429070,480_15_29,DOMINICAN REPUBLIC,19011,4,edgar sosa,28,8,9,88.9,4,5,80,4,4,100,4,6,66.7,0,3,3,2,4,3,2,0,24
429071,480_15_29,DOMINICAN REPUBLIC,25436,5,victor liz,12,2,4,50,2,3,66.7,0,1,0,2,2,100,0,1,1,1,2,0,0,0,6
429072,480_15_29,DOMINICAN REPUBLIC,28752,6,rigoberto mendoza,15,1,1,100,0,0,0,1,1,100,0,0,0,0,1,1,3,0,1,0,0,3
429073,480_15_29,DOMINICAN REPUBLIC,21234,7,angel suero,0,0,0,0,0,0,0,0,0,0,0,0,0,0,0,0,0,0,0,0,0,0
429074,480_15_29,DOMINICAN REPUBLIC,23761,8,edward santana,29,5,10,50,5,10,50,0,0,0,4,4,100,1,6,7,0,1,2,0,1,14
429075,480_15_29,DOMINICAN REPUBLIC,4116,9,francisco garcia,29,4,10,40,1,2,50,3,8,37.5,5,5,100,0,4,4,5,2,2,1,1,16
429076,480_15_29,DOMINICAN REPUBLIC,23762,10,james feldeine,33,1,9,11.1,0,5,0,1,4,25,0,0,0,0,6,6,4,0,3,0,0,3
429077,480_15_29,DOMINICAN REPUBLIC,19070,11,eloy vargas,0,0,0,0,0,0,0,0,0,0,0,0,0,0,0,0,0,0,0,0,0,0
429078,480_15_29,DOMINICAN REPUBLIC,19016,12,orlando sanchez,23,4,12,33.3,4,8,50,0,4,0,0,0,0,2,5,7,4,1,1,3,0,8
429079,480_15_29,DOMINICAN REPUBLIC,9947,13,eulis baez,29,3,4,75,1,1,100,2,3,66.7,2,4,50,1,6,7,4,3,1,0,0,10
429080,480_15_29,DOMINICAN REPUBLIC,4114,14,luis flores,3,0,1,0,0,1,0,0,0,0,0,0,0,0,0,0,0,1,2,0,0,0
429081,480_15_29,DOMINICAN REPUBLIC,28753,15,juan jose garcia,0,0,0,0,0,0,0,0,0,0,0,0,0,0,0,0,0,0,0,0,0,0
429082,480_15_29,DOMINICAN REPUBLIC,0,TOTALS,DOMINICAN REPUBLIC,200,28,60,46.7,17,35,48.6,11,25,44,17,21,81,5,32,37,23,15,15,6,2,84
429083,480_15_30,VENEZUELA,514,4,miguel marriaga,7,0,1,0,0,1,0,0,0,0,0,0,0,0,1,1,0,0,0,0,0,0
429084,480_15_30,VENEZUELA,16828,5,gregory vargas,28,3,3,100,1,1,100,2,2,100,2,2,100,2,1,3,10,3,2,2,0,10
429085,480_15_30,VENEZUELA,21053,6,john cox,29,5,8,62.5,5,5,100,0,3,0,2,2,100,1,2,3,0,2,2,0,0,12
429086,480_15_30,VENEZUELA,16829,8,david cubillan,20,2,7,28.6,0,2,0,2,5,40,1,2,50,0,2,2,3,2,1,0,0,7
429087,480_15_30,VENEZUELA,9857,10,jose vargas,33,5,13,38.5,2,4,50,3,9,33.3,4,4,100,0,0,0,3,2,0,0,1,17
429088,480_15_30,VENEZUELA,28745,11,cesar garcia,0,0,0,0,0,0,0,0,0,0,0,0,0,0,0,0,0,0,0,0,0,0
429089,480_15_30,VENEZUELA,9984,12,javinger vargas,0,0,0,0,0,0,0,0,0,0,0,0,0,0,0,0,0,0,0,0,0,0
429090,480_15_30,VENEZUELA,25751,14,miguel ruiz,20,0,2,0,0,2,0,0,0,0,0,0,0,4,3,7,0,4,1,0,1,0
429091,480_15_30,VENEZUELA,19026,15,windi graterol,21,7,11,63.6,6,7,85.7,1,4,25,0,0,0,2,2,4,0,2,2,3,1,15
429092,480_15_30,VENEZUELA,19021,19,heissler guillent,14,1,9,11.1,1,6,16.7,0,3,0,0,0,0,3,0,3,2,1,0,0,0,2
429093,480_15_30,VENEZUELA,19023,21,dwight lewis,7,0,5,0,0,4,0,0,1,0,0,0,0,1,0,1,0,1,0,0,0,0
429094,480_15_30,VENEZUELA,19022,43,nestor colmenares,20,5,8,62.5,5,7,71.4,0,1,0,2,4,50,0,6,6,1,4,2,0,0,12
429095,480_15_30,VENEZUELA,0,TOTALS,VENEZUELA,200,28,67,41.8,20,39,51.3,8,28,28.6,11,14,78.6,16,19,35,19,21,11,5,3,75
429096,480_15_30,URUGUAY,28746,4,santiago vidal,21,2,5,40,1,1,100,1,4,25,1,1,100,0,2,2,6,3,2,1,0,6
429097,480_15_30,URUGUAY,7588,5,bruno fitipaldo,37,5,9,55.6,4,4,100,1,5,20,1,1,100,0,3,3,7,3,0,0,0,12
429098,480_15_30,URUGUAY,298,6,mauricio aguiar,33,6,10,60,5,6,83.3,1,4,25,1,2,50,0,2,2,3,0,2,1,0,14
429099,480_15_30,URUGUAY,7590,7,mathias calfani,28,6,9,66.7,5,7,71.4,1,2,50,0,3,0,2,5,7,1,4,1,0,3,13
429100,480_15_30,URUGUAY,12235,10,marcel souberbielle,6,0,0,0,0,0,0,0,0,0,0,0,0,0,0,0,1,0,1,0,0,0
429101,480_15_30,URUGUAY,296,11,martin osimani,3,0,0,0,0,0,0,0,0,0,0,0,0,0,0,0,0,3,0,0,0,0
429102,480_15_30,URUGUAY,14992,13,hernando caceres,0,0,0,0,0,0,0,0,0,0,0,0,0,0,0,0,0,0,0,0,0,0
429103,480_15_30,URUGUAY,4134,14,nicolas borsellino,22,3,7,42.9,3,6,50,0,1,0,2,4,50,2,4,6,2,1,1,0,0,8
429104,480_15_30,URUGUAY,12278,21,luciano parodi,17,1,2,50,1,1,100,0,1,0,0,0,0,0,2,2,3,0,3,1,0,2
429105,480_15_30,URUGUAY,19040,22,reque newsome,25,8,10,80,8,10,80,0,0,0,4,4,100,1,2,3,0,2,2,0,0,20
429106,480_15_30,URUGUAY,23760,33,kiril wachsmann,6,1,2,50,1,2,50,0,0,0,0,0,0,3,1,4,0,1,0,0,0,2
429107,480_15_30,URUGUAY,28747,41,demian alvarez,5,0,2,0,0,2,0,0,0,0,0,0,0,0,1,1,1,2,0,0,0,0
429108,480_15_30,URUGUAY,0,TOTALS,URUGUAY,200,32,56,57.1,28,39,71.8,4,17,23.5,9,15,60,8,26,34,24,19,16,3,3,77
429109,480_15_31,PANAMA,4091,4,joel munoz,31,3,6,50,2,4,50,1,2,50,0,0,0,1,2,3,2,4,4,0,0,7
429110,480_15_31,PANAMA,25940,5,trevor gaskins,37,10,25,40,5,10,50,5,15,33.3,4,5,80,1,2,3,2,0,2,1,0,29
429111,480_15_31,PANAMA,4139,6,danilo pinnock,0,0,0,0,0,0,0,0,0,0,0,0,0,0,0,0,0,0,0,0,0,0
429112,480_15_31,PANAMA,28755,7,jamelle horne,0,0,0,0,0,0,0,0,0,0,0,0,0,0,0,0,0,0,0,0,0,0
429113,480_15_31,PANAMA,4526,8,jonathan king,1,0,0,0,0,0,0,0,0,0,0,0,0,0,0,0,0,0,0,0,0,0
429114,480_15_31,PANAMA,6822,9,jamaal levy,21,3,4,75,2,2,100,1,2,50,0,0,0,1,3,4,1,5,1,1,1,7
429115,480_15_31,PANAMA,19035,10,josimar ayarza,6,0,4,0,0,2,0,0,2,0,1,2,50,1,0,1,0,1,0,0,0,1
429116,480_15_31,PANAMA,401,11,michael hicks,33,2,6,33.3,1,2,50,1,4,25,5,6,83.3,0,1,1,1,3,7,0,1,10
429117,480_15_31,PANAMA,4529,12,ernesto oglivie,17,1,4,25,1,3,33.3,0,1,0,4,6,66.7,1,3,4,2,3,0,0,0,6
429118,480_15_31,PANAMA,14640,13,leonardo pomare,13,1,1,100,1,1,100,0,0,0,0,0,0,0,2,2,1,3,2,2,1,2
429119,480_15_31,PANAMA,25810,14,jaime lloreda,28,2,3,66.7,2,3,66.7,0,0,0,1,2,50,2,2,4,3,4,2,2,0,5
429120,480_15_31,PANAMA,6820,15,ruben garces,12,2,3,66.7,2,3,66.7,0,0,0,0,1,0,4,6,10,1,1,0,1,0,4
429121,480_15_31,PANAMA,0,TOTALS,PANAMA,200,24,56,42.9,16,30,53.3,8,26,30.8,15,22,68.2,12,24,36,13,24,20,7,3,71
429122,480_15_31,PUERTO RICO,23748,1,ramon clemente,22,5,8,62.5,5,7,71.4,0,1,0,3,5,60,3,4,7,0,1,4,1,0,13
429123,480_15_31,PUERTO RICO,14636,2,guillermo diaz,6,1,2,50,0,0,0,1,2,50,0,0,0,0,1,1,0,0,0,0,0,3
429124,480_15_31,PUERTO RICO,19036,5,jose juan barea,29,3,10,30,1,5,20,2,5,40,7,8,87.5,0,1,1,3,2,4,1,0,15
429125,480_15_31,PUERTO RICO,23749,6,richard chaney,21,3,5,60,3,4,75,0,1,0,6,8,75,0,2,2,0,3,0,1,0,12
429126,480_15_31,PUERTO RICO,28751,7,javier gonzalez,1,0,1,0,0,1,0,0,0,0,0,0,0,0,0,0,0,0,0,0,0,0
429127,480_15_31,PUERTO RICO,3479,8,angel vassallo,28,2,14,14.3,2,10,20,0,4,0,0,0,0,2,2,4,3,4,0,4,1,4
429128,480_15_31,PUERTO RICO,8997,9,jorge bryan diaz,22,4,5,80,4,5,80,0,0,0,1,2,50,3,1,4,3,0,2,0,0,9
429129,480_15_31,PUERTO RICO,103,10,larry ayuso,0,0,0,0,0,0,0,0,0,0,0,0,0,0,0,0,0,0,0,0,0,0
429130,480_15_31,PUERTO RICO,23750,11,luis villafane,0,0,0,0,0,0,0,0,0,0,0,0,0,0,0,0,0,0,0,0,0,0
429131,480_15_31,PUERTO RICO,16592,13,renaldo balkman,26,4,7,57.1,4,7,57.1,0,0,0,0,2,0,2,2,4,1,5,1,1,0,8
429132,480_15_31,PUERTO RICO,19067,23,john holland,17,1,1,100,1,1,100,0,0,0,2,2,100,0,3,3,2,3,0,0,0,4
429133,480_15_31,PUERTO RICO,25443,31,carlos rivera,27,2,3,66.7,2,2,100,0,1,0,6,6,100,0,2,2,4,4,1,1,0,10
429134,480_15_31,PUERTO RICO,0,TOTALS,PUERTO RICO,200,25,56,44.6,22,42,52.4,3,14,21.4,25,33,75.8,10,22,32,16,22,12,9,1,78
429135,480_15_32,MEXICO,16880,4,paul stoll,23,4,7,57.1,1,1,100,3,6,50,0,0,0,0,4,4,6,4,1,0,0,11
429136,480_15_32,MEXICO,23812,5,marco ramos,10,1,1,100,1,1,100,0,0,0,0,0,0,0,1,1,0,1,1,0,0,2
429137,480_15_32,MEXICO,28754,6,juan toscano,25,2,5,40,2,4,50,0,1,0,0,0,0,0,4,4,4,2,1,1,0,4
429138,480_15_32,MEXICO,23756,7,jorge gutierrez,17,4,12,33.3,4,10,40,0,2,0,0,0,0,0,0,0,2,2,0,2,0,8
429139,480_15_32,MEXICO,9836,8,gustavo ayon,20,4,5,80,4,5,80,0,0,0,0,0,0,3,4,7,3,1,2,0,0,8
429140,480_15_32,MEXICO,23813,9,francisco cruz,22,5,10,50,2,5,40,3,5,60,0,0,0,0,0,0,1,0,2,0,0,13
429141,480_15_32,MEXICO,21214,10,gabriel giron,22,3,7,42.9,2,5,40,1,2,50,0,0,0,1,3,4,1,3,4,1,0,7
429142,480_15_32,MEXICO,9834,11,pedro meza,0,0,0,0,0,0,0,0,0,0,0,0,0,0,0,0,0,0,0,0,0,0
429143,480_15_32,MEXICO,9835,12,hector hernandez,18,1,6,16.7,1,1,100,0,5,0,1,2,50,0,1,1,3,1,0,1,0,3
429144,480_15_32,MEXICO,21215,13,orlando mendez,0,0,0,0,0,0,0,0,0,0,0,0,0,0,0,0,0,0,0,0,0,0
429145,480_15_32,MEXICO,25446,14,adrian zamora,25,5,9,55.6,4,8,50,1,1,100,0,0,0,3,0,3,1,3,1,0,0,11
429146,480_15_32,MEXICO,25444,15,israel gutierrez,17,3,5,60,3,5,60,0,0,0,0,0,0,1,6,7,1,1,2,0,0,6
429147,480_15_32,MEXICO,0,TOTALS,MEXICO,200,32,67,47.8,24,45,53.3,8,22,36.4,1,2,50,10,23,33,22,18,14,5,0,73
429148,480_15_32,CANADA,16951,4,philip scrubb,16,3,5,60,2,4,50,1,1,100,0,0,0,0,1,1,0,1,0,1,0,7
429149,480_15_32,CANADA,8989,5,cory joseph,24,3,6,50,3,6,50,0,0,0,2,2,100,0,5,5,6,2,2,1,0,8
429150,480_15_32,CANADA,28756,6,melvin ejim,19,5,7,71.4,5,6,83.3,0,1,0,2,2,100,4,4,8,3,3,1,0,1,12
429151,480_15_32,CANADA,23739,7,andrew nicholson,19,5,10,50,3,6,50,2,4,50,3,4,75,2,1,3,1,0,1,1,0,15
429152,480_15_32,CANADA,16670,8,andrew wiggins,25,6,10,60,2,6,33.3,4,4,100,1,2,50,0,4,4,1,0,1,1,0,17
429153,480_15_32,CANADA,14711,9,nikolas stauskas,25,4,7,57.1,2,4,50,2,3,66.7,2,2,100,0,4,4,3,0,2,2,1,12
429154,480_15_32,CANADA,14713,10,anthony bennett,16,2,5,40,1,3,33.3,1,2,50,0,0,0,0,2,2,2,1,0,0,0,5
429155,480_15_32,CANADA,3485,11,aaron doornekamp,15,0,0,0,0,0,0,0,0,0,1,2,50,1,1,2,3,2,0,1,0,1
429156,480_15_32,CANADA,23740,12,brady heslip,15,2,7,28.6,0,0,0,2,7,28.6,2,2,100,0,1,1,1,0,0,0,0,8
429157,480_15_32,CANADA,12219,13,kelly olynyk,21,4,6,66.7,3,3,100,1,3,33.3,0,0,0,0,2,2,2,1,0,0,1,9
429158,480_15_32,CANADA,28757,14,dwight powell,5,0,1,0,0,1,0,0,0,0,0,0,0,0,1,1,0,1,0,0,0,0
429159,480_15_32,CANADA,7510,15,robert sacre,0,0,0,0,0,0,0,0,0,0,0,0,0,0,0,0,0,0,0,0,0,0
429160,480_15_32,CANADA,0,TOTALS,CANADA,200,34,64,53.1,21,39,53.8,13,25,52,13,16,81.2,7,26,33,22,11,8,7,3,94
429161,480_15_33,PANAMA,4091,4,joel munoz,31,0,2,0,0,2,0,0,0,0,0,0,0,0,1,1,2,1,1,0,0,0
429162,480_15_33,PANAMA,25940,5,trevor gaskins,40,6,14,42.9,5,9,55.6,1,5,20,0,0,0,1,6,7,5,3,2,2,0,13
429163,480_15_33,PANAMA,4139,6,danilo pinnock,0,0,0,0,0,0,0,0,0,0,0,0,0,0,0,0,0,0,0,0,0,0
429164,480_15_33,PANAMA,28755,7,jamelle horne,0,0,0,0,0,0,0,0,0,0,0,0,0,0,0,0,0,0,0,0,0,0
429165,480_15_33,PANAMA,4526,8,jonathan king,2,0,0,0,0,0,0,0,0,0,0,0,0,0,0,0,0,1,1,0,0,0
429166,480_15_33,PANAMA,6822,9,jamaal levy,24,4,7,57.1,4,4,100,0,3,0,0,0,0,0,2,2,3,4,0,1,0,8
429167,480_15_33,PANAMA,19035,10,josimar ayarza,3,0,3,0,0,2,0,0,1,0,0,0,0,0,0,0,0,1,0,0,0,0
429168,480_15_33,PANAMA,401,11,michael hicks,37,8,17,47.1,6,11,54.5,2,6,33.3,2,3,66.7,0,0,0,1,3,3,2,0,20
429169,480_15_33,PANAMA,4529,12,ernesto oglivie,0,0,0,0,0,0,0,0,0,0,0,0,0,0,0,0,0,0,0,0,0,0
429170,480_15_33,PANAMA,14640,13,leonardo pomare,18,2,6,33.3,2,6,33.3,0,0,0,2,2,100,1,1,2,1,0,1,1,0,6
429171,480_15_33,PANAMA,25810,14,jaime lloreda,21,4,6,66.7,4,6,66.7,0,0,0,1,3,33.3,1,4,5,2,2,0,0,0,9
429172,480_15_33,PANAMA,6820,15,ruben garces,23,3,8,37.5,3,8,37.5,0,0,0,0,0,0,4,8,12,0,2,1,1,0,6
429173,480_15_33,PANAMA,0,TOTALS,PANAMA,200,27,63,42.9,24,48,50,3,15,20,5,8,62.5,8,26,34,14,17,10,7,0,62
429174,480_15_33,VENEZUELA,514,4,miguel marriaga,12,1,3,33.3,1,3,33.3,0,0,0,1,4,25,1,0,1,0,2,1,0,1,3
429175,480_15_33,VENEZUELA,16828,5,gregory vargas,29,0,3,0,0,2,0,0,1,0,2,2,100,1,4,5,6,0,3,2,1,2
429176,480_15_33,VENEZUELA,21053,6,john cox,23,9,15,60,8,12,66.7,1,3,33.3,2,2,100,1,5,6,0,3,1,1,0,21
429177,480_15_33,VENEZUELA,16829,8,david cubillan,17,4,8,50,3,6,50,1,2,50,0,0,0,0,0,0,3,2,0,2,0,9
429178,480_15_33,VENEZUELA,9857,10,jose vargas,28,4,11,36.4,4,5,80,0,6,0,0,0,0,1,2,3,1,1,3,0,1,8
429179,480_15_33,VENEZUELA,28745,11,cesar garcia,1,0,0,0,0,0,0,0,0,0,0,0,0,0,0,0,0,1,0,0,0,0
429180,480_15_33,VENEZUELA,9984,12,javinger vargas,0,0,0,0,0,0,0,0,0,0,0,0,0,0,0,0,0,0,0,0,0,0
429181,480_15_33,VENEZUELA,25751,14,miguel ruiz,23,3,4,75,3,4,75,0,0,0,1,2,50,3,3,6,1,4,0,1,0,7
429182,480_15_33,VENEZUELA,19026,15,windi graterol,15,3,8,37.5,2,5,40,1,3,33.3,1,1,100,0,3,3,0,0,1,0,1,8
429183,480_15_33,VENEZUELA,19021,19,heissler guillent,16,4,6,66.7,1,1,100,3,5,60,2,2,100,0,3,3,4,2,2,0,0,13
429184,480_15_33,VENEZUELA,19023,21,dwight lewis,8,0,1,0,0,1,0,0,0,0,0,0,0,0,0,0,0,1,0,0,0,0
429185,480_15_33,VENEZUELA,19022,43,nestor colmenares,29,1,4,25,1,3,33.3,0,1,0,2,2,100,1,9,10,5,3,0,1,0,4
429186,480_15_33,VENEZUELA,0,TOTALS,VENEZUELA,200,29,63,46,23,42,54.8,6,21,28.6,11,15,73.3,10,30,40,20,19,12,7,4,75
429187,480_15_34,DOMINICAN REPUBLIC,19011,4,edgar sosa,14,3,7,42.9,1,4,25,2,3,66.7,1,4,25,0,2,2,2,3,2,0,0,9
429188,480_15_34,DOMINICAN REPUBLIC,25436,5,victor liz,22,3,8,37.5,1,2,50,2,6,33.3,2,2,100,1,1,2,2,1,1,0,0,10
429189,480_15_34,DOMINICAN REPUBLIC,28752,6,rigoberto mendoza,26,5,9,55.6,3,4,75,2,5,40,0,1,0,0,2,2,3,2,0,0,0,12
429190,480_15_34,DOMINICAN REPUBLIC,21234,7,angel suero,25,6,8,75,3,4,75,3,4,75,4,7,57.1,2,4,6,2,0,0,0,0,19
429191,480_15_34,DOMINICAN REPUBLIC,23761,8,edward santana,12,3,9,33.3,3,6,50,0,3,0,0,0,0,1,3,4,1,4,0,0,0,6
429192,480_15_34,DOMINICAN REPUBLIC,4116,9,francisco garcia,0,0,0,0,0,0,0,0,0,0,0,0,0,0,0,0,0,0,0,0,0,0
429193,480_15_34,DOMINICAN REPUBLIC,23762,10,james feldeine,22,3,7,42.9,0,2,0,3,5,60,2,2,100,1,0,1,6,1,0,1,0,11
429194,480_15_34,DOMINICAN REPUBLIC,19070,11,eloy vargas,0,0,0,0,0,0,0,0,0,0,0,0,0,0,0,0,0,0,0,0,0,0
429195,480_15_34,DOMINICAN REPUBLIC,19016,12,orlando sanchez,28,5,10,50,3,4,75,2,6,33.3,1,2,50,0,5,5,1,3,2,1,0,13
429196,480_15_34,DOMINICAN REPUBLIC,9947,13,eulis baez,24,2,9,22.2,0,2,0,2,7,28.6,0,0,0,0,3,3,3,1,0,2,0,6
429197,480_15_34,DOMINICAN REPUBLIC,4114,14,luis flores,26,6,12,50,5,10,50,1,2,50,4,4,100,0,1,1,7,2,1,1,0,17
429198,480_15_34,DOMINICAN REPUBLIC,28753,15,juan jose garcia,0,0,0,0,0,0,0,0,0,0,0,0,0,0,0,0,0,0,0,0,0,0
429199,480_15_34,DOMINICAN REPUBLIC,0,TOTALS,DOMINICAN REPUBLIC,200,36,79,45.6,19,38,50,17,41,41.5,14,22,63.6,6,24,30,27,17,6,5,0,103
429200,480_15_34,CANADA,16951,4,philip scrubb,16,3,7,42.9,1,5,20,2,2,100,2,2,100,0,1,1,2,1,0,0,0,10
429201,480_15_34,CANADA,8989,5,cory joseph,24,8,12,66.7,8,10,80,0,2,0,1,1,100,0,1,1,7,1,1,0,1,17
429202,480_15_34,CANADA,28756,6,melvin ejim,9,2,2,100,2,2,100,0,0,0,1,2,50,1,3,4,3,4,2,1,0,5
429203,480_15_34,CANADA,23739,7,andrew nicholson,13,1,3,33.3,1,2,50,0,1,0,0,0,0,0,2,2,1,3,3,0,0,2
429204,480_15_34,CANADA,16670,8,andrew wiggins,23,4,10,40,3,9,33.3,1,1,100,3,4,75,1,3,4,6,1,2,0,0,12
429205,480_15_34,CANADA,14711,9,nikolas stauskas,25,5,8,62.5,3,6,50,2,2,100,2,2,100,1,6,7,3,2,0,2,0,14
429206,480_15_34,CANADA,14713,10,anthony bennett,17,4,5,80,0,0,0,4,5,80,2,2,100,1,5,6,1,1,1,0,0,14
429207,480_15_34,CANADA,3485,11,aaron doornekamp,17,5,7,71.4,3,5,60,2,2,100,0,0,0,0,3,3,0,3,2,0,0,12
429208,480_15_34,CANADA,23740,12,brady heslip,15,2,9,22.2,1,2,50,1,7,14.3,0,0,0,2,0,2,0,2,1,0,0,5
429209,480_15_34,CANADA,12219,13,kelly olynyk,18,5,8,62.5,3,5,60,2,3,66.7,1,2,50,1,8,9,1,0,1,0,0,13
429210,480_15_34,CANADA,28757,14,dwight powell,14,3,6,50,3,6,50,0,0,0,2,2,100,3,5,8,2,4,1,0,0,8
429211,480_15_34,CANADA,7510,15,robert sacre,9,4,4,100,4,4,100,0,0,0,0,0,0,1,2,3,3,1,1,0,0,8
429212,480_15_34,CANADA,0,TOTALS,CANADA,200,46,81,56.8,32,56,57.1,14,25,56,14,17,82.4,14,40,54,29,23,15,3,1,120
429213,480_15_35,URUGUAY,28746,4,santiago vidal,18,1,3,33.3,1,1,100,0,2,0,0,0,0,0,1,1,4,2,1,0,0,2
429214,480_15_35,URUGUAY,7588,5,bruno fitipaldo,22,5,8,62.5,1,3,33.3,4,5,80,1,2,50,0,0,0,1,0,3,0,0,15
429215,480_15_35,URUGUAY,298,6,mauricio aguiar,25,3,9,33.3,2,5,40,1,4,25,0,0,0,0,1,1,0,1,2,1,0,7
429216,480_15_35,URUGUAY,7590,7,mathias calfani,26,3,10,30,3,10,30,0,0,0,1,2,50,2,4,6,4,4,3,3,2,7
429217,480_15_35,URUGUAY,12235,10,marcel souberbielle,12,1,1,100,0,0,0,1,1,100,0,0,0,0,1,1,0,0,0,0,0,3
429218,480_15_35,URUGUAY,296,11,martin osimani,23,1,4,25,1,2,50,0,2,0,0,0,0,1,3,4,5,0,1,1,0,2
429219,480_15_35,URUGUAY,14992,13,hernando caceres,16,2,6,33.3,2,3,66.7,0,3,0,2,2,100,1,4,5,0,1,1,0,0,6
429220,480_15_35,URUGUAY,4134,14,nicolas borsellino,18,5,7,71.4,5,7,71.4,0,0,0,2,2,100,0,6,6,0,2,1,1,0,12
429221,480_15_35,URUGUAY,12278,21,luciano parodi,11,1,2,50,1,2,50,0,0,0,2,2,100,1,0,1,2,1,1,0,0,4
429222,480_15_35,URUGUAY,19040,22,reque newsome,12,1,3,33.3,1,3,33.3,0,0,0,1,2,50,1,0,1,2,4,3,0,0,3
429223,480_15_35,URUGUAY,23760,33,kiril wachsmann,8,1,3,33.3,1,3,33.3,0,0,0,0,0,0,1,0,1,0,0,2,0,0,2
429224,480_15_35,URUGUAY,28747,41,demian alvarez,10,3,6,50,3,3,100,0,3,0,0,0,0,0,2,2,1,0,0,0,0,6
429225,480_15_35,URUGUAY,0,TOTALS,URUGUAY,200,27,62,43.5,21,42,50,6,20,30,9,12,75,10,24,34,19,15,19,6,2,69
429226,480_15_35,PUERTO RICO,23748,1,ramon clemente,20,4,5,80,3,4,75,1,1,100,2,4,50,4,4,8,3,3,2,2,0,11
429227,480_15_35,PUERTO RICO,14636,2,guillermo diaz,16,1,6,16.7,1,6,16.7,0,0,0,0,0,0,0,0,0,2,2,1,0,0,2
429228,480_15_35,PUERTO RICO,19036,5,jose juan barea,22,7,10,70,4,6,66.7,3,4,75,2,2,100,0,2,2,0,0,1,1,0,19
429229,480_15_35,PUERTO RICO,23749,6,richard chaney,20,1,6,16.7,1,3,33.3,0,3,0,2,2,100,0,1,1,0,2,2,0,0,4
429230,480_15_35,PUERTO RICO,28751,7,javier gonzalez,13,1,4,25,1,2,50,0,2,0,2,2,100,0,1,1,0,1,2,1,0,4
429231,480_15_35,PUERTO RICO,3479,8,angel vassallo,29,4,9,44.4,3,4,75,1,5,20,0,0,0,0,3,3,1,2,4,0,1,9
429232,480_15_35,PUERTO RICO,8997,9,jorge bryan diaz,22,4,5,80,4,5,80,0,0,0,0,2,0,2,1,3,2,1,1,1,0,8
429233,480_15_35,PUERTO RICO,103,10,larry ayuso,0,0,0,0,0,0,0,0,0,0,0,0,0,0,0,0,0,0,0,0,0,0
429234,480_15_35,PUERTO RICO,23750,11,luis villafane,8,0,1,0,0,1,0,0,0,0,0,0,0,0,2,2,1,1,0,0,0,0
429235,480_15_35,PUERTO RICO,16592,13,renaldo balkman,29,7,10,70,6,8,75,1,2,50,2,5,40,1,8,9,1,2,1,2,3,17
429236,480_15_35,PUERTO RICO,19067,23,john holland,7,1,2,50,0,0,0,1,2,50,0,0,0,0,1,1,1,1,0,0,0,3
429237,480_15_35,PUERTO RICO,25443,31,carlos rivera,15,1,4,25,0,2,0,1,2,50,0,0,0,1,1,2,5,2,1,1,0,3
429238,480_15_35,PUERTO RICO,0,TOTALS,PUERTO RICO,200,31,62,50,23,41,56.1,8,21,38.1,10,17,58.8,11,27,38,16,17,15,8,4,80
429239,480_15_36,MEXICO,16880,4,paul stoll,19,2,3,66.7,1,1,100,1,2,50,0,0,0,1,1,2,5,5,1,3,0,5
429240,480_15_36,MEXICO,23812,5,marco ramos,3,0,0,0,0,0,0,0,0,0,0,0,0,0,1,1,0,1,0,0,0,0
429241,480_15_36,MEXICO,28754,6,juan toscano,19,1,3,33.3,1,2,50,0,1,0,0,0,0,0,2,2,2,2,1,1,0,2
429242,480_15_36,MEXICO,23756,7,jorge gutierrez,36,9,14,64.3,9,13,69.2,0,1,0,5,7,71.4,1,3,4,4,2,3,2,0,23
429243,480_15_36,MEXICO,9836,8,gustavo ayon,40,14,23,60.9,14,23,60.9,0,0,0,10,12,83.3,5,9,14,4,4,2,0,4,38
429244,480_15_36,MEXICO,23813,9,francisco cruz,34,9,16,56.2,6,11,54.5,3,5,60,0,0,0,2,4,6,5,2,2,0,0,21
429245,480_15_36,MEXICO,21214,10,gabriel giron,10,0,0,0,0,0,0,0,0,0,0,0,0,0,1,1,0,2,0,1,1,0
429246,480_15_36,MEXICO,9834,11,pedro meza,0,0,0,0,0,0,0,0,0,0,0,0,0,0,0,0,0,0,0,0,0,0
429247,480_15_36,MEXICO,9835,12,hector hernandez,36,3,7,42.9,3,4,75,0,3,0,0,0,0,1,4,5,3,4,1,0,0,6
429248,480_15_36,MEXICO,21215,13,orlando mendez,0,0,0,0,0,0,0,0,0,0,0,0,0,0,0,0,0,0,0,0,0,0
429249,480_15_36,MEXICO,25446,14,adrian zamora,3,0,0,0,0,0,0,0,0,0,0,0,0,0,0,0,0,0,0,0,0,0
429250,480_15_36,MEXICO,25444,15,israel gutierrez,0,0,0,0,0,0,0,0,0,0,0,0,0,0,0,0,0,0,0,0,0,0
429251,480_15_36,MEXICO,0,TOTALS,MEXICO,200,38,66,57.6,34,54,63,4,12,33.3,15,19,78.9,11,26,37,23,22,11,7,5,95
429252,480_15_36,ARGENTINA,80,4,luis scola,33,11,19,57.9,11,18,61.1,0,1,0,4,8,50,2,2,4,1,4,4,0,1,26
429253,480_15_36,ARGENTINA,25731,5,nicolas richotti,4,0,2,0,0,1,0,0,1,0,0,0,0,0,0,0,0,1,0,0,0,0
429254,480_15_36,ARGENTINA,21037,7,facundo campazzo,30,4,12,33.3,3,7,42.9,1,5,20,2,2,100,2,2,4,5,3,1,2,0,11
429255,480_15_36,ARGENTINA,12228,8,nicolas laprovittola,28,4,7,57.1,1,4,25,3,3,100,0,0,0,1,2,3,5,2,4,1,0,11
429256,480_15_36,ARGENTINA,25732,9,nicolas brussino,0,0,0,0,0,0,0,0,0,0,0,0,0,0,0,0,0,0,0,0,0,0
429257,480_15_36,ARGENTINA,14903,12,marcos delia,20,0,2,0,0,2,0,0,0,0,3,4,75,1,1,2,1,2,0,0,0,3
429258,480_15_36,ARGENTINA,82,13,andres nocioni,34,6,13,46.2,4,9,44.4,2,4,50,5,5,100,0,8,8,0,3,0,2,1,19
429259,480_15_36,ARGENTINA,15007,14,gabriel deck,0,0,0,0,0,0,0,0,0,0,0,0,0,0,0,0,0,0,0,0,0,0
429260,480_15_36,ARGENTINA,21197,15,selem safar,16,1,4,25,0,0,0,1,4,25,0,0,0,0,0,0,0,1,1,0,0,3
429261,480_15_36,ARGENTINA,459,19,leo mainoldi,5,0,1,0,0,0,0,0,1,0,0,0,0,0,0,0,0,2,0,0,0,0
429262,480_15_36,ARGENTINA,12296,29,patricio garino,26,4,4,100,2,2,100,2,2,100,0,0,0,0,2,2,3,3,0,2,0,10
429263,480_15_36,ARGENTINA,16652,83,tayavek gallizzi,5,0,0,0,0,0,0,0,0,0,0,0,0,0,0,0,0,1,0,0,0,0
429264,480_15_36,ARGENTINA,0,TOTALS,ARGENTINA,200,30,64,46.9,21,43,48.8,9,21,42.9,14,19,73.7,10,17,27,15,22,11,7,2,83
429265,480_15_37,CANADA,16951,4,philip scrubb,20,1,2,50,1,1,100,0,1,0,1,2,50,1,1,2,4,0,1,1,0,3
429266,480_15_37,CANADA,8989,5,cory joseph,21,1,8,12.5,1,6,16.7,0,2,0,3,3,100,1,2,3,4,3,2,2,0,5
429267,480_15_37,CANADA,28756,6,melvin ejim,9,1,4,25,1,4,25,0,0,0,2,2,100,2,0,2,0,4,0,0,0,4
429268,480_15_37,CANADA,23739,7,andrew nicholson,15,4,6,66.7,4,5,80,0,1,0,1,3,33.3,0,2,2,0,0,0,0,0,9
429269,480_15_37,CANADA,16670,8,andrew wiggins,26,4,11,36.4,3,9,33.3,1,2,50,0,0,0,1,1,2,2,3,4,0,0,9
429270,480_15_37,CANADA,14711,9,nikolas stauskas,15,1,3,33.3,1,1,100,0,2,0,0,0,0,1,0,1,1,1,1,1,0,2
429271,480_15_37,CANADA,14713,10,anthony bennett,16,0,2,0,0,2,0,0,0,0,0,0,0,2,3,5,0,2,1,0,0,0
429272,480_15_37,CANADA,3485,11,aaron doornekamp,14,1,1,100,1,1,100,0,0,0,0,0,0,0,3,3,0,1,0,1,0,2
429273,480_15_37,CANADA,23740,12,brady heslip,24,4,8,50,3,3,100,1,5,20,1,2,50,0,1,1,1,0,1,2,0,10
429274,480_15_37,CANADA,12219,13,kelly olynyk,36,11,13,84.6,8,9,88.9,3,4,75,9,10,90,0,13,13,2,4,6,0,0,34
429275,480_15_37,CANADA,28757,14,dwight powell,4,0,0,0,0,0,0,0,0,0,0,0,0,0,1,1,0,0,1,0,0,0
429276,480_15_37,CANADA,7510,15,robert sacre,0,0,0,0,0,0,0,0,0,0,0,0,0,0,0,0,0,0,0,0,0,0
429277,480_15_37,CANADA,0,TOTALS,CANADA,200,28,58,48.3,23,41,56.1,5,17,29.4,17,22,77.3,13,29,42,14,18,17,7,0,78
429278,480_15_37,VENEZUELA,514,4,miguel marriaga,1,0,0,0,0,0,0,0,0,0,0,0,0,0,0,0,0,0,0,0,0,0
429279,480_15_37,VENEZUELA,16828,5,gregory vargas,25,3,5,60,3,4,75,0,1,0,3,4,75,0,5,5,3,4,1,1,1,9
429280,480_15_37,VENEZUELA,21053,6,john cox,29,6,15,40,5,11,45.5,1,4,25,1,1,100,0,1,1,4,1,2,1,0,14
429281,480_15_37,VENEZUELA,16829,8,david cubillan,10,0,3,0,0,2,0,0,1,0,1,2,50,0,1,1,1,1,0,0,0,1
429282,480_15_37,VENEZUELA,9857,10,jose vargas,23,1,8,12.5,1,4,25,0,4,0,0,0,0,2,0,2,0,3,0,2,0,2
429283,480_15_37,VENEZUELA,28745,11,cesar garcia,0,0,0,0,0,0,0,0,0,0,0,0,0,0,0,0,0,0,0,0,0,0
429284,480_15_37,VENEZUELA,9984,12,javinger vargas,6,1,2,50,0,0,0,1,2,50,0,0,0,0,2,2,1,0,1,0,0,3
429285,480_15_37,VENEZUELA,25751,14,miguel ruiz,7,0,0,0,0,0,0,0,0,0,0,0,0,2,1,3,0,3,1,0,0,0
429286,480_15_37,VENEZUELA,19026,15,windi graterol,30,7,11,63.6,4,6,66.7,3,5,60,3,4,75,1,4,5,2,3,0,1,1,20
429287,480_15_37,VENEZUELA,19021,19,heissler guillent,22,6,14,42.9,2,5,40,4,9,44.4,3,3,100,1,2,3,2,1,1,3,0,19
429288,480_15_37,VENEZUELA,19023,21,dwight lewis,16,1,5,20,0,4,0,1,1,100,0,0,0,0,0,0,1,2,3,1,0,3
429289,480_15_37,VENEZUELA,19022,43,nestor colmenares,33,2,4,50,2,3,66.7,0,1,0,4,5,80,4,2,6,2,4,1,2,1,8
429290,480_15_37,VENEZUELA,0,TOTALS,VENEZUELA,200,27,67,40.3,17,39,43.6,10,28,35.7,15,19,78.9,12,20,32,16,22,11,11,3,79
429291,480_15_38,ARGENTINA,80,4,luis scola,40,6,12,50,6,11,54.5,0,1,0,6,8,75,5,5,10,2,2,2,1,1,18
429292,480_15_38,ARGENTINA,25731,5,nicolas richotti,0,0,0,0,0,0,0,0,0,0,0,0,0,0,0,0,0,0,0,0,0,0
429293,480_15_38,ARGENTINA,21037,7,facundo campazzo,28,7,14,50,6,9,66.7,1,5,20,0,0,0,0,2,2,8,4,1,2,0,15
429294,480_15_38,ARGENTINA,12228,8,nicolas laprovittola,18,2,5,40,0,0,0,2,5,40,0,0,0,1,3,4,3,4,3,1,0,6
429295,480_15_38,ARGENTINA,25732,9,nicolas brussino,0,0,0,0,0,0,0,0,0,0,0,0,0,0,0,0,0,0,0,0,0,0
429296,480_15_38,ARGENTINA,14903,12,marcos delia,16,4,4,100,4,4,100,0,0,0,1,2,50,0,1,1,1,1,0,0,0,9
429297,480_15_38,ARGENTINA,82,13,andres nocioni,40,4,13,30.8,4,10,40,0,3,0,2,4,50,3,10,13,1,1,1,2,2,10
429298,480_15_38,ARGENTINA,15007,14,gabriel deck,0,0,0,0,0,0,0,0,0,0,0,0,0,0,0,0,0,0,0,0,0,0
429299,480_15_38,ARGENTINA,21197,15,selem safar,27,3,10,30,0,1,0,3,9,33.3,1,1,100,0,1,1,3,2,2,2,0,10
429300,480_15_38,ARGENTINA,459,19,leo mainoldi,5,1,2,50,0,0,0,1,2,50,0,0,0,0,1,1,0,0,0,0,0,3
429301,480_15_38,ARGENTINA,12296,29,patricio garino,18,1,3,33.3,0,1,0,1,2,50,0,0,0,0,0,0,0,2,2,2,0,3
429302,480_15_38,ARGENTINA,16652,83,tayavek gallizzi,9,2,4,50,2,4,50,0,0,0,0,0,0,1,0,1,0,2,1,0,0,4
429303,480_15_38,ARGENTINA,0,TOTALS,ARGENTINA,200,30,67,44.8,22,40,55,8,27,29.6,10,15,66.7,12,26,38,18,18,13,10,3,78
429304,480_15_38,MEXICO,16880,4,paul stoll,20,1,5,20,1,1,100,0,4,0,2,2,100,0,3,3,4,4,4,2,0,4
429305,480_15_38,MEXICO,23812,5,marco ramos,3,0,0,0,0,0,0,0,0,0,0,0,0,0,1,1,0,1,0,0,0,0
429306,480_15_38,MEXICO,28754,6,juan toscano,33,4,12,33.3,3,8,37.5,1,4,25,1,1,100,0,2,2,2,2,2,2,0,10
429307,480_15_38,MEXICO,23756,7,jorge gutierrez,28,8,12,66.7,7,10,70,1,2,50,0,0,0,0,2,2,0,5,2,4,0,17
429308,480_15_38,MEXICO,9836,8,gustavo ayon,40,4,9,44.4,4,9,44.4,0,0,0,0,1,0,4,8,12,5,1,1,0,1,8
429309,480_15_38,MEXICO,23813,9,francisco cruz,32,5,13,38.5,3,8,37.5,2,5,40,4,4,100,0,2,2,1,4,5,0,0,16
429310,480_15_38,MEXICO,21214,10,gabriel giron,4,0,1,0,0,0,0,0,1,0,0,0,0,0,0,0,0,2,0,0,0,0
429311,480_15_38,MEXICO,9834,11,pedro meza,0,0,0,0,0,0,0,0,0,0,0,0,0,0,0,0,0,0,0,0,0,0
429312,480_15_38,MEXICO,9835,12,hector hernandez,38,5,8,62.5,0,2,0,5,6,83.3,0,0,0,1,3,4,4,2,1,1,0,15
429313,480_15_38,MEXICO,21215,13,orlando mendez,2,0,1,0,0,0,0,0,1,0,0,0,0,0,0,0,1,1,0,0,0,0
429314,480_15_38,MEXICO,25446,14,adrian zamora,0,0,0,0,0,0,0,0,0,0,0,0,0,0,0,0,0,0,0,0,0,0
429315,480_15_38,MEXICO,25444,15,israel gutierrez,0,0,0,0,0,0,0,0,0,0,0,0,0,0,0,0,0,0,0,0,0,0
429316,480_15_38,MEXICO,0,TOTALS,MEXICO,200,27,61,44.3,18,38,47.4,9,23,39.1,7,8,87.5,9,26,35,17,22,15,9,1,70
429317,480_15_39,CANADA,16951,4,philip scrubb,16,2,4,50,1,2,50,1,2,50,0,0,0,0,3,3,1,2,0,0,0,5
429318,480_15_39,CANADA,8989,5,cory joseph,32,4,9,44.4,3,8,37.5,1,1,100,2,2,100,1,5,6,8,3,1,1,0,11
429319,480_15_39,CANADA,28756,6,melvin ejim,11,1,2,50,1,2,50,0,0,0,0,0,0,1,0,1,0,5,1,0,0,2
429320,480_15_39,CANADA,23739,7,andrew nicholson,20,8,13,61.5,4,7,57.1,4,6,66.7,0,0,0,0,3,3,1,2,0,0,0,20
429321,480_15_39,CANADA,16670,8,andrew wiggins,36,7,15,46.7,5,11,45.5,2,4,50,2,2,100,1,2,3,2,1,1,2,1,18
429322,480_15_39,CANADA,14711,9,nikolas stauskas,0,0,0,0,0,0,0,0,0,0,0,0,0,0,0,0,0,0,0,0,0,0
429323,480_15_39,CANADA,14713,10,anthony bennett,1,0,0,0,0,0,0,0,0,0,0,0,0,0,0,0,0,0,0,0,0,0
429324,480_15_39,CANADA,3485,11,aaron doornekamp,4,1,1,100,0,0,0,1,1,100,0,0,0,0,0,0,1,0,0,1,0,3
429325,480_15_39,CANADA,23740,12,brady heslip,32,4,11,36.4,1,3,33.3,3,8,37.5,1,2,50,2,2,4,5,0,0,0,0,12
429326,480_15_39,CANADA,12219,13,kelly olynyk,29,4,8,50,3,6,50,1,2,50,1,2,50,4,7,11,1,2,3,0,1,10
429327,480_15_39,CANADA,28757,14,dwight powell,5,1,2,50,1,2,50,0,0,0,0,0,0,1,2,3,1,1,1,0,0,2
429328,480_15_39,CANADA,7510,15,robert sacre,15,2,6,33.3,2,6,33.3,0,0,0,0,0,0,0,3,3,0,2,1,0,0,4
429329,480_15_39,CANADA,0,TOTALS,CANADA,200,34,71,47.9,21,47,44.7,13,24,54.2,6,8,75,11,30,41,20,18,8,4,2,87
429330,480_15_39,MEXICO,16880,4,paul stoll,34,5,11,45.5,1,2,50,4,9,44.4,2,2,100,1,0,1,10,0,2,0,0,16
429331,480_15_39,MEXICO,23812,5,marco ramos,31,6,12,50,1,3,33.3,5,9,55.6,2,2,100,3,2,5,2,0,0,0,0,19
429332,480_15_39,MEXICO,28754,6,juan toscano,9,0,4,0,0,3,0,0,1,0,0,0,0,1,1,2,0,0,0,0,0,0
429333,480_15_39,MEXICO,23756,7,jorge gutierrez,0,0,0,0,0,0,0,0,0,0,0,0,0,0,0,0,0,0,0,0,0,0
429334,480_15_39,MEXICO,9836,8,gustavo ayon,34,7,13,53.8,7,13,53.8,0,0,0,2,6,33.3,3,16,19,3,4,3,1,2,16
429335,480_15_39,MEXICO,23813,9,francisco cruz,35,4,11,36.4,3,6,50,1,5,20,0,0,0,0,4,4,6,3,1,2,0,9
429336,480_15_39,MEXICO,21214,10,gabriel giron,12,1,3,33.3,1,2,50,0,1,0,0,0,0,0,1,1,3,1,0,0,0,2
429337,480_15_39,MEXICO,9834,11,pedro meza,0,0,0,0,0,0,0,0,0,0,0,0,0,0,0,0,0,0,0,0,0,0
429338,480_15_39,MEXICO,9835,12,hector hernandez,22,3,9,33.3,0,3,0,3,6,50,2,4,50,0,1,1,1,3,0,0,0,11
429339,480_15_39,MEXICO,21215,13,orlando mendez,0,0,0,0,0,0,0,0,0,0,0,0,0,0,0,0,0,0,0,0,0,0
429340,480_15_39,MEXICO,25446,14,adrian zamora,15,5,6,83.3,5,6,83.3,0,0,0,1,2,50,1,0,1,0,5,0,0,1,11
429341,480_15_39,MEXICO,25444,15,israel gutierrez,9,1,1,100,1,1,100,0,0,0,0,0,0,0,1,1,1,0,0,0,0,2
429342,480_15_39,MEXICO,0,TOTALS,MEXICO,200,32,70,45.7,19,39,48.7,13,31,41.9,9,16,56.2,12,28,40,26,16,7,3,3,86
429343,480_15_40,VENEZUELA,514,4,miguel marriaga,13,0,2,0,0,1,0,0,1,0,1,4,25,2,2,4,0,2,0,0,1,1
429344,480_15_40,VENEZUELA,16828,5,gregory vargas,23,3,6,50,3,5,60,0,1,0,3,4,75,2,5,7,4,4,2,1,0,9
429345,480_15_40,VENEZUELA,21053,6,john cox,22,6,14,42.9,6,12,50,0,2,0,2,4,50,0,3,3,0,4,2,0,0,14
429346,480_15_40,VENEZUELA,16829,8,david cubillan,15,0,5,0,0,0,0,0,5,0,2,2,100,1,0,1,2,2,0,2,0,2
429347,480_15_40,VENEZUELA,9857,10,jose vargas,24,4,10,40,4,8,50,0,2,0,0,0,0,2,5,7,2,3,0,2,0,8
429348,480_15_40,VENEZUELA,28745,11,cesar garcia,1,0,0,0,0,0,0,0,0,0,0,0,0,0,0,0,0,0,0,0,0,0
429349,480_15_40,VENEZUELA,9984,12,javinger vargas,4,1,2,50,1,1,100,0,1,0,0,0,0,0,0,0,0,0,0,0,0,2
429350,480_15_40,VENEZUELA,25751,14,miguel ruiz,12,0,0,0,0,0,0,0,0,0,0,0,0,3,3,6,0,2,1,0,0,0
429351,480_15_40,VENEZUELA,19026,15,windi graterol,18,5,9,55.6,4,6,66.7,1,3,33.3,0,0,0,0,1,1,0,2,1,0,0,11
429352,480_15_40,VENEZUELA,19021,19,heissler guillent,29,6,12,50,5,8,62.5,1,4,25,2,2,100,0,2,2,3,4,1,1,0,15
429353,480_15_40,VENEZUELA,19023,21,dwight lewis,19,2,7,28.6,1,5,20,1,2,50,0,0,0,0,0,0,1,1,0,2,0,5
429354,480_15_40,VENEZUELA,19022,43,nestor colmenares,20,4,8,50,4,8,50,0,0,0,1,2,50,3,2,5,1,3,2,2,0,9
429355,480_15_40,VENEZUELA,0,TOTALS,VENEZUELA,200,31,75,41.3,28,54,51.9,3,21,14.3,11,18,61.1,14,23,37,13,27,9,10,1,76
429356,480_15_40,ARGENTINA,80,4,luis scola,34,6,11,54.5,6,11,54.5,0,0,0,2,6,33.3,4,7,11,3,3,5,0,0,14
429357,480_15_40,ARGENTINA,25731,5,nicolas richotti,0,0,0,0,0,0,0,0,0,0,0,0,0,0,0,0,0,0,0,0,0,0
429358,480_15_40,ARGENTINA,21037,7,facundo campazzo,25,3,8,37.5,3,7,42.9,0,1,0,2,4,50,2,4,6,7,5,4,2,0,8
429359,480_15_40,ARGENTINA,12228,8,nicolas laprovittola,18,1,7,14.3,0,2,0,1,5,20,6,6,100,0,2,2,3,1,0,0,0,9
429360,480_15_40,ARGENTINA,25732,9,nicolas brussino,0,0,0,0,0,0,0,0,0,0,0,0,0,0,0,0,0,0,0,0,0,0
429361,480_15_40,ARGENTINA,14903,12,marcos delia,14,4,6,66.7,4,6,66.7,0,0,0,0,0,0,0,2,2,0,1,0,0,0,8
429362,480_15_40,ARGENTINA,82,13,andres nocioni,37,6,14,42.9,4,7,57.1,2,7,28.6,7,9,77.8,0,8,8,2,1,3,1,3,21
429363,480_15_40,ARGENTINA,15007,14,gabriel deck,0,0,0,0,0,0,0,0,0,0,0,0,0,0,0,0,0,0,0,0,0,0
429364,480_15_40,ARGENTINA,21197,15,selem safar,32,2,8,25,0,1,0,2,7,28.6,1,1,100,1,1,2,0,1,2,1,0,7
429365,480_15_40,ARGENTINA,459,19,leo mainoldi,3,0,1,0,0,0,0,0,1,0,0,0,0,0,0,0,0,0,0,0,0,0
429366,480_15_40,ARGENTINA,12296,29,patricio garino,32,1,2,50,1,1,100,0,1,0,2,2,100,1,4,5,1,3,3,0,2,4
429367,480_15_40,ARGENTINA,16652,83,tayavek gallizzi,4,0,0,0,0,0,0,0,0,0,0,0,0,0,0,0,0,1,1,0,0,0
429368,480_15_40,ARGENTINA,0,TOTALS,ARGENTINA,200,23,57,40.4,18,35,51.4,5,22,22.7,20,28,71.4,11,32,43,16,16,19,4,5,71
437242,497_15_01,POLAND,15535,0,aleksander czyz,6,0,1,0,0,1,0,0,0,0,0,2,0,1,1,2,1,1,0,0,0,0
437243,497_15_01,POLAND,5694,5,aaron cel,19,3,7,42.9,2,4,50,1,3,33.3,1,2,50,1,6,7,1,3,2,0,0,8
437244,497_15_01,POLAND,29496,6,aj slaughter,31,3,9,33.3,2,5,40,1,4,25,3,4,75,0,1,1,3,2,1,3,0,10
437245,497_15_01,POLAND,7833,7,damian kulig,20,1,3,33.3,1,1,100,0,2,0,2,2,100,2,6,8,0,3,2,2,0,4
437246,497_15_01,POLAND,15981,9,mateusz ponitka,29,6,10,60,5,8,62.5,1,2,50,0,2,0,1,4,5,6,2,3,2,0,13
437247,497_15_01,POLAND,8034,12,adam waczynski,29,3,6,50,1,1,100,2,5,40,7,8,87.5,0,3,3,0,3,3,1,0,15
437248,497_15_01,POLAND,1215,13,marcin gortat,27,4,10,40,4,10,40,0,0,0,2,4,50,1,6,7,3,3,3,0,0,10
437249,497_15_01,POLAND,1207,15,lukasz koszarek,14,1,3,33.3,1,2,50,0,1,0,0,0,0,0,1,1,1,1,1,0,0,2
437250,497_15_01,POLAND,24194,17,przemyslaw zamojski,7,1,4,25,1,2,50,0,2,0,0,0,0,0,2,2,0,1,0,0,0,2
437251,497_15_01,POLAND,12920,24,przemyslaw karnowski,8,1,1,100,1,1,100,0,0,0,0,0,0,0,0,0,0,0,0,0,2,2
437252,497_15_01,POLAND,6186,33,karol gruszecki,11,1,3,33.3,1,1,100,0,2,0,0,0,0,0,1,1,1,1,1,0,0,2
437253,497_15_01,POLAND,4799,66,robert skibniewski,0,0,0,0,0,0,0,0,0,0,0,0,0,0,0,0,0,0,0,0,0,0
437254,497_15_01,POLAND,0,TOTALS,POLAND,200,24,57,42.1,19,36,52.8,5,21,23.8,15,24,62.5,9,33,42,16,20,16,8,2,68
437255,497_15_01,BOSNIA AND HERZEGOVINA,5859,4,muhamed pasalic,6,0,0,0,0,0,0,0,0,0,0,0,0,0,0,0,1,1,0,0,0,0
437256,497_15_01,BOSNIA AND HERZEGOVINA,20566,5,nedim buza,0,0,0,0,0,0,0,0,0,0,0,0,0,0,0,0,0,0,0,0,0,0
437257,497_15_01,BOSNIA AND HERZEGOVINA,7780,6,andrija stipanovic,29,8,12,66.7,8,12,66.7,0,0,0,4,4,100,0,2,2,0,5,4,3,0,20
437258,497_15_01,BOSNIA AND HERZEGOVINA,24189,7,marko sutalo,20,3,11,27.3,1,3,33.3,2,8,25,0,0,0,1,3,4,3,3,1,1,0,8
437259,497_15_01,BOSNIA AND HERZEGOVINA,5026,9,edin bavcic,20,0,2,0,0,0,0,0,2,0,0,2,0,0,5,5,2,1,0,0,0,0
437260,497_15_01,BOSNIA AND HERZEGOVINA,2887,10,nemanja gordic,24,3,11,27.3,3,7,42.9,0,4,0,0,2,0,0,2,2,4,5,2,0,0,6
437261,497_15_01,BOSNIA AND HERZEGOVINA,2891,11,elmedin kikanovic,31,3,15,20,3,13,23.1,0,2,0,0,0,0,4,2,6,0,2,2,1,0,6
437262,497_15_01,BOSNIA AND HERZEGOVINA,24191,13,dalibor persic,10,2,4,50,1,2,50,1,2,50,1,1,100,1,0,1,0,0,1,1,0,6
437263,497_15_01,BOSNIA AND HERZEGOVINA,15282,15,milan milosevic,24,2,5,40,1,4,25,1,1,100,3,5,60,2,5,7,1,4,0,1,0,8
437264,497_15_01,BOSNIA AND HERZEGOVINA,29497,20,alex renfroe,26,3,5,60,1,2,50,2,3,66.7,0,2,0,2,4,6,5,1,3,1,1,8
437265,497_15_01,BOSNIA AND HERZEGOVINA,17436,23,adin vrabac,10,1,1,100,1,1,100,0,0,0,0,0,0,0,2,2,3,3,1,1,0,2
437266,497_15_01,BOSNIA AND HERZEGOVINA,29498,30,drasko albijanic,0,0,0,0,0,0,0,0,0,0,0,0,0,0,0,0,0,0,0,0,0,0
437267,497_15_01,BOSNIA AND HERZEGOVINA,0,TOTALS,BOSNIA AND HERZEGOVINA,200,25,66,37.9,19,44,43.2,6,22,27.3,8,16,50,13,26,39,19,25,14,9,1,64
437268,497_15_02,GERMANY,29499,4,maodo lo,2,0,0,0,0,0,0,0,0,0,0,0,0,0,1,1,0,0,0,0,0,0
437269,497_15_02,GERMANY,8235,5,niels giffey,12,2,5,40,1,4,25,1,1,100,1,2,50,0,2,2,1,1,3,0,0,6
437270,497_15_02,GERMANY,1192,7,alex king,16,3,5,60,3,4,75,0,1,0,0,0,0,3,1,4,0,2,0,1,0,6
437271,497_15_02,GERMANY,15385,8,heiko schaffartzik,16,0,2,0,0,0,0,0,2,0,0,0,0,0,2,2,5,2,1,0,0,0
437272,497_15_02,GERMANY,10446,9,karsten tadda,5,0,0,0,0,0,0,0,0,0,0,0,0,0,1,1,0,3,0,0,0,0
437273,497_15_02,GERMANY,10637,11,tibor pleiss,14,2,4,50,2,4,50,0,0,0,0,0,0,2,3,5,0,3,2,0,0,4
437274,497_15_02,GERMANY,6326,12,robin benzing,12,2,6,33.3,0,1,0,2,5,40,0,0,0,0,1,1,2,3,1,0,0,6
437275,497_15_02,GERMANY,4711,14,dirk nowitzki,28,5,11,45.5,5,11,45.5,0,0,0,5,8,62.5,0,7,7,0,1,2,0,1,15
437276,497_15_02,GERMANY,19990,17,dennis schroder,30,7,13,53.8,6,9,66.7,1,4,25,0,1,0,1,5,6,4,2,4,0,0,15
437277,497_15_02,GERMANY,29500,21,paul zipser,28,2,4,50,0,1,0,2,3,66.7,0,0,0,0,7,7,1,5,1,1,1,6
437278,497_15_02,GERMANY,1152,25,anton gavel,28,3,8,37.5,3,4,75,0,4,0,1,2,50,0,2,2,3,1,0,2,0,7
437279,497_15_02,GERMANY,19867,77,johannes voigtmann,10,3,4,75,3,4,75,0,0,0,0,0,0,1,3,4,0,2,1,0,0,6
437280,497_15_02,GERMANY,0,TOTALS,GERMANY,200,29,62,46.8,23,42,54.8,6,20,30,7,13,53.8,8,35,43,16,25,15,4,2,71
437281,497_15_02,ICELAND,19926,3,martin hermannsson,14,1,3,33.3,0,0,0,1,3,33.3,0,0,0,0,1,1,1,0,1,2,0,3
437282,497_15_02,ICELAND,24208,4,axel karason,1,0,0,0,0,0,0,0,0,0,0,0,0,0,0,0,0,0,0,0,0,0
437283,497_15_02,ICELAND,15700,5,ragnar nathanaelsson,0,0,0,0,0,0,0,0,0,0,0,0,0,0,0,0,0,0,0,0,0,0
437284,497_15_02,ICELAND,4834,6,jakob sigurdarson,21,1,1,100,1,1,100,0,0,0,0,0,0,0,2,2,1,2,1,1,0,2
437285,497_15_02,ICELAND,4841,8,hlynur baeringsson,35,4,11,36.4,0,4,0,4,7,57.1,0,2,0,2,6,8,2,3,2,0,0,12
437286,497_15_02,ICELAND,4837,9,jon stefansson,29,9,19,47.4,9,16,56.2,0,3,0,5,5,100,1,0,1,5,4,3,1,0,23
437287,497_15_02,ICELAND,4840,10,helgi magnusson,2,0,0,0,0,0,0,0,0,0,0,0,0,0,1,1,0,1,0,0,0,0
437288,497_15_02,ICELAND,2764,13,hordur vilhjalmsson,27,4,9,44.4,4,6,66.7,0,3,0,3,7,42.9,1,5,6,1,4,2,2,0,11
437289,497_15_02,ICELAND,4980,14,logi gunnarsson,19,1,7,14.3,1,4,25,0,3,0,0,2,0,0,1,1,0,3,0,0,0,2
437290,497_15_02,ICELAND,2071,15,pavel ermolinskij,24,0,5,0,0,2,0,0,3,0,0,2,0,1,5,6,0,2,2,0,1,0
437291,497_15_02,ICELAND,13211,24,haukur palsson,28,3,6,50,1,3,33.3,2,3,66.7,4,4,100,0,2,2,1,4,1,0,0,12
437292,497_15_02,ICELAND,15702,29,aegir steinarsson,1,0,1,0,0,1,0,0,0,0,0,0,0,0,0,0,0,0,0,0,0,0
437293,497_15_02,ICELAND,0,TOTALS,ICELAND,200,23,62,37.1,16,37,43.2,7,25,28,12,22,54.5,8,27,35,11,23,12,6,1,65
437294,497_15_03,GEORGIA,24223,0,jacob everse pullen,25,1,8,12.5,0,4,0,1,4,25,4,4,100,1,1,2,3,2,1,1,0,7
437295,497_15_03,GEORGIA,8378,4,nika metreveli,0,0,0,0,0,0,0,0,0,0,0,0,0,0,0,0,0,0,0,0,0,0
437296,497_15_03,GEORGIA,4919,7,zaza pachulia,30,4,7,57.1,4,7,57.1,0,0,0,8,8,100,0,6,6,4,4,4,0,0,16
437297,497_15_03,GEORGIA,1690,8,george tsintsadze,24,3,3,100,1,1,100,2,2,100,0,0,0,0,0,0,1,2,4,1,0,8
437298,497_15_03,GEORGIA,6436,9,giorgi shermadini,10,1,1,100,1,1,100,0,0,0,0,0,0,2,1,3,0,2,0,0,0,2
437299,497_15_03,GEORGIA,15684,10,duda sanadze,12,4,5,80,1,2,50,3,3,100,0,0,0,0,0,0,0,1,0,0,2,11
437300,497_15_03,GEORGIA,1697,11,manuchar markoishvili,25,4,10,40,1,2,50,3,8,37.5,0,0,0,0,1,1,2,4,0,1,0,11
437301,497_15_03,GEORGIA,12467,12,levan patsatsia,8,0,1,0,0,0,0,0,1,0,0,0,0,0,0,0,0,1,0,0,0,0
437302,497_15_03,GEORGIA,1699,13,viktor sanikidze,26,0,5,0,0,2,0,0,3,0,1,2,50,3,6,9,0,2,4,0,2,1
437303,497_15_03,GEORGIA,16022,15,beka burjanadze,7,0,1,0,0,1,0,0,0,0,0,0,0,1,0,1,0,0,1,0,0,0
437304,497_15_03,GEORGIA,11036,23,tornike shengelia,33,6,18,33.3,6,16,37.5,0,2,0,4,4,100,1,7,8,5,4,1,2,0,16
437305,497_15_03,GEORGIA,1693,25,besik lezhava,0,0,0,0,0,0,0,0,0,0,0,0,0,0,0,0,0,0,0,0,0,0
437306,497_15_03,GEORGIA,0,TOTALS,GEORGIA,200,23,59,39,14,36,38.9,9,23,39.1,17,18,94.4,13,23,36,15,22,15,5,4,72
437307,497_15_03,NETHERLANDS,20407,0,yannick franke,0,0,0,0,0,0,0,0,0,0,0,0,0,0,0,0,0,0,0,0,0,0
437308,497_15_03,NETHERLANDS,15661,5,leon williams,11,0,0,0,0,0,0,0,0,0,0,0,0,1,1,2,3,2,2,0,0,0
437309,497_15_03,NETHERLANDS,24213,6,worthy de jong,19,5,9,55.6,4,8,50,1,1,100,5,8,62.5,1,5,6,0,2,2,0,0,16
437310,497_15_03,NETHERLANDS,15520,7,charlon kloof,29,8,18,44.4,4,11,36.4,4,7,57.1,2,5,40,2,1,3,2,2,2,2,0,22
437311,497_15_03,NETHERLANDS,10671,9,mohamed kherrazi,20,1,2,50,1,2,50,0,0,0,0,0,0,0,2,2,1,2,0,2,0,2
437312,497_15_03,NETHERLANDS,12501,10,ralf de pagter,0,0,0,0,0,0,0,0,0,0,0,0,0,0,0,0,0,0,0,0,0,0
437313,497_15_03,NETHERLANDS,29501,12,kees akerboom,18,1,3,33.3,0,2,0,1,1,100,2,2,100,0,0,0,0,1,0,0,0,5
437314,497_15_03,NETHERLANDS,2871,13,roeland schaftenaar,22,3,8,37.5,3,8,37.5,0,0,0,0,0,0,2,3,5,4,2,0,0,0,6
437315,497_15_03,NETHERLANDS,7480,18,nicolas de jong,13,2,4,50,2,4,50,0,0,0,0,0,0,2,1,3,0,4,1,0,0,4
437316,497_15_03,NETHERLANDS,5809,21,robin smeulders,21,3,4,75,3,4,75,0,0,0,2,2,100,1,3,4,0,1,0,0,0,8
437317,497_15_03,NETHERLANDS,5810,23,henk norel,24,2,3,66.7,2,3,66.7,0,0,0,4,6,66.7,2,2,4,0,3,3,1,0,8
437318,497_15_03,NETHERLANDS,10202,44,arvin slagter,23,1,7,14.3,1,2,50,0,5,0,0,0,0,1,1,2,3,3,2,0,0,2
437319,497_15_03,NETHERLANDS,0,TOTALS,NETHERLANDS,200,26,58,44.8,20,44,45.5,6,14,42.9,15,23,65.2,14,23,37,13,22,12,5,0,73
437320,497_15_04,CZECH REPUBLIC,4677,4,petr benda,19,3,4,75,1,2,50,2,2,100,0,0,0,1,5,6,1,3,3,1,0,8
437321,497_15_04,CZECH REPUBLIC,29502,5,patrik auda,15,1,4,25,1,4,25,0,0,0,1,2,50,0,2,2,0,2,0,0,0,3
437322,497_15_04,CZECH REPUBLIC,5478,6,pavel pumprla,16,2,6,33.3,2,5,40,0,1,0,1,1,100,0,2,2,3,3,0,1,1,5
437323,497_15_04,CZECH REPUBLIC,10700,7,vojtech hruban,12,2,5,40,2,4,50,0,1,0,0,0,0,0,2,2,1,0,0,0,0,4
437324,497_15_04,CZECH REPUBLIC,8325,8,tomas satoransky,26,2,8,25,1,3,33.3,1,5,20,2,2,100,0,7,7,3,1,0,0,0,7
437325,497_15_04,CZECH REPUBLIC,4774,9,jiri welsch,18,2,5,40,2,5,40,0,0,0,1,4,25,1,1,2,3,2,1,0,0,5
437326,497_15_04,CZECH REPUBLIC,1096,10,pavel houska,16,1,6,16.7,1,4,25,0,2,0,0,0,0,1,2,3,2,1,1,0,0,2
437327,497_15_04,CZECH REPUBLIC,4775,11,lubos barton,8,0,1,0,0,0,0,0,1,0,0,0,0,0,1,1,0,0,0,0,0,0
437328,497_15_04,CZECH REPUBLIC,8327,12,david jelinek,19,4,7,57.1,3,4,75,1,3,33.3,2,2,100,1,0,1,3,1,1,1,0,11
437329,497_15_04,CZECH REPUBLIC,10484,13,jakub sirina,6,2,2,100,1,1,100,1,1,100,0,0,0,0,0,0,0,2,1,1,0,5
437330,497_15_04,CZECH REPUBLIC,29503,14,blake schilb,24,6,9,66.7,4,7,57.1,2,2,100,0,1,0,2,2,4,1,1,0,0,0,14
437331,497_15_04,CZECH REPUBLIC,6362,24,jan vesely,22,7,11,63.6,7,11,63.6,0,0,0,2,4,50,3,5,8,1,1,2,1,1,16
437332,497_15_04,CZECH REPUBLIC,0,TOTALS,CZECH REPUBLIC,200,32,68,47.1,25,50,50,7,18,38.9,9,16,56.2,11,30,41,18,17,9,5,2,80
437333,497_15_04,ESTONIA,11295,4,rain veideman,28,4,9,44.4,2,5,40,2,4,50,0,0,0,1,1,2,2,0,1,0,0,10
437334,497_15_04,ESTONIA,1218,5,tanel sokk,7,1,3,33.3,1,3,33.3,0,0,0,0,0,0,0,0,0,0,1,0,0,0,2
437335,497_15_04,ESTONIA,1219,6,gert dorbek,4,0,2,0,0,2,0,0,0,0,0,0,0,2,1,3,0,1,0,0,0,0
437336,497_15_04,ESTONIA,2721,7,sten sokk,31,1,7,14.3,1,4,25,0,3,0,1,2,50,0,5,5,1,2,6,1,0,3
437337,497_15_04,ESTONIA,4625,8,janar talts,26,3,7,42.9,3,5,60,0,2,0,0,0,0,2,2,4,2,4,0,0,1,6
437338,497_15_04,ESTONIA,4622,9,gregor arbet,18,1,7,14.3,1,6,16.7,0,1,0,2,2,100,0,1,1,0,5,0,1,0,4
437339,497_15_04,ESTONIA,6373,10,erik keedus,22,1,7,14.3,1,3,33.3,0,4,0,0,0,0,0,2,2,0,2,1,2,0,2
437340,497_15_04,ESTONIA,6377,11,siim-sander vene,29,7,13,53.8,6,10,60,1,3,33.3,3,3,100,3,10,13,2,0,2,0,0,18
437341,497_15_04,ESTONIA,15312,13,joosep toome,12,2,3,66.7,2,2,100,0,1,0,0,0,0,0,3,3,1,2,0,0,0,4
437342,497_15_04,ESTONIA,4771,14,kristjan kangur,23,2,6,33.3,1,4,25,1,2,50,3,3,100,0,3,3,0,5,4,0,0,8
437343,497_15_04,ESTONIA,1229,15,reinar hallik,0,0,0,0,0,0,0,0,0,0,0,0,0,0,0,0,0,0,0,0,0,0
437344,497_15_04,ESTONIA,8047,20,tanel kurbas,0,0,0,0,0,0,0,0,0,0,0,0,0,0,0,0,0,0,0,0,0,0
437345,497_15_04,ESTONIA,0,TOTALS,ESTONIA,200,22,64,34.4,18,44,40.9,4,20,20,9,10,90,11,28,39,8,22,15,4,1,57
437346,497_15_05,ISRAEL,24229,5,dagan yivzori,10,2,4,50,2,2,100,0,2,0,0,0,0,0,0,0,0,1,0,0,0,4
437347,497_15_05,ISRAEL,21841,6,shawn dawson,11,0,2,0,0,2,0,0,0,0,1,2,50,0,0,0,0,2,1,1,0,1
437348,497_15_05,ISRAEL,2522,7,gal mekel,33,4,8,50,4,6,66.7,0,2,0,5,6,83.3,0,3,3,3,3,2,1,0,13
437349,497_15_05,ISRAEL,1023,8,lior eliyahu,32,7,10,70,7,10,70,0,0,0,2,2,100,0,0,0,4,2,3,3,0,16
437350,497_15_05,ISRAEL,1933,9,omri casspi,38,5,10,50,3,7,42.9,2,3,66.7,9,15,60,0,9,9,3,2,3,0,0,21
437351,497_15_05,ISRAEL,1022,10,raviv limonad,17,4,5,80,3,3,100,1,2,50,3,4,75,0,1,1,3,4,0,1,0,12
437352,497_15_05,ISRAEL,5780,11,elishay kadir,26,2,5,40,2,5,40,0,0,0,3,5,60,2,3,5,2,3,1,0,0,7
437353,497_15_05,ISRAEL,1685,12,yogev ohayon,19,1,5,20,1,3,33.3,0,2,0,0,0,0,0,2,2,5,4,1,3,0,2
437354,497_15_05,ISRAEL,4620,14,yaniv green,3,0,0,0,0,0,0,0,0,0,0,0,0,0,0,0,0,1,0,0,0,0
437355,497_15_05,ISRAEL,29504,15,dor fischer,11,0,0,0,0,0,0,0,0,0,0,0,0,0,1,1,0,3,0,0,0,0
437356,497_15_05,ISRAEL,19712,16,boris rothbart,0,0,0,0,0,0,0,0,0,0,0,0,0,0,0,0,0,0,0,0,0,0
437357,497_15_05,ISRAEL,12887,23,bar timor,0,0,0,0,0,0,0,0,0,0,0,0,0,0,0,0,0,0,0,0,0,0
437358,497_15_05,ISRAEL,0,TOTALS,ISRAEL,200,25,49,51,22,38,57.9,3,11,27.3,23,34,67.6,4,25,29,20,25,11,9,0,76
437359,497_15_05,RUSSIA,19857,1,andrey zubkov,20,2,7,28.6,2,5,40,0,2,0,8,8,100,1,1,2,1,1,0,1,0,12
437360,497_15_05,RUSSIA,29505,4,evgenii baburin,0,0,0,0,0,0,0,0,0,0,0,0,0,0,0,0,0,0,0,0,0,0
437361,497_15_05,RUSSIA,8296,5,ruslan pateev,10,0,2,0,0,2,0,0,0,0,2,4,50,0,0,0,0,5,2,0,0,2
437362,497_15_05,RUSSIA,1078,7,vitaly fridzon,17,3,8,37.5,2,6,33.3,1,2,50,2,3,66.7,0,0,0,0,3,2,0,0,9
437363,497_15_05,RUSSIA,1083,9,egor vyaltsev,21,2,6,33.3,1,4,25,1,2,50,0,0,0,0,1,1,1,1,2,1,0,5
437364,497_15_05,RUSSIA,10610,11,semen antonov,18,2,4,50,1,1,100,1,3,33.3,1,1,100,2,3,5,1,3,3,0,0,6
437365,497_15_05,RUSSIA,5064,12,sergey monya,28,2,9,22.2,1,2,50,1,7,14.3,2,2,100,1,3,4,1,4,2,1,0,7
437366,497_15_05,RUSSIA,2554,13,dmitry khvostov,26,5,7,71.4,1,1,100,4,6,66.7,1,2,50,3,1,4,5,0,2,1,0,15
437367,497_15_05,RUSSIA,1808,14,anton ponkrashov,14,0,3,0,0,0,0,0,3,0,0,0,0,0,2,2,0,0,1,0,0,0
437368,497_15_05,RUSSIA,7770,20,andrey vorontsevich,30,5,9,55.6,2,5,40,3,4,75,2,2,100,3,10,13,5,2,2,0,0,15
437369,497_15_05,RUSSIA,21941,32,andrei desiatnikov,0,0,0,0,0,0,0,0,0,0,0,0,0,0,0,0,0,0,0,0,0,0
437370,497_15_05,RUSSIA,1809,41,nikita kurbanov,16,0,4,0,0,4,0,0,0,0,2,2,100,1,4,5,1,5,1,0,1,2
437371,497_15_05,RUSSIA,0,TOTALS,RUSSIA,200,21,59,35.6,10,30,33.3,11,29,37.9,20,24,83.3,12,27,39,15,24,17,4,1,73
437372,497_15_06,SPAIN,61,4,pau gasol,28,5,10,50,5,10,50,0,0,0,6,8,75,3,2,5,2,2,1,0,4,16
437373,497_15_06,SPAIN,70,5,rudy fernandez,33,2,8,25,2,4,50,0,4,0,6,6,100,1,3,4,3,3,2,0,0,10
437374,497_15_06,SPAIN,1877,6,sergio rodriguez,23,1,7,14.3,1,5,20,0,2,0,0,0,0,0,3,3,2,1,3,1,0,2
437375,497_15_06,SPAIN,17609,7,guillermo hernangomez,2,1,1,100,1,1,100,0,0,0,0,1,0,0,0,0,0,1,0,0,0,2
437376,497_15_06,SPAIN,5713,8,pau ribas tossas,24,4,7,57.1,1,2,50,3,5,60,0,0,0,0,0,0,3,3,0,0,0,11
437377,497_15_06,SPAIN,66,9,felipe reyes,22,6,11,54.5,6,11,54.5,0,0,0,1,2,50,2,1,3,0,3,1,1,1,13
437378,497_15_06,SPAIN,2628,10,victor claver,5,0,0,0,0,0,0,0,0,0,0,0,0,0,1,1,1,1,0,1,0,0
437379,497_15_06,SPAIN,1317,11,fernando san emeterio,7,0,0,0,0,0,0,0,0,0,0,0,0,0,0,0,0,1,0,0,0,0
437380,497_15_06,SPAIN,1871,12,sergio llull,30,1,10,10,1,5,20,0,5,0,4,4,100,0,4,4,6,4,1,0,0,6
437381,497_15_06,SPAIN,6265,13,pablo aguilar,0,0,0,0,0,0,0,0,0,0,0,0,0,0,0,0,0,0,0,0,0,0
437382,497_15_06,SPAIN,17234,14,nikola mirotic,23,3,10,30,3,7,42.9,0,3,0,4,4,100,0,10,10,1,3,0,1,1,10
437383,497_15_06,SPAIN,19987,15,guillem vives,3,0,1,0,0,1,0,0,0,0,0,0,0,0,0,0,0,0,0,1,0,0
437384,497_15_06,SPAIN,0,TOTALS,SPAIN,200,23,65,35.4,20,46,43.5,3,19,15.8,21,25,84,8,24,32,18,22,8,5,6,70
437385,497_15_06,SERBIA,5751,4,milos teodosic,29,3,9,33.3,2,4,50,1,5,20,5,6,83.3,0,5,5,4,3,2,0,1,12
437386,497_15_06,SERBIA,2100,5,marko simonovic,1,0,0,0,0,0,0,0,0,0,0,0,0,0,0,0,0,0,0,0,0,0
437387,497_15_06,SERBIA,29506,6,ognjen kuzmic,11,0,1,0,0,1,0,0,0,0,0,0,0,0,2,2,1,4,0,1,1,0
437388,497_15_06,SERBIA,17361,7,bogdan bogdanovic,21,2,3,66.7,0,0,0,2,3,66.7,2,2,100,0,5,5,5,3,2,1,0,8
437389,497_15_06,SERBIA,15386,8,nemanja bjelica,35,8,16,50,5,9,55.6,3,7,42.9,5,6,83.3,1,9,10,4,2,4,0,0,24
437390,497_15_06,SERBIA,2654,9,stefan markovic,24,2,3,66.7,2,2,100,0,1,0,1,3,33.3,1,2,3,1,4,0,1,0,5
437391,497_15_06,SERBIA,19860,10,nikola kalinic,21,2,6,33.3,2,4,50,0,2,0,0,2,0,2,3,5,0,2,1,0,0,4
437392,497_15_06,SERBIA,15503,11,nemanja nedovic,21,6,6,100,4,4,100,2,2,100,0,0,0,0,2,2,3,1,0,0,1,14
437393,497_15_06,SERBIA,15505,12,dragan milosavljevic,4,1,1,100,1,1,100,0,0,0,0,0,0,0,0,0,0,1,0,0,0,2
437394,497_15_06,SERBIA,2656,13,miroslav raduljica,19,2,9,22.2,2,9,22.2,0,0,0,0,0,0,3,3,6,0,3,3,0,0,4
437395,497_15_06,SERBIA,10253,14,zoran erceg,15,2,5,40,1,2,50,1,3,33.3,2,2,100,1,2,3,0,3,2,0,0,7
437396,497_15_06,SERBIA,17652,15,nikola milutinov,0,0,0,0,0,0,0,0,0,0,0,0,0,0,0,0,0,0,0,0,0,0
437397,497_15_06,SERBIA,0,TOTALS,SERBIA,200,28,59,47.5,19,36,52.8,9,23,39.1,15,21,71.4,10,34,44,18,27,14,3,3,80
437398,497_15_07,MKD,6306,4,vladimir brckov,2,0,0,0,0,0,0,0,0,0,0,0,0,1,0,1,0,1,1,0,0,0
437399,497_15_07,MKD,10169,5,vlado ilievski,23,2,6,33.3,1,2,50,1,4,25,0,0,0,0,1,1,1,0,1,0,0,5
437400,497_15_07,MKD,7810,6,darko sokolov,1,0,2,0,0,2,0,0,0,0,0,0,0,1,0,1,0,0,0,0,0,0
437401,497_15_07,MKD,2709,7,aleksandar kostoski,25,8,13,61.5,4,5,80,4,8,50,0,0,0,0,1,1,2,1,2,2,0,20
437402,497_15_07,MKD,5892,8,vojdan stojanovski,29,3,10,30,1,6,16.7,2,4,50,5,5,100,0,1,1,2,1,3,0,0,13
437403,497_15_07,MKD,5892,9,damjan stojanovski,15,2,4,50,1,2,50,1,2,50,0,0,0,0,1,1,0,2,2,0,0,5
437404,497_15_07,MKD,6300,10,marko simonovski,27,2,6,33.3,0,0,0,2,6,33.3,0,0,0,1,2,3,3,2,1,0,0,6
437405,497_15_07,MKD,20507,11,ljubomir mladenovski,3,0,0,0,0,0,0,0,0,0,0,0,0,0,0,0,1,0,0,0,0,0
437406,497_15_07,MKD,2714,12,bojan trajkovski,19,2,7,28.6,0,3,0,2,4,50,0,0,0,0,3,3,0,4,1,0,0,6
437407,497_15_07,MKD,11275,13,stojan gjuroski,19,1,3,33.3,1,2,50,0,1,0,1,2,50,0,4,4,0,1,0,0,0,3
437408,497_15_07,MKD,29507,14,richard hendrix,16,1,3,33.3,1,2,50,0,1,0,0,0,0,1,2,3,0,4,2,0,0,2
437409,497_15_07,MKD,5010,15,predrag samardziski,21,1,9,11.1,1,9,11.1,0,0,0,3,4,75,5,1,6,3,5,0,1,0,5
437410,497_15_07,MKD,0,TOTALS,MKD,200,22,63,34.9,10,33,30.3,12,30,40,9,11,81.8,11,17,28,12,21,15,3,0,65
437411,497_15_07,GREECE,5050,5,yannis bourousis,16,5,8,62.5,5,8,62.5,0,0,0,6,7,85.7,2,8,10,0,3,3,0,0,16
437412,497_15_07,GREECE,123,6,nikos zisis,19,1,3,33.3,0,1,0,1,2,50,0,0,0,0,0,0,2,4,1,0,0,3
437413,497_15_07,GREECE,125,7,vassilis spanoulis,22,2,7,28.6,1,3,33.3,1,4,25,5,6,83.3,0,2,2,5,2,2,0,0,10
437414,497_15_07,GREECE,12472,8,nick calathes,26,3,5,60,2,4,50,1,1,100,0,2,0,2,2,4,8,2,2,1,0,7
437415,497_15_07,GREECE,1057,9,stratos perperoglou,5,0,1,0,0,1,0,0,0,0,0,0,0,0,0,0,0,0,0,0,0,0
437416,497_15_07,GREECE,8304,10,kostas sloukas,13,4,4,100,3,3,100,1,1,100,0,0,0,0,0,0,3,2,0,0,0,9
437417,497_15_07,GREECE,15374,12,kostas kaimakoglou,4,0,0,0,0,0,0,0,0,0,2,2,100,0,0,0,0,2,0,0,0,2
437418,497_15_07,GREECE,10607,13,kostas koufos,24,5,11,45.5,5,11,45.5,0,0,0,1,2,50,5,6,11,1,1,1,1,0,11
437419,497_15_07,GREECE,1056,15,georgios printezis,26,8,9,88.9,7,8,87.5,1,1,100,1,1,100,0,2,2,2,1,0,0,0,18
437420,497_15_07,GREECE,10606,16,kostas papanikolaou,15,0,1,0,0,0,0,0,1,0,0,0,0,0,1,1,1,0,1,0,0,0
437421,497_15_07,GREECE,8303,17,evangelos mantzaris,3,0,0,0,0,0,0,0,0,0,0,0,0,0,0,0,0,0,0,0,0,0
437422,497_15_07,GREECE,24314,34,giannis antetokounmpo,27,4,9,44.4,4,7,57.1,0,2,0,1,2,50,1,1,2,1,3,2,0,2,9
437423,497_15_07,GREECE,0,TOTALS,GREECE,200,32,58,55.2,27,46,58.7,5,12,41.7,16,22,72.7,11,28,39,23,20,12,2,2,85
437424,497_15_08,BELGIUM,10156,4,lionel bosco,0,0,0,0,0,0,0,0,0,0,0,0,0,0,0,0,0,0,0,0,0,0
437425,497_15_08,BELGIUM,2003,5,sam van rossom,31,4,14,28.6,2,8,25,2,6,33.3,2,2,100,0,2,2,4,2,2,1,0,12
437426,497_15_08,BELGIUM,4548,7,axel hervelle,31,5,9,55.6,4,7,57.1,1,2,50,2,2,100,0,6,6,7,4,3,1,0,13
437427,497_15_08,BELGIUM,6157,8,jean marc mwema,8,0,1,0,0,0,0,0,1,0,0,0,0,1,3,4,0,2,0,0,0,0
437428,497_15_08,BELGIUM,5599,9,jonathan tabu,21,3,10,30,3,9,33.3,0,1,0,2,2,100,0,1,1,3,2,4,1,0,8
437429,497_15_08,BELGIUM,8359,10,quentin serron,13,2,2,100,2,2,100,0,0,0,0,0,0,1,1,2,0,1,1,0,0,4
437430,497_15_08,BELGIUM,24196,12,wen mukubu,3,0,0,0,0,0,0,0,0,0,0,0,0,0,0,0,1,1,0,0,0,0
437431,497_15_08,BELGIUM,11181,13,pierre-antoine gillet,26,2,5,40,0,0,0,2,5,40,0,0,0,1,3,4,1,2,0,0,0,6
437432,497_15_08,BELGIUM,10498,14,maxime de zeeuw,15,4,9,44.4,3,6,50,1,3,33.3,2,2,100,3,3,6,0,2,2,1,0,11
437433,497_15_08,BELGIUM,19894,22,kevin tumba,7,1,1,100,1,1,100,0,0,0,0,0,0,0,1,1,1,2,0,1,0,2
437434,497_15_08,BELGIUM,15488,23,jean salumu,15,0,0,0,0,0,0,0,0,0,0,0,0,1,0,1,0,3,2,0,0,0
437435,497_15_08,BELGIUM,29508,24,matt lojeski,30,5,10,50,5,9,55.6,0,1,0,1,4,25,0,2,2,2,3,1,2,1,11
437436,497_15_08,BELGIUM,0,TOTALS,BELGIUM,200,26,61,42.6,20,42,47.6,6,19,31.6,9,12,75,11,23,34,19,24,16,7,1,67
437437,497_15_08,LATVIA,19755,5,mareks mejeris,21,1,2,50,1,2,50,0,0,0,1,2,50,0,1,1,1,3,1,0,3,3
437438,497_15_08,LATVIA,2539,6,rolands freimanis,24,2,7,28.6,1,3,33.3,1,4,25,3,4,75,3,2,5,4,1,0,1,1,8
437439,497_15_08,LATVIA,5029,7,janis blums,13,0,2,0,0,0,0,0,2,0,4,4,100,0,2,2,0,2,2,0,0,4
437440,497_15_08,LATVIA,6271,9,dairis bertans,31,4,10,40,1,3,33.3,3,7,42.9,2,2,100,0,3,3,4,3,3,0,0,13
437441,497_15_08,LATVIA,12927,10,janis timma,19,2,5,40,1,2,50,1,3,33.3,0,0,0,2,3,5,3,5,0,0,0,5
437442,497_15_08,LATVIA,4604,12,kristaps janicenoks,25,5,9,55.6,2,5,40,3,4,75,1,1,100,0,4,4,2,1,1,1,0,14
437443,497_15_08,LATVIA,10585,13,janis strelnieks,29,1,4,25,1,2,50,0,2,0,2,2,100,0,4,4,7,1,1,1,0,4
437444,497_15_08,LATVIA,1002,14,kaspars berzins,17,4,6,66.7,4,6,66.7,0,0,0,4,6,66.7,1,1,2,0,5,2,1,1,12
437445,497_15_08,LATVIA,12931,19,kaspars vecvagars,0,0,0,0,0,0,0,0,0,0,0,0,0,0,0,0,0,0,0,0,0,0
437446,497_15_08,LATVIA,11058,23,haralds karlis,0,0,0,0,0,0,0,0,0,0,0,0,0,0,0,0,0,0,0,0,0,0
437447,497_15_08,LATVIA,29509,31,zanis peiners,7,0,1,0,0,1,0,0,0,0,0,0,0,0,0,0,1,2,1,0,0,0
437448,497_15_08,LATVIA,15602,33,martins meiers,14,6,7,85.7,6,7,85.7,0,0,0,3,3,100,0,3,3,0,0,3,1,1,15
437449,497_15_08,LATVIA,0,TOTALS,LATVIA,200,25,53,47.2,17,31,54.8,8,22,36.4,20,24,83.3,7,26,33,22,23,15,5,6,78
437450,497_15_09,FRANCE,11077,4,leo j. p. westermann,2,0,0,0,0,0,0,0,0,0,0,0,0,0,0,0,1,0,0,0,0,0
437451,497_15_09,FRANCE,2588,5,nicolas batum,29,6,12,50,6,7,85.7,0,5,0,4,5,80,1,4,5,1,3,1,1,1,16
437452,497_15_09,FRANCE,11076,7,joffrey lauvergne,25,5,7,71.4,5,7,71.4,0,0,0,3,3,100,3,4,7,1,1,4,0,0,13
437453,497_15_09,FRANCE,1864,8,charles kahudi,6,1,1,100,1,1,100,0,0,0,0,0,0,1,0,1,0,1,0,0,1,2
437454,497_15_09,FRANCE,5047,9,tony parker,35,9,21,42.9,8,15,53.3,1,6,16.7,4,4,100,1,4,5,3,3,3,1,0,23
437455,497_15_09,FRANCE,12971,10,evan fournier,17,3,7,42.9,1,4,25,2,3,66.7,0,0,0,0,3,3,2,2,1,1,0,8
437456,497_15_09,FRANCE,4663,11,florent pietrus,14,0,1,0,0,0,0,0,1,0,0,0,0,0,0,0,0,2,1,1,0,0
437457,497_15_09,FRANCE,10428,12,nando de colo,32,5,9,55.6,3,4,75,2,5,40,4,5,80,0,7,7,6,2,2,2,0,16
437458,497_15_09,FRANCE,4665,13,boris diaw,31,4,5,80,4,5,80,0,0,0,0,1,0,0,3,3,4,1,2,0,1,8
437459,497_15_09,FRANCE,5044,15,mickael gelabale,15,0,1,0,0,1,0,0,0,0,0,0,0,0,1,1,2,1,1,0,0,0
437460,497_15_09,FRANCE,17374,16,rudy gobert,20,4,4,100,4,4,100,0,0,0,3,5,60,4,1,5,1,0,1,0,2,11
437461,497_15_09,FRANCE,17677,19,mouhammadou jaiteh,0,0,0,0,0,0,0,0,0,0,0,0,0,0,0,0,0,0,0,0,0,0
437462,497_15_09,FRANCE,0,TOTALS,FRANCE,225,37,68,54.4,32,48,66.7,5,20,25,18,23,78.3,13,30,43,21,16,17,6,5,97
437463,497_15_09,FINLAND,1834,4,mikko koivisto,10,1,1,100,1,1,100,0,0,0,0,0,0,1,0,1,0,1,0,0,0,2
437464,497_15_09,FINLAND,1314,7,shawn huff,31,3,10,30,2,3,66.7,1,7,14.3,0,0,0,2,0,2,1,3,1,1,0,7
437465,497_15_09,FINLAND,1836,8,gerald lee,26,5,6,83.3,5,6,83.3,0,0,0,0,2,0,4,3,7,1,1,2,0,0,10
437466,497_15_09,FINLAND,11129,9,sasu salin,26,5,13,38.5,2,6,33.3,3,7,42.9,1,2,50,0,2,2,2,3,0,2,1,14
437467,497_15_09,FINLAND,4932,10,tuukka kotti,23,1,5,20,1,5,20,0,0,0,0,0,0,0,0,0,0,3,1,1,0,2
437468,497_15_09,FINLAND,2802,11,petteri koponen,29,7,15,46.7,6,10,60,1,5,20,0,0,0,0,2,2,7,3,3,1,0,15
437469,497_15_09,FINLAND,8436,12,matti nuutinen,12,2,5,40,2,4,50,0,1,0,2,2,100,2,0,2,0,3,0,0,0,6
437470,497_15_09,FINLAND,24222,21,ville kaunisto,6,0,1,0,0,0,0,0,1,0,0,0,0,0,0,0,0,1,0,1,0,0
437471,497_15_09,FINLAND,29510,24,joonas caven,4,1,2,50,0,0,0,1,2,50,0,0,0,1,0,1,0,0,0,0,1,3
437472,497_15_09,FINLAND,8428,30,roope ahonen,5,0,1,0,0,0,0,0,1,0,0,0,0,0,0,0,0,0,0,0,0,0
437473,497_15_09,FINLAND,29511,31,jamar wilson,19,9,13,69.2,8,11,72.7,1,2,50,2,2,100,0,1,1,4,2,2,2,1,21
437474,497_15_09,FINLAND,25454,33,erik jay murphy,34,3,6,50,2,4,50,1,2,50,0,0,0,2,9,11,1,2,0,2,2,7
437475,497_15_09,FINLAND,0,TOTALS,FINLAND,225,37,78,47.4,29,50,58,8,28,28.6,5,8,62.5,13,19,32,16,22,10,10,5,87
437476,497_15_10,ITALY,20021,0,amedeo della valle,0,0,0,0,0,0,0,0,0,0,0,0,0,0,0,0,0,0,0,0,0,0
437477,497_15_10,ITALY,1272,3,marco belinelli,30,4,11,36.4,2,3,66.7,2,8,25,4,4,100,0,3,3,4,1,2,0,0,14
437478,497_15_10,ITALY,7944,4,pietro aradori,6,0,0,0,0,0,0,0,0,0,0,0,0,0,1,1,3,0,0,0,0,0
437479,497_15_10,ITALY,12988,5,alessandro gentile,35,5,12,41.7,4,9,44.4,1,3,33.3,1,2,50,1,4,5,5,3,4,1,0,12
437480,497_15_10,ITALY,2667,8,danilo gallinari,35,9,10,90,8,8,100,1,2,50,14,15,93.3,4,1,5,2,4,2,0,0,33
437481,497_15_10,ITALY,1270,9,andrea bargnani,22,5,8,62.5,3,6,50,2,2,100,0,0,0,2,2,4,0,1,2,0,0,12
437482,497_15_10,ITALY,15319,12,marco cusin,5,1,1,100,1,1,100,0,0,0,0,0,0,0,1,1,1,2,0,0,0,2
437483,497_15_10,ITALY,1861,13,luigi datome,22,3,5,60,2,3,66.7,1,2,50,0,0,0,0,5,5,0,4,1,0,0,7
437484,497_15_10,ITALY,10968,17,nicolo melli,7,1,2,50,1,1,100,0,1,0,0,0,0,0,0,0,0,2,0,0,0,2
437485,497_15_10,ITALY,19752,20,andrea cinciarini,9,0,0,0,0,0,0,0,0,0,0,0,0,0,0,0,0,3,0,0,0,0
437486,497_15_10,ITALY,10444,23,daniel hackett,29,2,5,40,1,3,33.3,1,2,50,0,0,0,0,1,1,4,5,3,1,0,5
437487,497_15_10,ITALY,15644,33,achille polonara,0,0,0,0,0,0,0,0,0,0,0,0,0,0,0,0,0,0,0,0,0,0
437488,497_15_10,ITALY,0,TOTALS,ITALY,200,30,54,55.6,22,34,64.7,8,20,40,19,21,90.5,9,22,31,19,25,14,2,0,87
437489,497_15_10,TURKEY,20222,4,kartal ozmizrak,0,0,0,0,0,0,0,0,0,0,0,0,0,0,0,0,0,0,0,0,0,0
437490,497_15_10,TURKEY,15304,5,sinan guler,34,4,10,40,4,6,66.7,0,4,0,1,2,50,1,3,4,9,2,1,2,0,9
437491,497_15_10,TURKEY,20219,6,cedi osman,34,5,11,45.5,3,8,37.5,2,3,66.7,0,0,0,1,0,1,1,4,0,2,0,12
437492,497_15_10,TURKEY,2576,7,baris hersek,0,0,0,0,0,0,0,0,0,0,0,0,0,0,0,0,0,0,0,0,0,0
437493,497_15_10,TURKEY,1802,8,ersan ilyasova,21,5,7,71.4,3,5,60,2,2,100,5,5,100,0,2,2,1,4,2,1,0,17
437494,497_15_10,TURKEY,1797,9,semih erden,26,8,12,66.7,8,12,66.7,0,0,0,6,12,50,5,3,8,0,3,0,1,0,22
437495,497_15_10,TURKEY,8151,10,melih mahmutoglu,24,3,8,37.5,1,2,50,2,6,33.3,0,0,0,2,2,4,0,1,2,0,0,8
437496,497_15_10,TURKEY,1796,11,oguz savas,0,0,0,0,0,0,0,0,0,0,0,0,0,0,0,0,0,0,0,0,0,0
437497,497_15_10,TURKEY,24656,12,furkan korkmaz,0,0,0,0,0,0,0,0,0,0,0,0,0,0,0,0,0,0,0,0,0,0
437498,497_15_10,TURKEY,29512,13,ali muhammed,36,4,20,20,2,15,13.3,2,5,40,7,8,87.5,1,2,3,9,4,2,1,0,17
437499,497_15_10,TURKEY,17253,14,huseyin koksal,13,0,2,0,0,2,0,0,0,0,0,0,0,4,1,5,0,0,0,1,0,0
437500,497_15_10,TURKEY,10942,15,furkan aldemir,12,2,2,100,2,2,100,0,0,0,0,0,0,3,1,4,0,2,0,0,1,4
437501,497_15_10,TURKEY,0,TOTALS,TURKEY,200,31,72,43.1,23,52,44.2,8,20,40,19,27,70.4,21,15,36,20,20,8,8,1,89
437502,497_15_11,CROATIA,1844,4,ante tomic,11,2,6,33.3,2,6,33.3,0,0,0,1,2,50,2,2,4,0,3,2,0,0,5
437503,497_15_11,CROATIA,1846,5,damjan rudez,11,1,1,100,0,0,0,1,1,100,0,0,0,0,0,0,3,4,1,1,0,3
437504,497_15_11,CROATIA,1915,6,rok stipcevic,19,0,2,0,0,0,0,0,2,0,3,4,75,0,2,2,1,2,0,0,0,3
437505,497_15_11,CROATIA,6280,7,bojan bogdanovic,22,2,5,40,2,3,66.7,0,2,0,5,7,71.4,1,1,2,0,2,3,0,0,9
437506,497_15_11,CROATIA,15894,8,dario saric,32,3,7,42.9,2,5,40,1,2,50,1,4,25,1,6,7,2,2,4,0,0,8
437507,497_15_11,CROATIA,1251,9,marko tomas,0,0,0,0,0,0,0,0,0,0,0,0,0,0,0,0,0,0,0,0,0,0
437508,497_15_11,CROATIA,4585,10,roko ukic,20,1,3,33.3,1,3,33.3,0,0,0,0,0,0,0,2,2,4,1,1,0,0,2
437509,497_15_11,CROATIA,1249,11,krunoslav simon,29,6,11,54.5,4,7,57.1,2,4,50,6,8,75,3,3,6,3,2,1,1,0,20
437510,497_15_11,CROATIA,18342,13,dontaye draper,5,0,0,0,0,0,0,0,0,0,0,0,0,0,2,2,0,1,1,0,0,0
437511,497_15_11,CROATIA,10624,15,miro bilan,4,0,0,0,0,0,0,0,0,0,0,0,0,0,1,1,0,1,1,1,0,0
437512,497_15_11,CROATIA,16607,21,luka zoric,23,5,8,62.5,5,8,62.5,0,0,0,7,8,87.5,2,2,4,0,3,2,0,4,17
437513,497_15_11,CROATIA,18415,23,mario hezonja,24,5,9,55.6,3,4,75,2,5,40,1,2,50,2,4,6,1,2,3,1,0,13
437514,497_15_11,CROATIA,0,TOTALS,CROATIA,200,25,52,48.1,19,36,52.8,6,16,37.5,24,35,68.6,15,28,43,14,23,19,4,4,80
437515,497_15_11,SLOVENIA,4655,1,nebojsa joksimovic,13,1,2,50,0,0,0,1,2,50,0,0,0,0,0,0,1,2,0,0,0,3
437516,497_15_11,SLOVENIA,13125,5,luka rupnik,0,0,0,0,0,0,0,0,0,0,0,0,0,0,0,0,0,0,0,0,0,0
437517,497_15_11,SLOVENIA,17343,7,klemen prepelic,22,2,6,33.3,1,2,50,1,4,25,2,4,50,2,0,2,4,4,2,1,0,7
437518,497_15_11,SLOVENIA,15479,9,jaka blazic,25,4,13,30.8,3,9,33.3,1,4,25,2,2,100,1,5,6,1,2,1,1,0,11
437519,497_15_11,SLOVENIA,8251,10,mitja nikolic,19,2,2,100,1,1,100,1,1,100,0,0,0,0,1,1,1,3,1,0,0,5
437520,497_15_11,SLOVENIA,6197,12,zoran dragic,30,5,12,41.7,2,5,40,3,7,42.9,1,3,33.3,1,3,4,3,2,3,1,0,14
437521,497_15_11,SLOVENIA,4764,13,miha zupan,13,3,4,75,1,1,100,2,3,66.7,2,2,100,0,3,3,2,4,0,0,0,10
437522,497_15_11,SLOVENIA,24203,15,jure balazic,21,1,8,12.5,0,3,0,1,5,20,1,2,50,1,0,1,0,4,0,0,0,4
437523,497_15_11,SLOVENIA,1069,17,sasa zagorac,0,0,0,0,0,0,0,0,0,0,0,0,0,0,0,0,0,0,0,0,0,0
437524,497_15_11,SLOVENIA,17344,23,alen omic,13,5,6,83.3,5,6,83.3,0,0,0,0,0,0,1,2,3,1,2,1,0,0,10
437525,497_15_11,SLOVENIA,5782,24,jaka klobucar,18,1,2,50,1,2,50,0,0,0,1,1,100,0,1,1,4,2,2,1,0,3
437526,497_15_11,SLOVENIA,5023,55,uros slokar,27,2,8,25,2,6,33.3,0,2,0,2,4,50,0,1,1,3,4,1,1,1,6
437527,497_15_11,SLOVENIA,0,TOTALS,SLOVENIA,200,26,63,41.3,16,35,45.7,10,28,35.7,11,18,61.1,9,16,25,20,29,13,5,1,73
437528,497_15_12,LITHUANIA,1726,5,mantas kalnietis,29,1,9,11.1,0,6,0,1,3,33.3,0,0,0,0,5,5,7,2,4,0,1,3
437529,497_15_12,LITHUANIA,8963,6,deividas gailius,0,0,0,0,0,0,0,0,0,0,0,0,0,0,0,0,0,0,0,0,0,0
437530,497_15_12,LITHUANIA,980,8,jonas maciulis,31,4,8,50,3,7,42.9,1,1,100,2,2,100,0,3,3,0,1,0,3,0,11
437531,497_15_12,LITHUANIA,3474,10,renaldas seibutis,28,3,8,37.5,3,7,42.9,0,1,0,2,2,100,0,3,3,3,2,2,0,0,8
437532,497_15_12,LITHUANIA,22216,11,domantas sabonis,4,0,1,0,0,1,0,0,0,0,0,0,0,2,0,2,0,1,0,0,0,0
437533,497_15_12,LITHUANIA,3476,12,antanas kavaliauskas,0,0,0,0,0,0,0,0,0,0,0,0,0,0,0,0,0,0,0,0,0,0
437534,497_15_12,LITHUANIA,987,13,paulius jankunas,30,5,11,45.5,2,7,28.6,3,4,75,9,10,90,0,5,5,0,0,0,1,0,22
437535,497_15_12,LITHUANIA,24,15,robertas javtokas,13,1,1,100,1,1,100,0,0,0,0,2,0,2,0,2,3,3,1,0,0,2
437536,497_15_12,LITHUANIA,10916,17,jonas valanciunas,28,7,16,43.8,7,16,43.8,0,0,0,5,5,100,6,5,11,1,3,1,0,1,19
437537,497_15_12,LITHUANIA,10639,19,mindaugas kuzminskas,12,0,3,0,0,3,0,0,0,0,1,2,50,2,0,2,1,0,0,1,0,1
437538,497_15_12,LITHUANIA,29513,21,arturas milaknis,14,0,3,0,0,0,0,0,3,0,0,0,0,0,0,0,0,1,0,1,0,0
437539,497_15_12,LITHUANIA,17685,43,lukas lekavicius,11,1,4,25,1,3,33.3,0,1,0,1,2,50,0,1,1,2,1,0,2,0,3
437540,497_15_12,LITHUANIA,0,TOTALS,LITHUANIA,200,22,64,34.4,17,51,33.3,5,13,38.5,20,25,80,16,23,39,17,14,11,8,2,69
437541,497_15_12,UKRAINE,5790,4,maksym pustozvonov,31,2,8,25,2,6,33.3,0,2,0,1,2,50,0,2,2,4,3,0,1,1,5
437542,497_15_12,UKRAINE,29514,5,dzherom dzherri rendl,33,6,12,50,6,11,54.5,0,1,0,0,0,0,0,1,1,6,2,4,2,0,12
437543,497_15_12,UKRAINE,12946,6,olexandr mishula,24,5,7,71.4,2,2,100,3,5,60,0,0,0,0,1,1,2,0,2,1,0,13
437544,497_15_12,UKRAINE,2768,7,denys lukashov,11,1,3,33.3,1,1,100,0,2,0,0,0,0,1,1,2,2,1,0,0,0,2
437545,497_15_12,UKRAINE,2093,8,kyrylo fesenko,26,9,13,69.2,9,13,69.2,0,0,0,1,1,100,3,8,11,1,5,1,0,2,19
437546,497_15_12,UKRAINE,7927,9,oleksandr sizov,9,0,2,0,0,2,0,0,0,0,0,0,0,0,0,0,0,2,1,0,0,0
437547,497_15_12,UKRAINE,10714,10,stanislav tymofeyenko,6,1,1,100,1,1,100,0,0,0,0,0,0,0,0,0,0,1,1,0,0,2
437548,497_15_12,UKRAINE,10926,11,oleksandr lypovyy,12,0,4,0,0,3,0,0,1,0,0,0,0,0,1,1,1,3,1,1,0,0
437549,497_15_12,UKRAINE,5791,12,maxym korniyenko,22,4,7,57.1,4,6,66.7,0,1,0,0,0,0,1,4,5,2,2,0,0,0,8
437550,497_15_12,UKRAINE,10713,13,ihor zaytsev,24,3,5,60,2,2,100,1,3,33.3,0,0,0,0,5,5,0,4,4,1,0,7
437551,497_15_12,UKRAINE,19863,14,artem pustovyi,2,0,0,0,0,0,0,0,0,0,0,0,0,0,0,0,0,0,0,1,0,0
437552,497_15_12,UKRAINE,12945,15,pavlo krutous,0,0,0,0,0,0,0,0,0,0,0,0,0,0,0,0,0,0,0,0,0,0
437553,497_15_12,UKRAINE,0,TOTALS,UKRAINE,200,31,62,50,27,47,57.4,4,15,26.7,2,3,66.7,7,26,33,18,23,14,7,3,68
437554,497_15_13,RUSSIA,19857,1,andrey zubkov,28,8,11,72.7,8,10,80,0,1,0,5,6,83.3,5,2,7,2,4,2,1,0,21
437555,497_15_13,RUSSIA,29505,4,evgenii baburin,0,0,0,0,0,0,0,0,0,0,0,0,0,0,0,0,0,0,0,0,0,0
437556,497_15_13,RUSSIA,8296,5,ruslan pateev,5,1,2,50,1,2,50,0,0,0,0,0,0,0,0,0,0,1,2,0,0,2
437557,497_15_13,RUSSIA,1078,7,vitaly fridzon,18,2,5,40,0,2,0,2,3,66.7,2,2,100,0,0,0,1,3,2,0,0,8
437558,497_15_13,RUSSIA,1083,9,egor vyaltsev,22,3,7,42.9,2,5,40,1,2,50,0,0,0,0,3,3,1,3,1,1,0,7
437559,497_15_13,RUSSIA,10610,11,semen antonov,12,1,7,14.3,1,3,33.3,0,4,0,0,0,0,3,3,6,1,2,1,0,0,2
437560,497_15_13,RUSSIA,5064,12,sergey monya,28,3,8,37.5,2,4,50,1,4,25,1,2,50,2,3,5,4,2,1,1,0,8
437561,497_15_13,RUSSIA,2554,13,dmitry khvostov,29,4,8,50,1,4,25,3,4,75,0,2,0,1,2,3,5,4,1,0,0,11
437562,497_15_13,RUSSIA,1808,14,anton ponkrashov,13,0,3,0,0,2,0,0,1,0,1,2,50,0,1,1,4,3,1,0,0,1
437563,497_15_13,RUSSIA,7770,20,andrey vorontsevich,30,2,7,28.6,0,2,0,2,5,40,6,6,100,1,5,6,1,1,0,0,1,12
437564,497_15_13,RUSSIA,21941,32,andrei desiatnikov,0,0,0,0,0,0,0,0,0,0,0,0,0,0,0,0,0,0,0,0,0,0
437565,497_15_13,RUSSIA,1809,41,nikita kurbanov,15,2,6,33.3,2,5,40,0,1,0,3,4,75,1,1,2,1,2,1,1,0,7
437566,497_15_13,RUSSIA,0,TOTALS,RUSSIA,200,26,64,40.6,17,39,43.6,9,25,36,18,24,75,17,24,41,20,25,12,4,1,79
437567,497_15_13,POLAND,15535,0,aleksander czyz,1,0,0,0,0,0,0,0,0,0,0,0,0,0,0,0,0,0,0,0,0,0
437568,497_15_13,POLAND,5694,5,aaron cel,26,1,5,20,1,2,50,0,3,0,2,2,100,1,4,5,1,2,0,0,0,4
437569,497_15_13,POLAND,29496,6,aj slaughter,26,3,8,37.5,3,7,42.9,0,1,0,1,2,50,0,2,2,5,3,2,1,0,7
437570,497_15_13,POLAND,7833,7,damian kulig,13,0,4,0,0,2,0,0,2,0,1,2,50,0,2,2,0,2,1,0,0,1
437571,497_15_13,POLAND,15981,9,mateusz ponitka,27,4,6,66.7,4,5,80,0,1,0,2,2,100,0,3,3,4,3,1,0,0,10
437572,497_15_13,POLAND,8034,12,adam waczynski,29,6,8,75,2,3,66.7,4,5,80,7,10,70,0,1,1,1,1,2,1,0,23
437573,497_15_13,POLAND,1215,13,marcin gortat,30,6,11,54.5,6,11,54.5,0,0,0,6,7,85.7,1,5,6,3,4,0,0,1,18
437574,497_15_13,POLAND,1207,15,lukasz koszarek,15,2,5,40,1,2,50,1,3,33.3,0,0,0,0,2,2,3,1,1,0,0,5
437575,497_15_13,POLAND,24194,17,przemyslaw zamojski,12,1,3,33.3,0,0,0,1,3,33.3,0,0,0,1,1,2,2,2,0,0,0,3
437576,497_15_13,POLAND,12920,24,przemyslaw karnowski,10,4,6,66.7,4,6,66.7,0,0,0,0,0,0,2,0,2,1,1,0,1,0,8
437577,497_15_13,POLAND,6186,33,karol gruszecki,11,1,2,50,0,0,0,1,2,50,0,0,0,0,2,2,0,2,1,0,0,3
437578,497_15_13,POLAND,4799,66,robert skibniewski,0,0,0,0,0,0,0,0,0,0,0,0,0,0,0,0,0,0,0,0,0,0
437579,497_15_13,POLAND,0,TOTALS,POLAND,200,28,58,48.3,21,38,55.3,7,20,35,19,25,76,8,23,31,20,21,8,3,1,82
437580,497_15_14,SERBIA,5751,4,milos teodosic,33,3,13,23.1,3,4,75,0,9,0,2,2,100,0,3,3,4,1,3,0,0,8
437581,497_15_14,SERBIA,2100,5,marko simonovic,12,1,2,50,1,1,100,0,1,0,3,3,100,0,3,3,0,1,0,0,0,5
437582,497_15_14,SERBIA,29506,6,ognjen kuzmic,15,2,5,40,2,5,40,0,0,0,0,0,0,3,4,7,0,1,1,0,0,4
437583,497_15_14,SERBIA,17361,7,bogdan bogdanovic,24,3,9,33.3,2,2,100,1,7,14.3,2,2,100,1,2,3,4,1,0,0,1,9
437584,497_15_14,SERBIA,15386,8,nemanja bjelica,27,4,7,57.1,3,4,75,1,3,33.3,3,4,75,0,3,3,3,3,0,0,0,12
437585,497_15_14,SERBIA,2654,9,stefan markovic,22,1,4,25,1,1,100,0,3,0,0,0,0,0,0,0,3,5,1,2,0,2
437586,497_15_14,SERBIA,19860,10,nikola kalinic,10,3,4,75,3,3,100,0,1,0,0,1,0,2,1,3,0,3,0,0,0,6
437587,497_15_14,SERBIA,15503,11,nemanja nedovic,21,2,8,25,1,6,16.7,1,2,50,1,2,50,4,3,7,0,3,1,2,1,6
437588,497_15_14,SERBIA,15505,12,dragan milosavljevic,0,0,0,0,0,0,0,0,0,0,0,0,0,0,0,0,0,0,0,0,0,0
437589,497_15_14,SERBIA,2656,13,miroslav raduljica,17,3,8,37.5,3,8,37.5,0,0,0,1,2,50,2,2,4,0,2,1,1,0,7
437590,497_15_14,SERBIA,10253,14,zoran erceg,18,2,5,40,1,1,100,1,4,25,4,7,57.1,0,3,3,0,2,0,1,0,9
437591,497_15_14,SERBIA,17652,15,nikola milutinov,3,0,0,0,0,0,0,0,0,0,0,0,0,0,0,0,0,0,0,0,0,0
437592,497_15_14,SERBIA,0,TOTALS,SERBIA,200,24,65,36.9,20,35,57.1,4,30,13.3,16,23,69.6,14,26,40,14,22,7,6,2,68
437593,497_15_14,GERMANY,29499,4,maodo lo,11,0,2,0,0,1,0,0,1,0,0,0,0,0,1,1,4,0,0,0,0,0
437594,497_15_14,GERMANY,8235,5,niels giffey,7,1,1,100,0,0,0,1,1,100,0,0,0,0,0,0,0,1,1,0,0,3
437595,497_15_14,GERMANY,1192,7,alex king,10,0,2,0,0,0,0,0,2,0,0,0,0,0,0,0,0,2,0,1,0,0
437596,497_15_14,GERMANY,15385,8,heiko schaffartzik,23,4,8,50,1,1,100,3,7,42.9,0,0,0,1,0,1,1,3,2,1,0,11
437597,497_15_14,GERMANY,10446,9,karsten tadda,0,0,0,0,0,0,0,0,0,0,0,0,0,0,0,0,0,0,0,0,0,0
437598,497_15_14,GERMANY,10637,11,tibor pleiss,23,5,6,83.3,5,6,83.3,0,0,0,5,5,100,3,4,7,0,3,0,0,2,15
437599,497_15_14,GERMANY,6326,12,robin benzing,0,0,0,0,0,0,0,0,0,0,0,0,0,0,0,0,0,0,0,0,0,0
437600,497_15_14,GERMANY,4711,14,dirk nowitzki,31,5,15,33.3,3,11,27.3,2,4,50,3,4,75,1,9,10,3,1,1,0,0,15
437601,497_15_14,GERMANY,19990,17,dennis schroder,29,4,11,36.4,4,9,44.4,0,2,0,3,4,75,0,2,2,6,3,4,1,0,11
437602,497_15_14,GERMANY,29500,21,paul zipser,28,1,4,25,1,2,50,0,2,0,0,0,0,0,6,6,5,3,1,0,0,2
437603,497_15_14,GERMANY,1152,25,anton gavel,23,1,4,25,0,0,0,1,4,25,1,2,50,0,4,4,1,2,0,0,0,4
437604,497_15_14,GERMANY,19867,77,johannes voigtmann,15,2,4,50,1,2,50,1,2,50,0,0,0,0,2,2,0,4,0,0,0,5
437605,497_15_14,GERMANY,0,TOTALS,GERMANY,200,23,57,40.4,15,32,46.9,8,25,32,12,15,80,6,30,36,20,22,11,3,2,66
437606,497_15_15,NETHERLANDS,20407,0,yannick franke,0,0,0,0,0,0,0,0,0,0,0,0,0,0,0,0,0,0,0,0,0,0
437607,497_15_15,NETHERLANDS,15661,5,leon williams,14,0,3,0,0,2,0,0,1,0,1,2,50,0,1,1,3,1,0,0,0,1
437608,497_15_15,NETHERLANDS,24213,6,worthy de jong,20,1,6,16.7,1,5,20,0,1,0,0,0,0,2,4,6,1,4,2,0,0,2
437609,497_15_15,NETHERLANDS,15520,7,charlon kloof,27,3,10,30,2,8,25,1,2,50,2,6,33.3,2,3,5,3,0,4,0,1,9
437610,497_15_15,NETHERLANDS,10671,9,mohamed kherrazi,16,0,0,0,0,0,0,0,0,0,0,0,0,0,1,1,1,1,1,1,0,0
437611,497_15_15,NETHERLANDS,12501,10,ralf de pagter,0,0,0,0,0,0,0,0,0,0,0,0,0,0,0,0,0,0,0,0,0,0
437612,497_15_15,NETHERLANDS,29501,12,kees akerboom,19,2,5,40,1,3,33.3,1,2,50,1,2,50,0,1,1,0,0,1,0,0,6
437613,497_15_15,NETHERLANDS,2871,13,roeland schaftenaar,21,3,7,42.9,3,4,75,0,3,0,0,0,0,2,2,4,0,2,1,0,0,6
437614,497_15_15,NETHERLANDS,7480,18,nicolas de jong,19,8,14,57.1,8,14,57.1,0,0,0,3,4,75,4,0,4,1,3,1,0,0,19
437615,497_15_15,NETHERLANDS,5809,21,robin smeulders,19,3,4,75,3,4,75,0,0,0,2,3,66.7,2,3,5,0,4,1,0,0,8
437616,497_15_15,NETHERLANDS,5810,23,henk norel,19,4,7,57.1,4,7,57.1,0,0,0,2,3,66.7,3,6,9,0,2,0,0,0,10
437617,497_15_15,NETHERLANDS,10202,44,arvin slagter,26,4,7,57.1,2,3,66.7,2,4,50,0,0,0,0,1,1,1,1,1,0,0,10
437618,497_15_15,NETHERLANDS,0,TOTALS,NETHERLANDS,200,28,63,44.4,24,50,48,4,13,30.8,11,20,55,17,25,42,10,18,12,1,1,71
437619,497_15_15,MKD,6306,4,vladimir brckov,0,0,0,0,0,0,0,0,0,0,0,0,0,0,0,0,0,0,0,0,0,0
437620,497_15_15,MKD,10169,5,vlado ilievski,27,5,7,71.4,2,3,66.7,3,4,75,1,3,33.3,1,0,1,7,2,0,1,0,14
437621,497_15_15,MKD,7810,6,darko sokolov,0,0,0,0,0,0,0,0,0,0,0,0,0,0,0,0,0,0,0,0,0,0
437622,497_15_15,MKD,2709,7,aleksandar kostoski,26,5,7,71.4,2,2,100,3,5,60,0,0,0,0,2,2,3,1,1,0,0,13
437623,497_15_15,MKD,5892,8,vojdan stojanovski,29,3,9,33.3,3,6,50,0,3,0,5,6,83.3,2,3,5,3,2,0,3,0,11
437624,497_15_15,MKD,5892,9,damjan stojanovski,10,1,3,33.3,0,1,0,1,2,50,1,2,50,0,0,0,1,2,0,0,0,4
437625,497_15_15,MKD,6300,10,marko simonovski,28,2,6,33.3,0,0,0,2,6,33.3,1,3,33.3,0,0,0,0,0,1,0,0,7
437626,497_15_15,MKD,20507,11,ljubomir mladenovski,0,0,0,0,0,0,0,0,0,0,0,0,0,0,0,0,0,0,0,0,0,0
437627,497_15_15,MKD,2714,12,bojan trajkovski,28,5,16,31.2,2,6,33.3,3,10,30,0,0,0,1,2,3,3,4,2,1,0,13
437628,497_15_15,MKD,11275,13,stojan gjuroski,9,0,1,0,0,1,0,0,0,0,0,0,0,0,1,1,1,3,0,0,0,0
437629,497_15_15,MKD,29507,14,richard hendrix,24,5,7,71.4,5,7,71.4,0,0,0,0,0,0,1,6,7,2,3,1,0,2,10
437630,497_15_15,MKD,5010,15,predrag samardziski,19,3,4,75,3,4,75,0,0,0,0,0,0,1,4,5,0,5,2,0,1,6
437631,497_15_15,MKD,0,TOTALS,MKD,200,29,60,48.3,17,30,56.7,12,30,40,8,14,57.1,8,21,29,20,22,7,5,3,78
437632,497_15_16,ESTONIA,11295,4,rain veideman,36,2,8,25,2,4,50,0,4,0,5,5,100,2,6,8,2,3,1,0,0,9
437633,497_15_16,ESTONIA,1218,5,tanel sokk,10,0,2,0,0,1,0,0,1,0,0,0,0,0,1,1,0,0,1,0,0,0
437634,497_15_16,ESTONIA,1219,6,gert dorbek,0,0,0,0,0,0,0,0,0,0,0,0,0,0,0,0,0,0,0,0,0,0
437635,497_15_16,ESTONIA,2721,7,sten sokk,29,2,8,25,1,3,33.3,1,5,20,3,4,75,1,0,1,4,4,2,2,0,8
437636,497_15_16,ESTONIA,4625,8,janar talts,16,1,4,25,1,2,50,0,2,0,2,2,100,0,4,4,0,2,1,1,1,4
437637,497_15_16,ESTONIA,4622,9,gregor arbet,27,3,9,33.3,1,3,33.3,2,6,33.3,0,0,0,0,0,0,2,5,1,0,1,8
437638,497_15_16,ESTONIA,6373,10,erik keedus,16,3,4,75,2,2,100,1,2,50,0,0,0,0,1,1,0,3,0,1,1,7
437639,497_15_16,ESTONIA,6377,11,siim-sander vene,24,6,16,37.5,6,12,50,0,4,0,0,0,0,2,1,3,0,3,0,0,0,12
437640,497_15_16,ESTONIA,15312,13,joosep toome,6,0,1,0,0,1,0,0,0,0,0,0,0,0,1,1,1,2,0,0,0,0
437641,497_15_16,ESTONIA,4771,14,kristjan kangur,19,1,4,25,1,3,33.3,0,1,0,0,0,0,0,1,1,0,1,2,0,0,2
437642,497_15_16,ESTONIA,1229,15,reinar hallik,3,0,2,0,0,0,0,0,2,0,1,2,50,0,1,1,0,2,2,0,0,1
437643,497_15_16,ESTONIA,8047,20,tanel kurbas,14,0,2,0,0,2,0,0,0,0,4,4,100,1,0,1,1,3,1,0,0,4
437644,497_15_16,ESTONIA,0,TOTALS,ESTONIA,200,18,60,30,14,33,42.4,4,27,14.8,15,17,88.2,9,21,30,10,28,12,4,3,55
437645,497_15_16,BELGIUM,10156,4,lionel bosco,7,0,1,0,0,0,0,0,1,0,0,0,0,0,3,3,1,0,2,0,0,0
437646,497_15_16,BELGIUM,2003,5,sam van rossom,24,4,5,80,1,2,50,3,3,100,3,3,100,0,4,4,2,3,1,0,0,14
437647,497_15_16,BELGIUM,4548,7,axel hervelle,19,3,5,60,3,4,75,0,1,0,1,2,50,1,5,6,2,1,1,1,0,7
437648,497_15_16,BELGIUM,6157,8,jean marc mwema,18,1,3,33.3,1,1,100,0,2,0,0,0,0,1,3,4,1,3,0,0,2,2
437649,497_15_16,BELGIUM,5599,9,jonathan tabu,20,1,5,20,0,1,0,1,4,25,6,6,100,0,1,1,4,2,2,1,0,9
437650,497_15_16,BELGIUM,8359,10,quentin serron,18,5,6,83.3,3,4,75,2,2,100,0,0,0,0,1,1,2,1,1,0,0,12
437651,497_15_16,BELGIUM,24196,12,wen mukubu,18,3,6,50,2,5,40,1,1,100,0,2,0,0,1,1,1,1,1,0,1,7
437652,497_15_16,BELGIUM,11181,13,pierre-antoine gillet,23,4,6,66.7,2,3,66.7,2,3,66.7,0,0,0,1,1,2,0,2,2,0,0,10
437653,497_15_16,BELGIUM,10498,14,maxime de zeeuw,6,2,4,50,2,3,66.7,0,1,0,0,0,0,0,2,2,0,1,0,0,0,4
437654,497_15_16,BELGIUM,19894,22,kevin tumba,14,1,2,50,1,2,50,0,0,0,0,2,0,1,3,4,0,4,2,0,1,2
437655,497_15_16,BELGIUM,15488,23,jean salumu,14,0,2,0,0,1,0,0,1,0,1,4,25,0,0,0,0,4,1,0,0,1
437656,497_15_16,BELGIUM,29508,24,matt lojeski,19,4,7,57.1,2,4,50,2,3,66.7,6,7,85.7,2,4,6,3,1,0,0,0,16
437657,497_15_16,BELGIUM,0,TOTALS,BELGIUM,200,28,52,53.8,17,30,56.7,11,22,50,17,26,65.4,8,30,38,16,23,13,2,4,84
437658,497_15_17,FINLAND,1834,4,mikko koivisto,9,0,4,0,0,0,0,0,4,0,2,2,100,0,0,0,1,1,1,0,0,2
437659,497_15_17,FINLAND,1314,7,shawn huff,27,1,7,14.3,0,2,0,1,5,20,2,3,66.7,2,3,5,3,3,0,0,0,5
437660,497_15_17,FINLAND,1836,8,gerald lee,21,2,6,33.3,2,6,33.3,0,0,0,1,2,50,2,3,5,0,2,2,0,0,5
437661,497_15_17,FINLAND,11129,9,sasu salin,20,4,8,50,1,3,33.3,3,5,60,2,2,100,0,2,2,3,4,0,0,0,13
437662,497_15_17,FINLAND,4932,10,tuukka kotti,20,0,1,0,0,1,0,0,0,0,0,4,0,2,4,6,2,2,1,1,1,0
437663,497_15_17,FINLAND,2802,11,petteri koponen,31,1,10,10,0,3,0,1,7,14.3,0,0,0,0,2,2,5,2,1,0,0,3
437664,497_15_17,FINLAND,8436,12,matti nuutinen,18,3,7,42.9,1,1,100,2,6,33.3,0,0,0,0,3,3,0,2,1,1,0,8
437665,497_15_17,FINLAND,24222,21,ville kaunisto,3,0,1,0,0,1,0,0,0,0,0,0,0,0,0,0,0,0,0,0,0,0
437666,497_15_17,FINLAND,29510,24,joonas caven,0,0,0,0,0,0,0,0,0,0,0,0,0,0,0,0,0,0,0,0,0,0
437667,497_15_17,FINLAND,8428,30,roope ahonen,3,0,2,0,0,1,0,0,1,0,0,0,0,0,0,0,0,0,0,0,0,0
437668,497_15_17,FINLAND,29511,31,jamar wilson,17,3,9,33.3,3,8,37.5,0,1,0,0,1,0,1,2,3,2,2,1,0,0,6
437669,497_15_17,FINLAND,25454,33,erik jay murphy,31,10,15,66.7,7,10,70,3,5,60,1,2,50,4,5,9,0,3,1,0,3,24
437670,497_15_17,FINLAND,0,TOTALS,FINLAND,200,24,70,34.3,14,36,38.9,10,34,29.4,8,16,50,11,24,35,16,21,8,2,4,66
437671,497_15_17,ISRAEL,24229,5,dagan yivzori,14,2,6,33.3,1,3,33.3,1,3,33.3,1,2,50,0,0,0,0,3,0,0,0,6
437672,497_15_17,ISRAEL,21841,6,shawn dawson,9,0,0,0,0,0,0,0,0,0,0,2,0,0,0,0,1,2,0,0,0,0
437673,497_15_17,ISRAEL,2522,7,gal mekel,29,5,10,50,5,9,55.6,0,1,0,4,4,100,0,2,2,5,2,0,0,1,14
437674,497_15_17,ISRAEL,1023,8,lior eliyahu,30,11,20,55,11,20,55,0,0,0,0,2,0,2,3,5,6,1,3,0,0,22
437675,497_15_17,ISRAEL,1933,9,omri casspi,36,3,9,33.3,3,7,42.9,0,2,0,4,6,66.7,0,8,8,4,2,4,1,0,10
437676,497_15_17,ISRAEL,1022,10,raviv limonad,16,2,4,50,2,4,50,0,0,0,1,2,50,0,1,1,1,5,1,0,0,5
437677,497_15_17,ISRAEL,5780,11,elishay kadir,11,1,2,50,1,2,50,0,0,0,0,0,0,0,4,4,1,3,0,0,0,2
437678,497_15_17,ISRAEL,1685,12,yogev ohayon,24,4,5,80,2,3,66.7,2,2,100,3,3,100,0,5,5,2,3,2,2,0,13
437679,497_15_17,ISRAEL,4620,14,yaniv green,0,0,0,0,0,0,0,0,0,0,0,0,0,0,0,0,0,0,0,0,0,0
437680,497_15_17,ISRAEL,29504,15,dor fischer,31,1,2,50,1,2,50,0,0,0,5,5,100,4,7,11,0,1,1,1,3,7
437681,497_15_17,ISRAEL,19712,16,boris rothbart,0,0,0,0,0,0,0,0,0,0,0,0,0,0,0,0,0,0,0,0,0,0
437682,497_15_17,ISRAEL,12887,23,bar timor,0,0,0,0,0,0,0,0,0,0,0,0,0,0,0,0,0,0,0,0,0,0
437683,497_15_17,ISRAEL,0,TOTALS,ISRAEL,200,29,58,50,26,50,52,3,8,37.5,18,26,69.2,7,35,42,20,22,12,4,4,79
437684,497_15_18,ICELAND,19926,3,martin hermannsson,15,1,2,50,1,1,100,0,1,0,2,2,100,1,2,3,0,3,0,0,0,4
437685,497_15_18,ICELAND,24208,4,axel karason,0,0,0,0,0,0,0,0,0,0,0,0,0,0,0,0,0,0,0,0,0,0
437686,497_15_18,ICELAND,15700,5,ragnar nathanaelsson,0,0,0,0,0,0,0,0,0,0,0,0,0,0,0,0,0,0,0,0,0,0
437687,497_15_18,ICELAND,4834,6,jakob sigurdarson,16,2,5,40,1,2,50,1,3,33.3,2,2,100,0,1,1,0,2,0,1,0,7
437688,497_15_18,ICELAND,4841,8,hlynur baeringsson,34,4,8,50,2,4,50,2,4,50,4,6,66.7,2,5,7,1,3,2,1,0,14
437689,497_15_18,ICELAND,4837,9,jon stefansson,35,4,16,25,3,10,30,1,6,16.7,2,3,66.7,0,2,2,6,2,1,0,0,11
437690,497_15_18,ICELAND,4840,10,helgi magnusson,3,0,2,0,0,1,0,0,1,0,0,0,0,1,1,2,0,0,0,0,0,0
437691,497_15_18,ICELAND,2764,13,hordur vilhjalmsson,26,2,7,28.6,1,5,20,1,2,50,0,0,0,0,3,3,3,4,1,0,0,5
437692,497_15_18,ICELAND,4980,14,logi gunnarsson,11,2,3,66.7,2,3,66.7,0,0,0,0,0,0,0,0,0,0,1,1,0,0,4
437693,497_15_18,ICELAND,2071,15,pavel ermolinskij,26,0,3,0,0,1,0,0,2,0,2,4,50,0,4,4,3,3,3,0,1,2
437694,497_15_18,ICELAND,13211,24,haukur palsson,34,6,14,42.9,2,6,33.3,4,8,50,1,2,50,1,4,5,2,1,1,1,0,17
437695,497_15_18,ICELAND,15702,29,aegir steinarsson,1,0,0,0,0,0,0,0,0,0,0,0,0,0,0,0,0,1,0,0,0,0
437696,497_15_18,ICELAND,0,TOTALS,ICELAND,200,21,60,35,12,33,36.4,9,27,33.3,13,19,68.4,8,24,32,15,20,10,3,1,64
437697,497_15_18,ITALY,20021,0,amedeo della valle,0,0,0,0,0,0,0,0,0,0,0,0,0,0,0,0,0,0,0,0,0,0
437698,497_15_18,ITALY,1272,3,marco belinelli,36,2,10,20,0,3,0,2,7,28.6,6,7,85.7,1,7,8,3,2,1,1,0,12
437699,497_15_18,ITALY,7944,4,pietro aradori,20,1,2,50,1,2,50,0,0,0,3,3,100,0,4,4,1,2,2,0,0,5
437700,497_15_18,ITALY,12988,5,alessandro gentile,34,7,16,43.8,5,12,41.7,2,4,50,5,5,100,0,5,5,4,2,1,1,1,21
437701,497_15_18,ITALY,2667,8,danilo gallinari,18,2,4,50,2,4,50,0,0,0,0,0,0,3,7,10,1,5,3,0,1,4
437702,497_15_18,ITALY,1270,9,andrea bargnani,9,1,5,20,1,5,20,0,0,0,3,4,75,2,3,5,0,1,2,0,3,5
437703,497_15_18,ITALY,15319,12,marco cusin,14,2,2,100,2,2,100,0,0,0,2,2,100,1,1,2,0,3,2,1,1,6
437704,497_15_18,ITALY,1861,13,luigi datome,11,3,8,37.5,3,5,60,0,3,0,1,2,50,0,1,1,2,1,0,0,0,7
437705,497_15_18,ITALY,10968,17,nicolo melli,17,1,2,50,1,2,50,0,0,0,0,0,0,4,2,6,1,5,2,0,0,2
437706,497_15_18,ITALY,19752,20,andrea cinciarini,21,2,7,28.6,2,5,40,0,2,0,0,0,0,2,1,3,1,1,0,0,0,4
437707,497_15_18,ITALY,10444,23,daniel hackett,19,2,5,40,1,3,33.3,1,2,50,0,0,0,0,0,0,0,1,2,1,0,5
437708,497_15_18,ITALY,15644,33,achille polonara,2,0,0,0,0,0,0,0,0,0,0,0,0,0,0,0,0,0,0,0,0,0
437709,497_15_18,ITALY,0,TOTALS,ITALY,200,23,61,37.7,18,43,41.9,5,18,27.8,20,23,87,13,32,45,13,23,15,4,6,71
437710,497_15_19,SLOVENIA,4655,1,nebojsa joksimovic,11,0,2,0,0,0,0,0,2,0,0,0,0,0,2,2,0,1,2,0,0,0
437711,497_15_19,SLOVENIA,13125,5,luka rupnik,3,0,1,0,0,0,0,0,1,0,0,0,0,0,1,1,0,0,0,0,0,0
437712,497_15_19,SLOVENIA,17343,7,klemen prepelic,30,5,5,100,1,1,100,4,4,100,7,7,100,0,5,5,4,2,6,0,0,21
437713,497_15_19,SLOVENIA,15479,9,jaka blazic,27,5,9,55.6,4,5,80,1,4,25,1,2,50,0,1,1,1,3,2,0,0,12
437714,497_15_19,SLOVENIA,8251,10,mitja nikolic,11,0,1,0,0,1,0,0,0,0,0,0,0,0,1,1,1,1,0,0,0,0
437715,497_15_19,SLOVENIA,6197,12,zoran dragic,13,2,5,40,1,3,33.3,1,2,50,2,2,100,1,1,2,1,3,4,0,0,7
437716,497_15_19,SLOVENIA,4764,13,miha zupan,13,1,1,100,0,0,0,1,1,100,0,0,0,0,0,0,2,2,1,0,0,3
437717,497_15_19,SLOVENIA,24203,15,jure balazic,19,3,4,75,2,2,100,1,2,50,0,0,0,0,0,0,1,5,2,0,0,7
437718,497_15_19,SLOVENIA,1069,17,sasa zagorac,0,0,0,0,0,0,0,0,0,0,0,0,0,0,0,0,0,0,0,0,0,0
437719,497_15_19,SLOVENIA,17344,23,alen omic,23,3,5,60,3,5,60,0,0,0,0,0,0,0,3,3,4,3,3,0,1,6
437720,497_15_19,SLOVENIA,5782,24,jaka klobucar,26,6,8,75,3,4,75,3,4,75,5,5,100,0,4,4,2,4,1,1,0,20
437721,497_15_19,SLOVENIA,5023,55,uros slokar,24,1,4,25,1,3,33.3,0,1,0,1,1,100,2,3,5,3,1,1,0,0,3
437722,497_15_19,SLOVENIA,0,TOTALS,SLOVENIA,200,26,45,57.8,15,24,62.5,11,21,52.4,16,17,94.1,3,28,31,19,25,23,1,1,79
437723,497_15_19,GEORGIA,24223,0,jacob everse pullen,14,1,4,25,1,3,33.3,0,1,0,2,2,100,0,0,0,0,2,1,0,0,4
437724,497_15_19,GEORGIA,8378,4,nika metreveli,0,0,0,0,0,0,0,0,0,0,0,0,0,0,0,0,0,0,0,0,0,0
437725,497_15_19,GEORGIA,4919,7,zaza pachulia,19,1,6,16.7,1,6,16.7,0,0,0,1,2,50,2,0,2,2,5,2,2,0,3
437726,497_15_19,GEORGIA,1690,8,george tsintsadze,35,4,10,40,4,6,66.7,0,4,0,3,3,100,0,0,0,7,4,3,2,0,11
437727,497_15_19,GEORGIA,6436,9,giorgi shermadini,20,3,3,100,3,3,100,0,0,0,5,6,83.3,2,2,4,0,2,0,0,2,11
437728,497_15_19,GEORGIA,15684,10,duda sanadze,13,0,2,0,0,1,0,0,1,0,0,0,0,0,1,1,2,2,3,0,0,0
437729,497_15_19,GEORGIA,1697,11,manuchar markoishvili,27,2,8,25,1,3,33.3,1,5,20,1,1,100,0,3,3,3,4,1,0,0,6
437730,497_15_19,GEORGIA,12467,12,levan patsatsia,4,0,0,0,0,0,0,0,0,0,0,0,0,0,0,0,0,0,0,0,0,0
437731,497_15_19,GEORGIA,1699,13,viktor sanikidze,29,4,8,50,3,5,60,1,3,33.3,1,1,100,0,2,2,0,3,1,0,0,10
437732,497_15_19,GEORGIA,16022,15,beka burjanadze,11,1,4,25,1,2,50,0,2,0,0,0,0,0,2,2,1,1,0,0,0,2
437733,497_15_19,GEORGIA,11036,23,tornike shengelia,30,8,12,66.7,7,8,87.5,1,4,25,4,6,66.7,0,3,3,3,3,1,1,0,21
437734,497_15_19,GEORGIA,1693,25,besik lezhava,0,0,0,0,0,0,0,0,0,0,0,0,0,0,0,0,0,0,0,0,0,0
437735,497_15_19,GEORGIA,0,TOTALS,GEORGIA,200,24,57,42.1,21,37,56.8,3,20,15,17,21,81,5,15,20,18,26,12,5,2,68
437736,497_15_20,LATVIA,19755,5,mareks mejeris,21,1,3,33.3,1,2,50,0,1,0,3,4,75,1,2,3,0,0,0,0,1,5
437737,497_15_20,LATVIA,2539,6,rolands freimanis,24,4,9,44.4,4,6,66.7,0,3,0,0,0,0,2,7,9,1,2,0,0,0,8
437738,497_15_20,LATVIA,5029,7,janis blums,22,2,7,28.6,1,3,33.3,1,4,25,1,2,50,0,1,1,1,2,0,1,0,6
437739,497_15_20,LATVIA,6271,9,dairis bertans,16,1,6,16.7,0,2,0,1,4,25,3,3,100,0,2,2,1,2,1,0,0,6
437740,497_15_20,LATVIA,12927,10,janis timma,15,2,9,22.2,1,2,50,1,7,14.3,0,0,0,1,2,3,3,3,2,0,0,5
437741,497_15_20,LATVIA,4604,12,kristaps janicenoks,18,0,5,0,0,2,0,0,3,0,0,0,0,0,2,2,3,0,1,2,0,0
437742,497_15_20,LATVIA,10585,13,janis strelnieks,20,1,4,25,0,1,0,1,3,33.3,0,0,0,1,0,1,3,1,1,0,0,3
437743,497_15_20,LATVIA,1002,14,kaspars berzins,20,3,4,75,1,1,100,2,3,66.7,0,0,0,0,2,2,0,4,0,0,0,8
437744,497_15_20,LATVIA,12931,19,kaspars vecvagars,6,1,4,25,1,4,25,0,0,0,0,0,0,0,1,1,0,0,0,0,0,2
437745,497_15_20,LATVIA,11058,23,haralds karlis,7,0,0,0,0,0,0,0,0,0,0,0,0,0,1,1,2,4,0,0,0,0
437746,497_15_20,LATVIA,29509,31,zanis peiners,17,2,5,40,2,3,66.7,0,2,0,0,0,0,0,0,0,1,0,2,0,1,4
437747,497_15_20,LATVIA,15602,33,martins meiers,14,1,2,50,1,2,50,0,0,0,0,0,0,1,1,2,0,4,3,0,2,2
437748,497_15_20,LATVIA,0,TOTALS,LATVIA,200,18,58,31,12,28,42.9,6,30,20,7,9,77.8,8,25,33,15,22,11,3,4,49
437749,497_15_20,LITHUANIA,1726,5,mantas kalnietis,28,5,9,55.6,4,7,57.1,1,2,50,1,1,100,0,3,3,6,3,3,0,0,12
437750,497_15_20,LITHUANIA,8963,6,deividas gailius,20,2,6,33.3,1,4,25,1,2,50,2,2,100,3,2,5,2,1,2,0,0,7
437751,497_15_20,LITHUANIA,980,8,jonas maciulis,30,5,10,50,2,7,28.6,3,3,100,0,0,0,1,9,10,3,2,1,1,1,13
437752,497_15_20,LITHUANIA,3474,10,renaldas seibutis,22,2,5,40,2,4,50,0,1,0,0,0,0,0,2,2,3,3,0,1,0,4
437753,497_15_20,LITHUANIA,22216,11,domantas sabonis,0,0,0,0,0,0,0,0,0,0,0,0,0,0,0,0,0,0,0,0,0,0
437754,497_15_20,LITHUANIA,3476,12,antanas kavaliauskas,18,0,1,0,0,1,0,0,0,0,3,4,75,2,4,6,1,1,0,0,1,3
437755,497_15_20,LITHUANIA,987,13,paulius jankunas,28,3,6,50,2,4,50,1,2,50,0,0,0,1,5,6,0,1,1,0,1,7
437756,497_15_20,LITHUANIA,24,15,robertas javtokas,0,0,0,0,0,0,0,0,0,0,0,0,0,0,0,0,0,0,0,0,0,0
437757,497_15_20,LITHUANIA,10916,17,jonas valanciunas,22,7,17,41.2,7,17,41.2,0,0,0,1,2,50,2,5,7,1,4,1,2,2,15
437758,497_15_20,LITHUANIA,10639,19,mindaugas kuzminskas,20,2,7,28.6,2,5,40,0,2,0,3,3,100,0,2,2,0,1,0,0,0,7
437759,497_15_20,LITHUANIA,29513,21,arturas milaknis,0,0,0,0,0,0,0,0,0,0,0,0,0,0,0,0,0,0,0,0,0,0
437760,497_15_20,LITHUANIA,17685,43,lukas lekavicius,12,0,3,0,0,3,0,0,0,0,0,0,0,1,0,1,2,0,0,1,0,0
437761,497_15_20,LITHUANIA,0,TOTALS,LITHUANIA,200,26,64,40.6,20,52,38.5,6,12,50,10,12,83.3,13,32,45,18,16,8,5,5,68
437762,497_15_21,BOSNIA AND HERZEGOVINA,5859,4,muhamed pasalic,6,0,1,0,0,0,0,0,1,0,0,0,0,0,0,0,1,2,1,0,0,0
437763,497_15_21,BOSNIA AND HERZEGOVINA,20566,5,nedim buza,7,1,4,25,1,3,33.3,0,1,0,0,0,0,0,2,2,0,4,0,1,0,2
437764,497_15_21,BOSNIA AND HERZEGOVINA,7780,6,andrija stipanovic,21,4,7,57.1,4,7,57.1,0,0,0,2,5,40,2,1,3,0,2,2,0,0,10
437765,497_15_21,BOSNIA AND HERZEGOVINA,24189,7,marko sutalo,23,3,8,37.5,1,2,50,2,6,33.3,0,0,0,0,1,1,4,3,0,2,0,8
437766,497_15_21,BOSNIA AND HERZEGOVINA,5026,9,edin bavcic,18,2,3,66.7,2,2,100,0,1,0,0,1,0,2,2,4,0,3,2,0,0,4
437767,497_15_21,BOSNIA AND HERZEGOVINA,2887,10,nemanja gordic,20,1,7,14.3,0,3,0,1,4,25,0,0,0,0,3,3,1,0,1,0,0,3
437768,497_15_21,BOSNIA AND HERZEGOVINA,2891,11,elmedin kikanovic,19,2,8,25,2,8,25,0,0,0,6,8,75,0,1,1,1,1,1,1,0,10
437769,497_15_21,BOSNIA AND HERZEGOVINA,24191,13,dalibor persic,14,1,4,25,1,2,50,0,2,0,0,0,0,1,2,3,0,2,0,0,0,2
437770,497_15_21,BOSNIA AND HERZEGOVINA,15282,15,milan milosevic,7,1,3,33.3,0,2,0,1,1,100,0,0,0,1,3,4,1,0,1,0,0,3
437771,497_15_21,BOSNIA AND HERZEGOVINA,29497,20,alex renfroe,21,4,8,50,4,7,57.1,0,1,0,0,0,0,0,1,1,3,1,1,1,0,8
437772,497_15_21,BOSNIA AND HERZEGOVINA,17436,23,adin vrabac,23,0,2,0,0,0,0,0,2,0,0,0,0,0,1,1,1,3,3,0,0,0
437773,497_15_21,BOSNIA AND HERZEGOVINA,29498,30,drasko albijanic,22,1,4,25,1,3,33.3,0,1,0,2,4,50,2,4,6,0,3,1,1,0,4
437774,497_15_21,BOSNIA AND HERZEGOVINA,0,TOTALS,BOSNIA AND HERZEGOVINA,200,20,59,33.9,16,39,41,4,20,20,10,18,55.6,8,22,30,12,24,14,6,0,54
437775,497_15_21,FRANCE,11077,4,leo j. p. westermann,17,3,6,50,0,0,0,3,6,50,0,0,0,0,0,0,1,3,2,0,0,9
437776,497_15_21,FRANCE,2588,5,nicolas batum,17,4,12,33.3,3,9,33.3,1,3,33.3,2,2,100,0,2,2,1,0,1,0,1,11
437777,497_15_21,FRANCE,11076,7,joffrey lauvergne,17,5,9,55.6,4,7,57.1,1,2,50,1,2,50,2,5,7,1,4,1,0,0,12
437778,497_15_21,FRANCE,1864,8,charles kahudi,16,3,4,75,3,3,100,0,1,0,1,2,50,2,2,4,2,1,1,1,0,7
437779,497_15_21,FRANCE,5047,9,tony parker,20,4,6,66.7,3,4,75,1,2,50,2,4,50,0,2,2,5,0,1,1,0,11
437780,497_15_21,FRANCE,12971,10,evan fournier,16,0,3,0,0,3,0,0,0,0,2,2,100,0,1,1,3,4,1,0,0,2
437781,497_15_21,FRANCE,4663,11,florent pietrus,18,2,2,100,2,2,100,0,0,0,1,2,50,3,3,6,0,3,0,1,0,5
437782,497_15_21,FRANCE,10428,12,nando de colo,21,5,7,71.4,5,6,83.3,0,1,0,2,2,100,0,7,7,2,1,2,1,0,12
437783,497_15_21,FRANCE,4665,13,boris diaw,18,1,1,100,1,1,100,0,0,0,1,2,50,1,3,4,6,0,1,0,0,3
437784,497_15_21,FRANCE,5044,15,mickael gelabale,15,1,4,25,1,3,33.3,0,1,0,2,2,100,0,3,3,0,1,1,0,0,4
437785,497_15_21,FRANCE,17374,16,rudy gobert,18,2,3,66.7,2,3,66.7,0,0,0,1,2,50,1,4,5,1,2,0,1,3,5
437786,497_15_21,FRANCE,17677,19,mouhammadou jaiteh,8,0,1,0,0,1,0,0,0,0,0,0,0,0,2,2,0,1,1,0,0,0
437787,497_15_21,FRANCE,0,TOTALS,FRANCE,200,30,58,51.7,24,42,57.1,6,16,37.5,15,22,68.2,9,35,44,22,20,12,5,4,81
437788,497_15_22,TURKEY,20222,4,kartal ozmizrak,17,1,5,20,0,2,0,1,3,33.3,0,0,0,0,0,0,2,0,2,0,0,3
437789,497_15_22,TURKEY,15304,5,sinan guler,15,1,6,16.7,1,5,20,0,1,0,0,0,0,0,1,1,0,3,3,1,0,2
437790,497_15_22,TURKEY,20219,6,cedi osman,24,4,9,44.4,4,6,66.7,0,3,0,1,3,33.3,2,2,4,1,3,0,1,1,9
437791,497_15_22,TURKEY,2576,7,baris hersek,17,3,3,100,2,2,100,1,1,100,0,0,0,2,1,3,1,1,0,0,0,7
437792,497_15_22,TURKEY,1802,8,ersan ilyasova,21,3,7,42.9,2,3,66.7,1,4,25,8,9,88.9,0,1,1,0,2,0,0,0,15
437793,497_15_22,TURKEY,1797,9,semih erden,18,1,2,50,1,2,50,0,0,0,0,0,0,1,1,2,0,4,2,0,0,2
437794,497_15_22,TURKEY,8151,10,melih mahmutoglu,19,5,9,55.6,3,4,75,2,5,40,0,0,0,0,0,0,1,0,2,0,0,12
437795,497_15_22,TURKEY,1796,11,oguz savas,7,3,3,100,3,3,100,0,0,0,0,0,0,2,2,4,0,5,1,0,0,6
437796,497_15_22,TURKEY,24656,12,furkan korkmaz,10,1,4,25,1,4,25,0,0,0,0,0,0,1,0,1,1,2,1,1,0,2
437797,497_15_22,TURKEY,29512,13,ali muhammed,17,1,7,14.3,0,3,0,1,4,25,2,2,100,0,2,2,2,2,1,1,0,5
437798,497_15_22,TURKEY,17253,14,huseyin koksal,21,5,12,41.7,3,7,42.9,2,5,40,0,0,0,3,0,3,0,1,0,0,0,12
437799,497_15_22,TURKEY,10942,15,furkan aldemir,15,1,3,33.3,1,3,33.3,0,0,0,0,0,0,2,1,3,2,1,0,0,0,2
437800,497_15_22,TURKEY,0,TOTALS,TURKEY,200,29,70,41.4,21,44,47.7,8,26,30.8,11,14,78.6,17,13,30,10,24,12,4,1,77
437801,497_15_22,SPAIN,61,4,pau gasol,24,7,11,63.6,5,9,55.6,2,2,100,5,7,71.4,2,5,7,0,1,1,1,2,21
437802,497_15_22,SPAIN,70,5,rudy fernandez,15,4,5,80,3,3,100,1,2,50,1,2,50,0,2,2,0,2,1,1,0,10
437803,497_15_22,SPAIN,1877,6,sergio rodriguez,24,6,9,66.7,4,5,80,2,4,50,0,0,0,0,2,2,5,2,0,2,0,14
437804,497_15_22,SPAIN,17609,7,guillermo hernangomez,16,5,7,71.4,5,7,71.4,0,0,0,1,4,25,2,4,6,0,2,2,0,2,11
437805,497_15_22,SPAIN,5713,8,pau ribas tossas,24,3,7,42.9,1,3,33.3,2,4,50,0,0,0,1,2,3,3,3,0,0,0,8
437806,497_15_22,SPAIN,66,9,felipe reyes,18,5,7,71.4,4,6,66.7,1,1,100,1,4,25,2,2,4,3,1,0,0,0,12
437807,497_15_22,SPAIN,2628,10,victor claver,5,0,0,0,0,0,0,0,0,0,0,0,0,0,1,1,1,3,0,0,0,0
437808,497_15_22,SPAIN,1317,11,fernando san emeterio,24,4,5,80,3,3,100,1,2,50,1,2,50,1,1,2,4,1,1,0,0,10
437809,497_15_22,SPAIN,1871,12,sergio llull,25,3,6,50,1,3,33.3,2,3,66.7,1,2,50,0,1,1,5,3,2,0,0,9
437810,497_15_22,SPAIN,6265,13,pablo aguilar,2,0,0,0,0,0,0,0,0,0,0,0,0,0,0,0,0,1,0,0,0,0
437811,497_15_22,SPAIN,17234,14,nikola mirotic,18,3,5,60,2,3,66.7,1,2,50,2,2,100,0,3,3,2,2,1,2,0,9
437812,497_15_22,SPAIN,19987,15,guillem vives,6,0,1,0,0,0,0,0,1,0,0,0,0,0,0,0,1,0,1,1,0,0
437813,497_15_22,SPAIN,0,TOTALS,SPAIN,200,40,63,63.5,28,42,66.7,12,21,57.1,12,23,52.2,9,26,35,24,21,10,7,4,104
437814,497_15_23,GREECE,5050,5,yannis bourousis,27,5,7,71.4,5,7,71.4,0,0,0,0,0,0,0,4,4,5,3,2,1,0,10
437815,497_15_23,GREECE,123,6,nikos zisis,24,3,8,37.5,3,4,75,0,4,0,1,2,50,0,2,2,4,3,0,0,0,7
437816,497_15_23,GREECE,125,7,vassilis spanoulis,31,4,11,36.4,1,5,20,3,6,50,5,6,83.3,1,3,4,6,2,0,0,0,16
437817,497_15_23,GREECE,12472,8,nick calathes,15,1,5,20,1,4,25,0,1,0,0,0,0,0,0,0,1,0,2,0,0,2
437818,497_15_23,GREECE,1057,9,stratos perperoglou,6,0,2,0,0,0,0,0,2,0,0,0,0,0,0,0,1,2,0,0,0,0
437819,497_15_23,GREECE,8304,10,kostas sloukas,24,1,4,25,1,3,33.3,0,1,0,0,0,0,1,2,3,3,5,3,0,0,2
437820,497_15_23,GREECE,15374,12,kostas kaimakoglou,6,0,0,0,0,0,0,0,0,0,0,0,0,0,2,2,0,0,0,0,0,0
437821,497_15_23,GREECE,10607,13,kostas koufos,13,5,10,50,5,10,50,0,0,0,1,2,50,6,3,9,0,2,1,0,1,11
437822,497_15_23,GREECE,1056,15,georgios printezis,29,6,12,50,5,8,62.5,1,4,25,0,0,0,2,2,4,0,2,0,1,0,13
437823,497_15_23,GREECE,10606,16,kostas papanikolaou,4,1,2,50,1,1,100,0,1,0,0,0,0,0,0,0,0,1,0,0,0,2
437824,497_15_23,GREECE,8303,17,evangelos mantzaris,2,0,0,0,0,0,0,0,0,0,3,3,100,0,0,0,0,0,1,0,0,3
437825,497_15_23,GREECE,24314,34,giannis antetokounmpo,19,3,6,50,3,5,60,0,1,0,0,0,0,0,3,3,1,4,0,0,0,6
437826,497_15_23,GREECE,0,TOTALS,GREECE,200,29,67,43.3,25,47,53.2,4,20,20,10,13,76.9,14,26,40,21,24,9,2,1,72
437827,497_15_23,CROATIA,1844,4,ante tomic,27,3,8,37.5,3,8,37.5,0,0,0,3,4,75,0,5,5,0,0,1,0,0,9
437828,497_15_23,CROATIA,1846,5,damjan rudez,9,0,2,0,0,1,0,0,1,0,0,0,0,0,0,0,0,1,0,0,0,0
437829,497_15_23,CROATIA,1915,6,rok stipcevic,12,0,3,0,0,0,0,0,3,0,0,0,0,1,1,2,1,1,1,0,0,0
437830,497_15_23,CROATIA,6280,7,bojan bogdanovic,0,0,0,0,0,0,0,0,0,0,0,0,0,0,0,0,0,0,0,0,0,0
437831,497_15_23,CROATIA,15894,8,dario saric,31,4,5,80,3,3,100,1,2,50,2,4,50,0,6,6,2,2,3,0,1,11
437832,497_15_23,CROATIA,1251,9,marko tomas,0,0,0,0,0,0,0,0,0,0,0,0,0,0,0,0,0,0,0,0,0,0
437833,497_15_23,CROATIA,4585,10,roko ukic,34,4,8,50,2,3,66.7,2,5,40,4,4,100,0,2,2,4,4,3,0,0,14
437834,497_15_23,CROATIA,1249,11,krunoslav simon,27,5,10,50,2,5,40,3,5,60,5,6,83.3,2,3,5,1,1,0,1,0,18
437835,497_15_23,CROATIA,18342,13,dontaye draper,21,1,3,33.3,1,2,50,0,1,0,0,0,0,1,2,3,2,4,0,1,0,2
437836,497_15_23,CROATIA,10624,15,miro bilan,0,0,0,0,0,0,0,0,0,0,0,0,0,0,0,0,0,0,0,0,0,0
437837,497_15_23,CROATIA,16607,21,luka zoric,13,3,6,50,3,6,50,0,0,0,2,2,100,0,4,4,0,3,0,0,0,8
437838,497_15_23,CROATIA,18415,23,mario hezonja,27,3,10,30,1,2,50,2,8,25,0,0,0,0,2,2,0,0,1,1,1,8
437839,497_15_23,CROATIA,0,TOTALS,CROATIA,200,23,55,41.8,15,30,50,8,25,32,16,20,80,7,25,32,10,16,10,3,2,70
437840,497_15_24,UKRAINE,5790,4,maksym pustozvonov,30,1,5,20,0,2,0,1,3,33.3,1,2,50,1,4,5,0,1,0,0,0,4
437841,497_15_24,UKRAINE,29514,5,dzherom dzherri rendl,26,4,12,33.3,3,10,30,1,2,50,3,4,75,0,2,2,3,1,3,0,0,12
437842,497_15_24,UKRAINE,12946,6,olexandr mishula,10,2,6,33.3,2,4,50,0,2,0,0,0,0,0,0,0,1,4,0,0,0,4
437843,497_15_24,UKRAINE,2768,7,denys lukashov,15,3,6,50,1,2,50,2,4,50,1,2,50,0,2,2,4,3,2,0,0,9
437844,497_15_24,UKRAINE,2093,8,kyrylo fesenko,26,6,15,40,6,15,40,0,0,0,2,5,40,7,1,8,1,2,0,0,0,14
437845,497_15_24,UKRAINE,7927,9,oleksandr sizov,6,0,1,0,0,0,0,0,1,0,0,0,0,1,0,1,0,1,0,1,0,0
437846,497_15_24,UKRAINE,10714,10,stanislav tymofeyenko,15,2,3,66.7,2,3,66.7,0,0,0,0,0,0,0,1,1,0,0,2,0,0,4
437847,497_15_24,UKRAINE,10926,11,oleksandr lypovyy,31,1,7,14.3,0,3,0,1,4,25,0,0,0,0,2,2,3,3,2,3,0,3
437848,497_15_24,UKRAINE,5791,12,maxym korniyenko,19,2,5,40,2,5,40,0,0,0,0,0,0,3,2,5,1,0,2,0,0,4
437849,497_15_24,UKRAINE,10713,13,ihor zaytsev,17,3,4,75,3,4,75,0,0,0,0,0,0,1,4,5,2,1,1,0,0,6
437850,497_15_24,UKRAINE,19863,14,artem pustovyi,3,1,2,50,1,1,100,0,1,0,2,2,100,0,1,1,0,1,0,0,0,4
437851,497_15_24,UKRAINE,12945,15,pavlo krutous,2,0,1,0,0,1,0,0,0,0,0,0,0,0,0,0,0,0,0,0,0,0
437852,497_15_24,UKRAINE,0,TOTALS,UKRAINE,200,25,67,37.3,20,50,40,5,17,29.4,9,15,60,18,21,39,15,17,13,4,0,64
437853,497_15_24,CZECH REPUBLIC,4677,4,petr benda,23,4,6,66.7,4,5,80,0,1,0,0,0,0,1,1,2,2,2,1,1,0,8
437854,497_15_24,CZECH REPUBLIC,29502,5,patrik auda,8,0,2,0,0,2,0,0,0,0,0,2,0,1,1,2,0,1,1,0,0,0
437855,497_15_24,CZECH REPUBLIC,5478,6,pavel pumprla,29,7,12,58.3,6,8,75,1,4,25,2,3,66.7,0,1,1,2,3,1,2,0,17
437856,497_15_24,CZECH REPUBLIC,10700,7,vojtech hruban,8,1,1,100,1,1,100,0,0,0,0,0,0,0,1,1,0,1,0,0,0,2
437857,497_15_24,CZECH REPUBLIC,8325,8,tomas satoransky,28,6,11,54.5,5,10,50,1,1,100,2,3,66.7,3,5,8,6,3,4,0,0,15
437858,497_15_24,CZECH REPUBLIC,4774,9,jiri welsch,15,1,3,33.3,1,2,50,0,1,0,0,0,0,0,0,0,4,2,2,0,0,2
437859,497_15_24,CZECH REPUBLIC,1096,10,pavel houska,23,1,5,20,0,2,0,1,3,33.3,2,2,100,0,6,6,0,2,0,1,0,5
437860,497_15_24,CZECH REPUBLIC,4775,11,lubos barton,0,0,0,0,0,0,0,0,0,0,0,0,0,0,0,0,0,0,0,0,0,0
437861,497_15_24,CZECH REPUBLIC,8327,12,david jelinek,7,1,3,33.3,1,2,50,0,1,0,0,0,0,0,2,2,0,0,1,0,0,2
437862,497_15_24,CZECH REPUBLIC,10484,13,jakub sirina,2,0,1,0,0,0,0,0,1,0,0,0,0,0,0,0,0,0,1,0,0,0
437863,497_15_24,CZECH REPUBLIC,29503,14,blake schilb,31,3,7,42.9,3,4,75,0,3,0,2,2,100,1,3,4,5,3,0,0,0,8
437864,497_15_24,CZECH REPUBLIC,6362,24,jan vesely,26,9,14,64.3,9,14,64.3,0,0,0,1,4,25,5,4,9,3,1,0,1,1,19
437865,497_15_24,CZECH REPUBLIC,0,TOTALS,CZECH REPUBLIC,200,33,65,50.8,30,50,60,3,15,20,9,16,56.2,13,28,41,22,18,13,5,1,78
437866,497_15_25,FINLAND,1834,4,mikko koivisto,8,0,0,0,0,0,0,0,0,0,0,0,0,0,0,0,0,1,0,0,0,0
437867,497_15_25,FINLAND,1314,7,shawn huff,26,4,5,80,3,3,100,1,2,50,1,2,50,0,2,2,1,5,3,0,0,10
437868,497_15_25,FINLAND,1836,8,gerald lee,13,2,2,100,2,2,100,0,0,0,0,2,0,3,2,5,1,3,2,0,0,4
437869,497_15_25,FINLAND,11129,9,sasu salin,30,5,14,35.7,2,5,40,3,9,33.3,3,4,75,0,4,4,0,0,1,1,0,16
437870,497_15_25,FINLAND,4932,10,tuukka kotti,23,3,6,50,3,6,50,0,0,0,1,2,50,2,5,7,4,3,0,1,0,7
437871,497_15_25,FINLAND,2802,11,petteri koponen,30,4,11,36.4,2,7,28.6,2,4,50,2,2,100,1,2,3,6,1,2,1,0,12
437872,497_15_25,FINLAND,8436,12,matti nuutinen,14,2,4,50,2,2,100,0,2,0,0,0,0,2,0,2,2,2,0,0,0,4
437873,497_15_25,FINLAND,24222,21,ville kaunisto,10,2,3,66.7,1,2,50,1,1,100,0,0,0,1,2,3,1,2,0,0,0,5
437874,497_15_25,FINLAND,29510,24,joonas caven,0,0,0,0,0,0,0,0,0,0,0,0,0,0,0,0,0,0,0,0,0,0
437875,497_15_25,FINLAND,8428,30,roope ahonen,3,0,0,0,0,0,0,0,0,0,2,2,100,0,1,1,0,1,0,0,0,2
437876,497_15_25,FINLAND,29511,31,jamar wilson,12,1,1,100,1,1,100,0,0,0,0,0,0,0,0,0,0,2,2,1,0,2
437877,497_15_25,FINLAND,25454,33,erik jay murphy,31,7,13,53.8,5,10,50,2,3,66.7,3,4,75,3,4,7,0,3,2,0,1,19
437878,497_15_25,FINLAND,0,TOTALS,FINLAND,200,30,59,50.8,21,38,55.3,9,21,42.9,12,18,66.7,12,23,35,15,23,12,4,1,81
437879,497_15_25,RUSSIA,19857,1,andrey zubkov,30,5,11,45.5,4,9,44.4,1,2,50,0,0,0,1,3,4,2,3,1,1,0,11
437880,497_15_25,RUSSIA,29505,4,evgenii baburin,0,0,0,0,0,0,0,0,0,0,0,0,0,0,0,0,0,0,0,0,0,0
437881,497_15_25,RUSSIA,8296,5,ruslan pateev,4,0,0,0,0,0,0,0,0,0,1,2,50,0,0,0,0,0,1,0,0,1
437882,497_15_25,RUSSIA,1078,7,vitaly fridzon,24,8,14,57.1,4,7,57.1,4,7,57.1,2,2,100,0,0,0,4,3,0,0,0,22
437883,497_15_25,RUSSIA,1083,9,egor vyaltsev,21,2,8,25,2,7,28.6,0,1,0,1,1,100,0,1,1,1,2,1,0,0,5
437884,497_15_25,RUSSIA,10610,11,semen antonov,10,1,1,100,1,1,100,0,0,0,4,4,100,0,1,1,0,1,1,0,0,6
437885,497_15_25,RUSSIA,5064,12,sergey monya,26,3,7,42.9,3,5,60,0,2,0,1,3,33.3,1,0,1,3,2,1,4,0,7
437886,497_15_25,RUSSIA,2554,13,dmitry khvostov,34,4,7,57.1,2,3,66.7,2,4,50,1,2,50,1,1,2,5,4,2,2,0,11
437887,497_15_25,RUSSIA,1808,14,anton ponkrashov,6,0,0,0,0,0,0,0,0,0,1,2,50,0,0,0,0,1,1,1,0,1
437888,497_15_25,RUSSIA,7770,20,andrey vorontsevich,34,5,10,50,4,8,50,1,2,50,2,2,100,3,8,11,5,2,0,0,1,13
437889,497_15_25,RUSSIA,21941,32,andrei desiatnikov,0,0,0,0,0,0,0,0,0,0,0,0,0,0,0,0,0,0,0,0,0,0
437890,497_15_25,RUSSIA,1809,41,nikita kurbanov,11,1,2,50,1,2,50,0,0,0,0,0,0,2,1,3,0,2,2,0,0,2
437891,497_15_25,RUSSIA,0,TOTALS,RUSSIA,200,29,60,48.3,21,42,50,8,18,44.4,13,18,72.2,10,19,29,20,20,11,8,1,79
437892,497_15_26,LITHUANIA,1726,5,mantas kalnietis,30,3,8,37.5,3,5,60,0,3,0,1,2,50,0,2,2,13,1,2,1,0,7
437893,497_15_26,LITHUANIA,8963,6,deividas gailius,0,0,0,0,0,0,0,0,0,0,0,0,0,0,0,0,0,0,0,0,0,0
437894,497_15_26,LITHUANIA,980,8,jonas maciulis,19,1,6,16.7,1,3,33.3,0,3,0,2,2,100,0,2,2,2,4,2,1,0,4
437895,497_15_26,LITHUANIA,3474,10,renaldas seibutis,23,2,6,33.3,2,3,66.7,0,3,0,0,0,0,0,1,1,2,2,1,2,0,4
437896,497_15_26,LITHUANIA,22216,11,domantas sabonis,16,4,6,66.7,4,5,80,0,1,0,2,3,66.7,1,3,4,0,0,2,0,1,10
437897,497_15_26,LITHUANIA,3476,12,antanas kavaliauskas,2,0,1,0,0,1,0,0,0,0,0,0,0,0,0,0,0,1,0,0,0,0
437898,497_15_26,LITHUANIA,987,13,paulius jankunas,28,3,6,50,2,5,40,1,1,100,6,6,100,3,1,4,4,3,1,0,0,13
437899,497_15_26,LITHUANIA,24,15,robertas javtokas,0,0,0,0,0,0,0,0,0,0,0,0,0,0,0,0,0,0,0,0,0,0
437900,497_15_26,LITHUANIA,10916,17,jonas valanciunas,30,11,16,68.8,11,16,68.8,0,0,0,3,3,100,3,9,12,0,3,2,0,0,25
437901,497_15_26,LITHUANIA,10639,19,mindaugas kuzminskas,25,2,4,50,2,3,66.7,0,1,0,3,4,75,2,4,6,2,1,1,0,0,7
437902,497_15_26,LITHUANIA,29513,21,arturas milaknis,6,0,0,0,0,0,0,0,0,0,2,2,100,0,1,1,0,1,0,0,0,2
437903,497_15_26,LITHUANIA,17685,43,lukas lekavicius,21,1,4,25,1,3,33.3,0,1,0,0,0,0,0,2,2,1,2,1,0,0,2
437904,497_15_26,LITHUANIA,0,TOTALS,LITHUANIA,200,27,57,47.4,26,44,59.1,1,13,7.7,19,22,86.4,11,25,36,24,18,14,4,1,74
437905,497_15_26,BELGIUM,10156,4,lionel bosco,15,1,1,100,1,1,100,0,0,0,0,2,0,0,1,1,3,1,0,1,0,2
437906,497_15_26,BELGIUM,2003,5,sam van rossom,27,5,10,50,2,3,66.7,3,7,42.9,0,0,0,1,2,3,5,1,0,0,0,13
437907,497_15_26,BELGIUM,4548,7,axel hervelle,23,5,9,55.6,4,6,66.7,1,3,33.3,0,0,0,0,2,2,1,3,3,1,1,11
437908,497_15_26,BELGIUM,6157,8,jean marc mwema,20,3,4,75,0,0,0,3,4,75,1,1,100,0,2,2,0,2,1,0,0,10
437909,497_15_26,BELGIUM,5599,9,jonathan tabu,31,6,11,54.5,4,8,50,2,3,66.7,2,2,100,0,1,1,3,3,3,1,0,16
437910,497_15_26,BELGIUM,8359,10,quentin serron,8,0,1,0,0,0,0,0,1,0,0,0,0,0,1,1,1,2,2,2,0,0
437911,497_15_26,BELGIUM,24196,12,wen mukubu,10,0,3,0,0,2,0,0,1,0,0,0,0,1,0,1,0,3,0,0,0,0
437912,497_15_26,BELGIUM,11181,13,pierre-antoine gillet,24,0,3,0,0,0,0,0,3,0,0,0,0,0,3,3,4,3,0,0,0,0
437913,497_15_26,BELGIUM,10498,14,maxime de zeeuw,0,0,0,0,0,0,0,0,0,0,0,0,0,0,0,0,0,0,0,0,0,0
437914,497_15_26,BELGIUM,19894,22,kevin tumba,12,1,3,33.3,1,3,33.3,0,0,0,0,0,0,0,2,2,0,4,1,0,0,2
437915,497_15_26,BELGIUM,15488,23,jean salumu,0,0,0,0,0,0,0,0,0,0,0,0,0,0,0,0,0,0,0,0,0,0
437916,497_15_26,BELGIUM,29508,24,matt lojeski,30,10,15,66.7,8,11,72.7,2,4,50,0,0,0,2,2,4,5,2,0,1,0,22
437917,497_15_26,BELGIUM,0,TOTALS,BELGIUM,200,31,60,51.7,20,34,58.8,11,26,42.3,3,5,60,4,18,22,22,24,10,6,1,76
437918,497_15_27,ISRAEL,24229,5,dagan yivzori,12,1,2,50,1,2,50,0,0,0,0,0,0,0,3,3,0,1,2,0,0,2
437919,497_15_27,ISRAEL,21841,6,shawn dawson,1,0,0,0,0,0,0,0,0,0,1,2,50,0,0,0,0,0,0,0,0,1
437920,497_15_27,ISRAEL,2522,7,gal mekel,40,6,9,66.7,4,6,66.7,2,3,66.7,0,2,0,0,2,2,7,1,3,1,0,14
437921,497_15_27,ISRAEL,1023,8,lior eliyahu,36,6,12,50,6,12,50,0,0,0,2,2,100,2,3,5,6,5,2,1,1,14
437922,497_15_27,ISRAEL,1933,9,omri casspi,42,12,20,60,9,14,64.3,3,6,50,2,5,40,1,5,6,5,4,6,0,0,29
437923,497_15_27,ISRAEL,1022,10,raviv limonad,17,3,5,60,3,5,60,0,0,0,0,0,0,0,1,1,1,2,1,1,0,6
437924,497_15_27,ISRAEL,5780,11,elishay kadir,3,0,0,0,0,0,0,0,0,0,0,0,0,0,0,0,0,1,0,0,0,0
437925,497_15_27,ISRAEL,1685,12,yogev ohayon,30,2,5,40,0,1,0,2,4,50,0,0,0,0,2,2,4,4,3,1,0,6
437926,497_15_27,ISRAEL,4620,14,yaniv green,6,0,0,0,0,0,0,0,0,0,0,2,0,0,0,0,0,1,0,0,0,0
437927,497_15_27,ISRAEL,29504,15,dor fischer,39,5,7,71.4,5,7,71.4,0,0,0,2,4,50,1,7,8,2,3,1,0,3,12
437928,497_15_27,ISRAEL,19712,16,boris rothbart,0,0,0,0,0,0,0,0,0,0,0,0,0,0,0,0,0,0,0,0,0,0
437929,497_15_27,ISRAEL,12887,23,bar timor,0,0,0,0,0,0,0,0,0,0,0,0,0,0,0,0,0,0,0,0,0,0
437930,497_15_27,ISRAEL,0,TOTALS,ISRAEL,225,35,60,58.3,28,47,59.6,7,13,53.8,7,17,41.2,4,27,31,25,22,19,4,4,84
437931,497_15_27,BOSNIA AND HERZEGOVINA,5859,4,muhamed pasalic,12,1,3,33.3,0,0,0,1,3,33.3,0,0,0,2,1,3,0,2,2,0,0,3
437932,497_15_27,BOSNIA AND HERZEGOVINA,20566,5,nedim buza,0,0,0,0,0,0,0,0,0,0,0,0,0,0,0,0,0,0,0,0,0,0
437933,497_15_27,BOSNIA AND HERZEGOVINA,7780,6,andrija stipanovic,37,6,12,50,6,12,50,0,0,0,4,10,40,10,8,18,2,3,5,0,0,16
437934,497_15_27,BOSNIA AND HERZEGOVINA,24189,7,marko sutalo,24,3,8,37.5,0,1,0,3,7,42.9,3,3,100,0,2,2,0,3,1,1,0,12
437935,497_15_27,BOSNIA AND HERZEGOVINA,5026,9,edin bavcic,5,0,0,0,0,0,0,0,0,0,0,0,0,0,0,0,0,1,0,0,0,0
437936,497_15_27,BOSNIA AND HERZEGOVINA,2887,10,nemanja gordic,34,7,15,46.7,4,8,50,3,7,42.9,5,6,83.3,0,1,1,3,3,0,0,0,22
437937,497_15_27,BOSNIA AND HERZEGOVINA,2891,11,elmedin kikanovic,40,8,16,50,7,15,46.7,1,1,100,0,0,0,3,0,3,2,4,2,1,0,17
437938,497_15_27,BOSNIA AND HERZEGOVINA,24191,13,dalibor persic,7,0,2,0,0,0,0,0,2,0,0,0,0,1,1,2,0,0,1,1,0,0
437939,497_15_27,BOSNIA AND HERZEGOVINA,15282,15,milan milosevic,19,0,7,0,0,2,0,0,5,0,2,2,100,0,1,1,1,2,0,2,0,2
437940,497_15_27,BOSNIA AND HERZEGOVINA,29497,20,alex renfroe,33,4,10,40,1,7,14.3,3,3,100,1,2,50,2,6,8,8,3,2,4,0,12
437941,497_15_27,BOSNIA AND HERZEGOVINA,17436,23,adin vrabac,6,0,1,0,0,0,0,0,1,0,0,0,0,0,1,1,0,0,0,0,0,0
437942,497_15_27,BOSNIA AND HERZEGOVINA,29498,30,drasko albijanic,8,1,1,100,1,1,100,0,0,0,0,0,0,0,1,1,0,1,3,0,0,2
437943,497_15_27,BOSNIA AND HERZEGOVINA,0,TOTALS,BOSNIA AND HERZEGOVINA,225,30,75,40,19,46,41.3,11,29,37.9,15,23,65.2,19,23,42,16,22,18,9,0,86
437944,497_15_28,CZECH REPUBLIC,4677,4,petr benda,19,0,7,0,0,6,0,0,1,0,0,0,0,2,4,6,0,1,0,0,0,0
437945,497_15_28,CZECH REPUBLIC,29502,5,patrik auda,11,3,5,60,3,5,60,0,0,0,1,2,50,0,0,0,1,2,1,0,1,7
437946,497_15_28,CZECH REPUBLIC,5478,6,pavel pumprla,29,3,5,60,3,4,75,0,1,0,0,6,0,1,0,1,2,0,1,0,0,6
437947,497_15_28,CZECH REPUBLIC,10700,7,vojtech hruban,1,0,1,0,0,1,0,0,0,0,0,0,0,0,0,0,0,0,0,0,0,0
437948,497_15_28,CZECH REPUBLIC,8325,8,tomas satoransky,37,8,16,50,7,13,53.8,1,3,33.3,5,7,71.4,2,3,5,9,2,0,0,1,22
437949,497_15_28,CZECH REPUBLIC,4774,9,jiri welsch,16,0,3,0,0,1,0,0,2,0,0,0,0,0,0,0,4,2,0,0,0,0
437950,497_15_28,CZECH REPUBLIC,1096,10,pavel houska,14,0,3,0,0,0,0,0,3,0,0,0,0,0,2,2,0,0,0,0,0,0
437951,497_15_28,CZECH REPUBLIC,4775,11,lubos barton,9,0,1,0,0,1,0,0,0,0,0,0,0,1,1,2,0,1,0,0,0,0
437952,497_15_28,CZECH REPUBLIC,8327,12,david jelinek,10,0,3,0,0,1,0,0,2,0,2,3,66.7,0,2,2,1,2,1,0,0,2
437953,497_15_28,CZECH REPUBLIC,10484,13,jakub sirina,0,0,0,0,0,0,0,0,0,0,0,0,0,0,0,0,0,0,0,0,0,0
437954,497_15_28,CZECH REPUBLIC,29503,14,blake schilb,29,3,9,33.3,0,2,0,3,7,42.9,2,2,100,1,2,3,2,2,1,1,0,11
437955,497_15_28,CZECH REPUBLIC,6362,24,jan vesely,26,8,14,57.1,8,14,57.1,0,0,0,1,4,25,5,6,11,0,5,2,1,2,17
437956,497_15_28,CZECH REPUBLIC,0,TOTALS,CZECH REPUBLIC,200,25,67,37.3,21,48,43.8,4,19,21.1,11,24,45.8,14,23,37,19,17,6,2,4,65
437957,497_15_28,LATVIA,19755,5,mareks mejeris,17,0,0,0,0,0,0,0,0,0,2,2,100,0,2,2,1,1,1,0,0,2
437958,497_15_28,LATVIA,2539,6,rolands freimanis,21,3,6,50,3,4,75,0,2,0,0,0,0,3,5,8,2,2,2,0,0,6
437959,497_15_28,LATVIA,5029,7,janis blums,22,5,9,55.6,1,1,100,4,8,50,0,0,0,0,4,4,1,2,0,1,0,14
437960,497_15_28,LATVIA,6271,9,dairis bertans,30,3,11,27.3,2,6,33.3,1,5,20,2,2,100,1,2,3,3,1,2,1,0,9
437961,497_15_28,LATVIA,12927,10,janis timma,22,3,6,50,2,2,100,1,4,25,0,0,0,1,7,8,1,2,4,0,0,7
437962,497_15_28,LATVIA,4604,12,kristaps janicenoks,22,2,4,50,2,3,66.7,0,1,0,2,3,66.7,2,1,3,1,3,1,0,0,6
437963,497_15_28,LATVIA,10585,13,janis strelnieks,27,5,8,62.5,4,6,66.7,1,2,50,0,0,0,0,1,1,7,2,1,0,0,11
437964,497_15_28,LATVIA,1002,14,kaspars berzins,25,3,8,37.5,3,7,42.9,0,1,0,5,6,83.3,1,5,6,1,5,1,0,1,11
437965,497_15_28,LATVIA,12931,19,kaspars vecvagars,0,0,0,0,0,0,0,0,0,0,0,0,0,0,0,0,0,0,0,0,0,0
437966,497_15_28,LATVIA,11058,23,haralds karlis,0,0,0,0,0,0,0,0,0,0,0,0,0,0,0,0,0,0,0,0,0,0
437967,497_15_28,LATVIA,29509,31,zanis peiners,1,0,0,0,0,0,0,0,0,0,0,0,0,0,0,0,1,0,1,0,0,0
437968,497_15_28,LATVIA,15602,33,martins meiers,13,3,5,60,3,5,60,0,0,0,0,0,0,0,5,5,0,3,0,0,0,6
437969,497_15_28,LATVIA,0,TOTALS,LATVIA,200,27,57,47.4,20,34,58.8,7,23,30.4,11,13,84.6,8,35,43,18,21,14,2,1,72
437970,497_15_29,FRANCE,11077,4,leo j. p. westermann,4,0,3,0,0,2,0,0,1,0,0,0,0,1,0,1,0,1,0,0,0,0
437971,497_15_29,FRANCE,2588,5,nicolas batum,20,2,6,33.3,2,4,50,0,2,0,0,0,0,0,4,4,3,4,2,0,0,4
437972,497_15_29,FRANCE,11076,7,joffrey lauvergne,15,1,4,25,1,3,33.3,0,1,0,0,0,0,0,3,3,0,1,0,1,0,2
437973,497_15_29,FRANCE,1864,8,charles kahudi,9,0,0,0,0,0,0,0,0,0,2,2,100,0,0,0,0,1,0,0,0,2
437974,497_15_29,FRANCE,5047,9,tony parker,28,6,13,46.2,6,11,54.5,0,2,0,4,6,66.7,0,1,1,3,0,1,0,0,16
437975,497_15_29,FRANCE,12971,10,evan fournier,11,0,2,0,0,0,0,0,2,0,2,2,100,0,0,0,0,1,2,0,0,2
437976,497_15_29,FRANCE,4663,11,florent pietrus,16,1,2,50,1,2,50,0,0,0,0,0,0,2,1,3,0,3,0,0,0,2
437977,497_15_29,FRANCE,10428,12,nando de colo,29,5,13,38.5,3,9,33.3,2,4,50,0,0,0,1,7,8,1,1,1,2,0,12
437978,497_15_29,FRANCE,4665,13,boris diaw,24,4,9,44.4,4,9,44.4,0,0,0,1,2,50,1,2,3,5,0,1,0,1,9
437979,497_15_29,FRANCE,5044,15,mickael gelabale,19,6,7,85.7,6,6,100,0,1,0,0,0,0,0,3,3,0,2,0,1,0,12
437980,497_15_29,FRANCE,17374,16,rudy gobert,25,4,6,66.7,4,6,66.7,0,0,0,0,0,0,2,5,7,1,3,1,2,3,8
437981,497_15_29,FRANCE,17677,19,mouhammadou jaiteh,0,0,0,0,0,0,0,0,0,0,0,0,0,0,0,0,0,0,0,0,0,0
437982,497_15_29,FRANCE,0,TOTALS,FRANCE,200,29,65,44.6,27,52,51.9,2,13,15.4,9,12,75,8,27,35,13,17,9,6,4,69
437983,497_15_29,POLAND,15535,0,aleksander czyz,0,0,0,0,0,0,0,0,0,0,0,0,0,0,0,0,0,0,0,0,0,0
437984,497_15_29,POLAND,5694,5,aaron cel,19,1,3,33.3,0,0,0,1,3,33.3,1,2,50,0,6,6,1,2,2,0,0,4
437985,497_15_29,POLAND,29496,6,aj slaughter,26,4,11,36.4,3,6,50,1,5,20,0,0,0,0,2,2,3,4,1,1,0,9
437986,497_15_29,POLAND,7833,7,damian kulig,21,2,3,66.7,2,3,66.7,0,0,0,1,2,50,3,6,9,0,1,1,0,1,5
437987,497_15_29,POLAND,15981,9,mateusz ponitka,32,5,11,45.5,5,9,55.6,0,2,0,0,0,0,1,2,3,1,1,3,1,0,10
437988,497_15_29,POLAND,8034,12,adam waczynski,30,6,11,54.5,2,4,50,4,7,57.1,2,2,100,0,1,1,2,0,1,1,0,18
437989,497_15_29,POLAND,1215,13,marcin gortat,28,5,11,45.5,5,10,50,0,1,0,0,2,0,3,8,11,2,2,4,0,1,10
437990,497_15_29,POLAND,1207,15,lukasz koszarek,14,2,5,40,2,3,66.7,0,2,0,0,0,0,0,1,1,3,0,0,1,0,4
437991,497_15_29,POLAND,24194,17,przemyslaw zamojski,10,0,1,0,0,0,0,0,1,0,3,3,100,0,1,1,0,1,1,0,0,3
437992,497_15_29,POLAND,12920,24,przemyslaw karnowski,12,1,4,25,1,3,33.3,0,1,0,1,2,50,1,2,3,2,2,1,1,0,3
437993,497_15_29,POLAND,6186,33,karol gruszecki,8,0,2,0,0,1,0,0,1,0,0,0,0,0,0,0,1,2,1,0,0,0
437994,497_15_29,POLAND,4799,66,robert skibniewski,0,0,0,0,0,0,0,0,0,0,0,0,0,0,0,0,0,0,0,0,0,0
437995,497_15_29,POLAND,0,TOTALS,POLAND,200,26,62,41.9,20,39,51.3,6,23,26.1,8,13,61.5,10,29,39,15,15,15,5,2,66
437996,497_15_30,UKRAINE,5790,4,maksym pustozvonov,27,2,4,50,2,4,50,0,0,0,0,0,0,2,5,7,1,1,3,0,0,4
437997,497_15_30,UKRAINE,29514,5,dzherom dzherri rendl,29,9,15,60,8,10,80,1,5,20,3,3,100,1,2,3,4,2,4,0,0,22
437998,497_15_30,UKRAINE,12946,6,olexandr mishula,24,3,11,27.3,0,0,0,3,11,27.3,2,2,100,0,1,1,1,3,2,0,0,11
437999,497_15_30,UKRAINE,2768,7,denys lukashov,11,0,4,0,0,2,0,0,2,0,0,0,0,0,0,0,2,2,2,0,0,0
438000,497_15_30,UKRAINE,2093,8,kyrylo fesenko,17,1,3,33.3,1,3,33.3,0,0,0,4,6,66.7,1,3,4,0,3,2,0,1,6
438001,497_15_30,UKRAINE,7927,9,oleksandr sizov,10,0,0,0,0,0,0,0,0,0,0,0,0,0,0,0,2,2,0,0,0,0
438002,497_15_30,UKRAINE,10714,10,stanislav tymofeyenko,20,0,2,0,0,1,0,0,1,0,3,4,75,1,4,5,0,2,2,0,1,3
438003,497_15_30,UKRAINE,10926,11,oleksandr lypovyy,20,2,4,50,1,2,50,1,2,50,2,2,100,1,2,3,0,4,1,0,0,7
438004,497_15_30,UKRAINE,5791,12,maxym korniyenko,20,2,8,25,2,8,25,0,0,0,4,7,57.1,3,2,5,2,3,1,2,1,8
438005,497_15_30,UKRAINE,10713,13,ihor zaytsev,23,2,5,40,1,3,33.3,1,2,50,5,5,100,1,2,3,1,4,1,0,0,10
438006,497_15_30,UKRAINE,19863,14,artem pustovyi,0,0,0,0,0,0,0,0,0,0,0,0,0,0,0,0,0,0,0,0,0,0
438007,497_15_30,UKRAINE,12945,15,pavlo krutous,0,0,0,0,0,0,0,0,0,0,0,0,0,0,0,0,0,0,0,0,0,0
438008,497_15_30,UKRAINE,0,TOTALS,UKRAINE,200,21,56,37.5,15,33,45.5,6,23,26.1,23,29,79.3,14,23,37,13,26,18,2,3,71
438009,497_15_30,ESTONIA,11295,4,rain veideman,33,5,13,38.5,4,8,50,1,5,20,4,4,100,0,6,6,6,2,1,2,0,15
438010,497_15_30,ESTONIA,1218,5,tanel sokk,0,0,0,0,0,0,0,0,0,0,0,0,0,0,0,0,0,0,0,0,0,0
438011,497_15_30,ESTONIA,1219,6,gert dorbek,0,0,0,0,0,0,0,0,0,0,0,0,0,0,0,0,0,0,0,0,0,0
438012,497_15_30,ESTONIA,2721,7,sten sokk,33,1,8,12.5,0,2,0,1,6,16.7,2,2,100,1,0,1,6,3,3,1,0,5
438013,497_15_30,ESTONIA,4625,8,janar talts,19,4,6,66.7,3,3,100,1,3,33.3,1,2,50,4,3,7,0,5,1,1,1,10
438014,497_15_30,ESTONIA,4622,9,gregor arbet,35,9,15,60,4,5,80,5,10,50,3,4,75,2,2,4,0,3,2,1,1,26
438015,497_15_30,ESTONIA,6373,10,erik keedus,0,0,0,0,0,0,0,0,0,0,0,0,0,0,0,0,0,0,0,0,0,0
438016,497_15_30,ESTONIA,6377,11,siim-sander vene,18,1,3,33.3,1,3,33.3,0,0,0,3,4,75,3,5,8,1,4,1,0,0,5
438017,497_15_30,ESTONIA,15312,13,joosep toome,22,1,6,16.7,0,2,0,1,4,25,0,0,0,2,1,3,0,4,2,1,1,3
438018,497_15_30,ESTONIA,4771,14,kristjan kangur,21,2,7,28.6,0,3,0,2,4,50,3,4,75,1,1,2,3,4,1,0,0,9
438019,497_15_30,ESTONIA,1229,15,reinar hallik,0,0,0,0,0,0,0,0,0,0,0,0,0,0,0,0,0,0,0,0,0,0
438020,497_15_30,ESTONIA,8047,20,tanel kurbas,19,2,5,40,2,4,50,0,1,0,1,2,50,1,1,2,2,1,0,0,0,5
438021,497_15_30,ESTONIA,0,TOTALS,ESTONIA,200,25,63,39.7,14,30,46.7,11,33,33.3,17,22,77.3,14,23,37,18,26,11,6,3,78
438022,497_15_31,SERBIA,5751,4,milos teodosic,16,2,6,33.3,2,3,66.7,0,3,0,0,0,0,0,1,1,6,2,2,0,0,4
438023,497_15_31,SERBIA,2100,5,marko simonovic,18,1,1,100,0,0,0,1,1,100,0,2,0,0,1,1,1,2,1,0,0,3
438024,497_15_31,SERBIA,29506,6,ognjen kuzmic,15,4,4,100,4,4,100,0,0,0,3,4,75,0,3,3,1,0,0,1,0,11
438025,497_15_31,SERBIA,17361,7,bogdan bogdanovic,20,2,6,33.3,0,0,0,2,6,33.3,3,4,75,0,7,7,6,0,1,1,0,9
438026,497_15_31,SERBIA,15386,8,nemanja bjelica,18,3,4,75,3,3,100,0,1,0,1,1,100,0,4,4,2,1,2,0,0,7
438027,497_15_31,SERBIA,2654,9,stefan markovic,20,1,2,50,1,1,100,0,1,0,0,0,0,1,4,5,2,2,1,2,0,2
438028,497_15_31,SERBIA,19860,10,nikola kalinic,24,4,5,80,1,2,50,3,3,100,1,2,50,1,2,3,5,2,3,1,1,12
438029,497_15_31,SERBIA,15503,11,nemanja nedovic,26,5,9,55.6,4,5,80,1,4,25,4,4,100,0,3,3,4,1,3,1,0,15
438030,497_15_31,SERBIA,15505,12,dragan milosavljevic,16,3,3,100,3,3,100,0,0,0,2,2,100,0,0,0,3,4,2,1,0,8
438031,497_15_31,SERBIA,2656,13,miroslav raduljica,16,6,8,75,6,8,75,0,0,0,1,2,50,1,2,3,2,1,4,0,0,13
438032,497_15_31,SERBIA,10253,14,zoran erceg,4,1,1,100,0,0,0,1,1,100,0,0,0,0,3,3,0,0,0,0,0,3
438033,497_15_31,SERBIA,17652,15,nikola milutinov,8,2,4,50,2,4,50,0,0,0,2,2,100,1,2,3,0,0,0,0,0,6
438034,497_15_31,SERBIA,0,TOTALS,SERBIA,200,34,53,64.2,26,33,78.8,8,20,40,17,23,73.9,5,35,40,32,15,21,7,1,93
438035,497_15_31,ICELAND,19926,3,martin hermannsson,17,3,7,42.9,3,5,60,0,2,0,0,0,0,3,2,5,1,3,1,0,0,6
438036,497_15_31,ICELAND,24208,4,axel karason,4,0,0,0,0,0,0,0,0,0,0,0,0,0,0,0,0,0,0,0,0,0
438037,497_15_31,ICELAND,15700,5,ragnar nathanaelsson,7,0,4,0,0,4,0,0,0,0,0,0,0,3,1,4,0,2,0,0,0,0
438038,497_15_31,ICELAND,4834,6,jakob sigurdarson,21,2,7,28.6,2,3,66.7,0,4,0,2,2,100,0,6,6,0,2,3,0,0,6
438039,497_15_31,ICELAND,4841,8,hlynur baeringsson,23,1,4,25,1,2,50,0,2,0,6,6,100,2,2,4,1,2,5,3,0,8
438040,497_15_31,ICELAND,4837,9,jon stefansson,18,1,5,20,0,3,0,1,2,50,0,0,0,0,0,0,4,1,0,1,0,3
438041,497_15_31,ICELAND,4840,10,helgi magnusson,11,1,5,20,0,0,0,1,5,20,0,0,0,0,1,1,1,2,0,0,0,3
438042,497_15_31,ICELAND,2764,13,hordur vilhjalmsson,18,4,10,40,4,7,57.1,0,3,0,1,2,50,1,0,1,0,2,0,0,0,9
438043,497_15_31,ICELAND,4980,14,logi gunnarsson,24,7,15,46.7,3,8,37.5,4,7,57.1,0,0,0,1,2,3,1,3,2,0,0,18
438044,497_15_31,ICELAND,2071,15,pavel ermolinskij,20,2,6,33.3,0,3,0,2,3,66.7,0,0,0,0,1,1,2,3,1,1,0,6
438045,497_15_31,ICELAND,13211,24,haukur palsson,30,1,5,20,1,2,50,0,3,0,1,2,50,0,2,2,4,4,1,1,1,3
438046,497_15_31,ICELAND,15702,29,aegir steinarsson,9,1,4,25,1,3,33.3,0,1,0,0,0,0,1,0,1,1,3,1,1,0,2
438047,497_15_31,ICELAND,0,TOTALS,ICELAND,200,23,72,31.9,15,40,37.5,8,32,25,10,12,83.3,13,17,30,15,27,15,7,1,64
438048,497_15_32,SLOVENIA,4655,1,nebojsa joksimovic,6,1,1,100,0,0,0,1,1,100,0,0,0,0,1,1,1,0,1,0,0,3
438049,497_15_32,SLOVENIA,13125,5,luka rupnik,0,0,0,0,0,0,0,0,0,0,0,0,0,0,0,0,0,0,0,0,0,0
438050,497_15_32,SLOVENIA,17343,7,klemen prepelic,27,4,6,66.7,1,1,100,3,5,60,5,6,83.3,1,1,2,6,3,0,2,0,16
438051,497_15_32,SLOVENIA,15479,9,jaka blazic,24,4,9,44.4,1,3,33.3,3,6,50,2,2,100,0,2,2,0,4,1,1,0,13
438052,497_15_32,SLOVENIA,8251,10,mitja nikolic,5,1,1,100,1,1,100,0,0,0,0,0,0,0,1,1,0,1,0,0,0,2
438053,497_15_32,SLOVENIA,6197,12,zoran dragic,31,5,10,50,4,5,80,1,5,20,2,2,100,2,4,6,5,3,4,1,0,13
438054,497_15_32,SLOVENIA,4764,13,miha zupan,10,1,3,33.3,0,2,0,1,1,100,0,0,0,1,0,1,3,1,1,0,0,3
438055,497_15_32,SLOVENIA,24203,15,jure balazic,18,3,8,37.5,2,4,50,1,4,25,0,0,0,2,0,2,1,4,0,0,0,7
438056,497_15_32,SLOVENIA,1069,17,sasa zagorac,13,0,4,0,0,0,0,0,4,0,0,0,0,0,0,0,0,5,2,2,0,0
438057,497_15_32,SLOVENIA,17344,23,alen omic,24,3,7,42.9,3,7,42.9,0,0,0,5,5,100,3,4,7,0,2,1,0,0,11
438058,497_15_32,SLOVENIA,5782,24,jaka klobucar,28,3,6,50,3,3,100,0,3,0,3,3,100,0,6,6,1,3,2,1,0,9
438059,497_15_32,SLOVENIA,5023,55,uros slokar,15,2,5,40,2,3,66.7,0,2,0,0,1,0,0,1,1,3,5,0,0,0,4
438060,497_15_32,SLOVENIA,0,TOTALS,SLOVENIA,200,27,60,45,17,29,58.6,10,31,32.3,17,19,89.5,10,21,31,20,31,12,7,0,81
438061,497_15_32,NETHERLANDS,20407,0,yannick franke,0,0,0,0,0,0,0,0,0,0,0,0,0,0,0,0,0,0,0,0,0,0
438062,497_15_32,NETHERLANDS,15661,5,leon williams,13,0,0,0,0,0,0,0,0,0,0,0,0,0,1,1,1,3,2,0,0,0
438063,497_15_32,NETHERLANDS,24213,6,worthy de jong,31,6,6,100,5,5,100,1,1,100,6,6,100,1,5,6,1,1,4,2,0,19
438064,497_15_32,NETHERLANDS,15520,7,charlon kloof,30,6,12,50,3,9,33.3,3,3,100,10,13,76.9,1,5,6,4,4,4,1,0,25
438065,497_15_32,NETHERLANDS,10671,9,mohamed kherrazi,14,0,3,0,0,3,0,0,0,0,0,0,0,0,0,0,0,4,1,1,0,0
438066,497_15_32,NETHERLANDS,12501,10,ralf de pagter,0,0,0,0,0,0,0,0,0,0,0,0,0,0,0,0,0,0,0,0,0,0
438067,497_15_32,NETHERLANDS,29501,12,kees akerboom,19,1,3,33.3,1,2,50,0,1,0,0,0,0,0,0,0,0,2,0,0,0,2
438068,497_15_32,NETHERLANDS,2871,13,roeland schaftenaar,22,1,6,16.7,1,3,33.3,0,3,0,0,0,0,1,2,3,0,1,2,0,0,2
438069,497_15_32,NETHERLANDS,7480,18,nicolas de jong,21,2,3,66.7,2,3,66.7,0,0,0,2,4,50,0,5,5,0,4,1,0,0,6
438070,497_15_32,NETHERLANDS,5809,21,robin smeulders,21,5,7,71.4,5,7,71.4,0,0,0,4,8,50,2,0,2,0,4,1,1,0,14
438071,497_15_32,NETHERLANDS,5810,23,henk norel,9,3,4,75,3,4,75,0,0,0,0,0,0,1,1,2,0,0,0,0,0,6
438072,497_15_32,NETHERLANDS,10202,44,arvin slagter,20,0,5,0,0,4,0,0,1,0,0,0,0,0,1,1,2,1,1,0,0,0
438073,497_15_32,NETHERLANDS,0,TOTALS,NETHERLANDS,200,24,49,49,20,40,50,4,9,44.4,22,31,71,8,22,30,8,24,16,5,0,74
438074,497_15_33,GERMANY,29499,4,maodo lo,17,3,9,33.3,2,4,50,1,5,20,0,0,0,1,2,3,0,2,1,0,1,7
438075,497_15_33,GERMANY,8235,5,niels giffey,17,1,4,25,1,3,33.3,0,1,0,0,0,0,0,3,3,1,3,0,0,0,2
438076,497_15_33,GERMANY,1192,7,alex king,1,0,0,0,0,0,0,0,0,0,0,0,0,0,0,0,0,0,0,0,0,0
438077,497_15_33,GERMANY,15385,8,heiko schaffartzik,19,1,5,20,0,0,0,1,5,20,0,0,0,2,2,4,4,4,0,0,0,3
438078,497_15_33,GERMANY,10446,9,karsten tadda,5,0,0,0,0,0,0,0,0,0,0,0,0,0,0,0,0,0,0,0,0,0
438079,497_15_33,GERMANY,10637,11,tibor pleiss,14,3,5,60,3,5,60,0,0,0,1,1,100,1,3,4,0,4,0,0,1,7
438080,497_15_33,GERMANY,6326,12,robin benzing,24,3,8,37.5,2,2,100,1,6,16.7,6,6,100,1,2,3,0,3,0,1,0,13
438081,497_15_33,GERMANY,4711,14,dirk nowitzki,24,3,10,30,2,7,28.6,1,3,33.3,8,8,100,1,4,5,2,2,0,0,0,15
438082,497_15_33,GERMANY,19990,17,dennis schroder,28,7,18,38.9,6,13,46.2,1,5,20,9,10,90,0,5,5,6,3,5,0,0,24
438083,497_15_33,GERMANY,29500,21,paul zipser,17,0,1,0,0,1,0,0,0,0,0,0,0,0,2,2,1,2,1,0,1,0
438084,497_15_33,GERMANY,1152,25,anton gavel,17,0,2,0,0,1,0,0,1,0,0,0,0,0,3,3,0,1,2,0,0,0
438085,497_15_33,GERMANY,19867,77,johannes voigtmann,17,1,2,50,1,2,50,0,0,0,2,2,100,2,1,3,0,3,0,1,0,4
438086,497_15_33,GERMANY,0,TOTALS,GERMANY,200,22,64,34.4,17,38,44.7,5,26,19.2,26,27,96.3,13,29,42,14,27,9,2,3,75
438087,497_15_33,TURKEY,20222,4,kartal ozmizrak,0,0,0,0,0,0,0,0,0,0,0,0,0,0,0,0,0,0,0,0,0,0
438088,497_15_33,TURKEY,15304,5,sinan guler,32,3,7,42.9,1,4,25,2,3,66.7,3,4,75,0,2,2,3,4,0,1,0,11
438089,497_15_33,TURKEY,20219,6,cedi osman,31,5,8,62.5,3,4,75,2,4,50,5,7,71.4,1,4,5,1,3,0,0,0,17
438090,497_15_33,TURKEY,2576,7,baris hersek,0,0,0,0,0,0,0,0,0,0,0,0,0,0,0,0,0,0,0,0,0,0
438091,497_15_33,TURKEY,1802,8,ersan ilyasova,36,5,14,35.7,4,11,36.4,1,3,33.3,4,4,100,0,4,4,1,4,1,1,0,15
438092,497_15_33,TURKEY,1797,9,semih erden,31,7,11,63.6,7,11,63.6,0,0,0,2,4,50,2,7,9,4,3,2,0,4,16
438093,497_15_33,TURKEY,8151,10,melih mahmutoglu,18,2,6,33.3,2,3,66.7,0,3,0,2,2,100,0,2,2,0,1,2,0,0,6
438094,497_15_33,TURKEY,1796,11,oguz savas,0,0,0,0,0,0,0,0,0,0,0,0,0,0,0,0,0,0,0,0,0,0
438095,497_15_33,TURKEY,24656,12,furkan korkmaz,0,0,0,0,0,0,0,0,0,0,0,0,0,0,0,0,0,0,0,0,0,0
438096,497_15_33,TURKEY,29512,13,ali muhammed,36,5,13,38.5,1,6,16.7,4,7,57.1,1,2,50,0,5,5,5,4,1,3,0,15
438097,497_15_33,TURKEY,17253,14,huseyin koksal,9,0,0,0,0,0,0,0,0,0,0,2,0,1,1,2,0,3,0,0,1,0
438098,497_15_33,TURKEY,10942,15,furkan aldemir,7,0,1,0,0,1,0,0,0,0,0,0,0,1,1,2,0,2,1,1,0,0
438099,497_15_33,TURKEY,0,TOTALS,TURKEY,200,27,60,45,18,40,45,9,20,45,17,25,68,8,27,35,14,25,7,6,5,80
438100,497_15_34,GEORGIA,24223,0,jacob everse pullen,17,2,7,28.6,2,4,50,0,3,0,0,0,0,0,0,0,2,2,1,1,0,4
438101,497_15_34,GEORGIA,8378,4,nika metreveli,0,0,0,0,0,0,0,0,0,0,0,0,0,0,0,0,0,0,0,0,0,0
438102,497_15_34,GEORGIA,4919,7,zaza pachulia,21,2,8,25,2,8,25,0,0,0,0,0,0,0,2,2,5,4,5,3,0,4
438103,497_15_34,GEORGIA,1690,8,george tsintsadze,29,2,5,40,1,1,100,1,4,25,0,0,0,0,2,2,3,2,6,0,0,5
438104,497_15_34,GEORGIA,6436,9,giorgi shermadini,19,3,3,100,3,3,100,0,0,0,3,4,75,0,3,3,0,1,2,1,0,9
438105,497_15_34,GEORGIA,15684,10,duda sanadze,12,1,4,25,1,3,33.3,0,1,0,0,0,0,0,0,0,4,2,0,0,0,2
438106,497_15_34,GEORGIA,1697,11,manuchar markoishvili,27,4,7,57.1,1,3,33.3,3,4,75,0,0,0,0,2,2,0,3,2,2,1,11
438107,497_15_34,GEORGIA,12467,12,levan patsatsia,4,0,1,0,0,1,0,0,0,0,0,0,0,0,0,0,1,1,0,0,0,0
438108,497_15_34,GEORGIA,1699,13,viktor sanikidze,30,3,4,75,2,3,66.7,1,1,100,3,4,75,0,6,6,2,2,0,0,0,10
438109,497_15_34,GEORGIA,16022,15,beka burjanadze,8,1,2,50,0,1,0,1,1,100,0,0,0,0,0,0,0,0,0,0,0,3
438110,497_15_34,GEORGIA,11036,23,tornike shengelia,33,9,13,69.2,8,12,66.7,1,1,100,1,4,25,2,6,8,2,3,1,1,0,20
438111,497_15_34,GEORGIA,1693,25,besik lezhava,0,0,0,0,0,0,0,0,0,0,0,0,0,0,0,0,0,0,0,0,0,0
438112,497_15_34,GEORGIA,0,TOTALS,GEORGIA,200,27,54,50,20,39,51.3,7,15,46.7,7,12,58.3,5,22,27,19,20,17,8,1,68
438113,497_15_34,GREECE,5050,5,yannis bourousis,17,1,3,33.3,1,3,33.3,0,0,0,2,4,50,1,4,5,1,2,2,0,0,4
438114,497_15_34,GREECE,123,6,nikos zisis,15,5,9,55.6,4,7,57.1,1,2,50,0,0,0,1,1,2,1,1,1,1,0,11
438115,497_15_34,GREECE,125,7,vassilis spanoulis,20,0,0,0,0,0,0,0,0,0,2,2,100,0,2,2,5,2,5,0,1,2
438116,497_15_34,GREECE,12472,8,nick calathes,24,7,11,63.6,3,5,60,4,6,66.7,1,2,50,0,2,2,8,1,1,0,0,19
438117,497_15_34,GREECE,1057,9,stratos perperoglou,0,0,0,0,0,0,0,0,0,0,0,0,0,0,0,0,0,0,0,0,0,0
438118,497_15_34,GREECE,8304,10,kostas sloukas,18,1,2,50,1,1,100,0,1,0,1,2,50,0,3,3,5,0,2,0,0,3
438119,497_15_34,GREECE,15374,12,kostas kaimakoglou,20,3,3,100,1,1,100,2,2,100,0,2,0,1,1,2,0,2,0,1,0,8
438120,497_15_34,GREECE,10607,13,kostas koufos,23,5,10,50,5,10,50,0,0,0,2,3,66.7,2,2,4,1,4,0,0,0,12
438121,497_15_34,GREECE,1056,15,georgios printezis,17,1,3,33.3,0,2,0,1,1,100,0,0,0,0,2,2,4,1,1,0,1,3
438122,497_15_34,GREECE,10606,16,kostas papanikolaou,15,2,4,50,2,3,66.7,0,1,0,1,2,50,0,2,2,2,1,1,0,1,5
438123,497_15_34,GREECE,8303,17,evangelos mantzaris,3,0,0,0,0,0,0,0,0,0,0,0,0,0,0,0,0,0,0,0,0,0
438124,497_15_34,GREECE,24314,34,giannis antetokounmpo,28,5,9,55.6,3,5,60,2,4,50,0,0,0,0,3,3,1,3,1,0,2,12
438125,497_15_34,GREECE,0,TOTALS,GREECE,200,30,54,55.6,20,37,54.1,10,17,58.8,9,17,52.9,5,23,28,28,17,14,2,5,79
438126,497_15_35,SPAIN,61,4,pau gasol,32,10,17,58.8,10,16,62.5,0,1,0,14,16,87.5,3,7,10,5,2,0,0,1,34
438127,497_15_35,SPAIN,70,5,rudy fernandez,33,3,8,37.5,2,6,33.3,1,2,50,0,0,0,3,3,6,4,3,1,0,0,7
438128,497_15_35,SPAIN,1877,6,sergio rodriguez,26,2,8,25,2,4,50,0,4,0,0,0,0,0,1,1,4,2,1,0,0,4
438129,497_15_35,SPAIN,17609,7,guillermo hernangomez,5,3,3,100,3,3,100,0,0,0,0,0,0,0,0,0,0,2,1,0,1,6
438130,497_15_35,SPAIN,5713,8,pau ribas tossas,24,3,4,75,1,1,100,2,3,66.7,0,0,0,0,2,2,0,2,0,0,0,8
438131,497_15_35,SPAIN,66,9,felipe reyes,14,2,4,50,2,4,50,0,0,0,5,5,100,1,2,3,1,4,2,0,0,9
438132,497_15_35,SPAIN,2628,10,victor claver,0,0,0,0,0,0,0,0,0,0,0,0,0,0,0,0,0,0,0,0,0,0
438133,497_15_35,SPAIN,1317,11,fernando san emeterio,16,3,3,100,2,2,100,1,1,100,1,1,100,0,0,0,1,5,0,0,0,8
438134,497_15_35,SPAIN,1871,12,sergio llull,28,3,9,33.3,2,4,50,1,5,20,2,2,100,0,2,2,9,4,2,0,0,9
438135,497_15_35,SPAIN,6265,13,pablo aguilar,0,0,0,0,0,0,0,0,0,0,0,0,0,0,0,0,0,0,0,0,0,0
438136,497_15_35,SPAIN,17234,14,nikola mirotic,22,5,7,71.4,4,5,80,1,2,50,2,3,66.7,1,5,6,1,3,1,0,0,13
438137,497_15_35,SPAIN,19987,15,guillem vives,0,0,0,0,0,0,0,0,0,0,0,0,0,0,0,0,0,0,0,0,0,0
438138,497_15_35,SPAIN,0,TOTALS,SPAIN,200,34,63,54,28,45,62.2,6,18,33.3,24,27,88.9,9,24,33,25,27,8,0,2,98
438139,497_15_35,ITALY,20021,0,amedeo della valle,0,0,0,0,0,0,0,0,0,0,0,0,0,0,0,0,0,0,0,0,0,0
438140,497_15_35,ITALY,1272,3,marco belinelli,35,8,16,50,1,7,14.3,7,9,77.8,4,4,100,2,2,4,7,2,2,0,0,27
438141,497_15_35,ITALY,7944,4,pietro aradori,18,2,4,50,2,3,66.7,0,1,0,7,9,77.8,0,0,0,2,2,1,1,0,11
438142,497_15_35,ITALY,12988,5,alessandro gentile,28,5,11,45.5,4,7,57.1,1,4,25,2,3,66.7,3,3,6,2,4,0,1,0,13
438143,497_15_35,ITALY,2667,8,danilo gallinari,36,7,12,58.3,5,7,71.4,2,5,40,13,14,92.9,1,7,8,6,1,0,0,1,29
438144,497_15_35,ITALY,1270,9,andrea bargnani,24,8,13,61.5,7,10,70,1,3,33.3,1,1,100,0,3,3,0,5,0,1,0,18
438145,497_15_35,ITALY,15319,12,marco cusin,13,1,1,100,1,1,100,0,0,0,1,1,100,0,2,2,2,5,0,0,1,3
438146,497_15_35,ITALY,1861,13,luigi datome,0,0,0,0,0,0,0,0,0,0,0,0,0,0,0,0,0,0,0,0,0,0
438147,497_15_35,ITALY,10968,17,nicolo melli,5,1,1,100,1,1,100,0,0,0,2,2,100,1,1,2,0,3,0,0,0,4
438148,497_15_35,ITALY,19752,20,andrea cinciarini,23,0,2,0,0,1,0,0,1,0,0,0,0,0,1,1,2,3,0,0,0,0
438149,497_15_35,ITALY,10444,23,daniel hackett,19,0,4,0,0,3,0,0,1,0,0,0,0,0,1,1,3,1,0,0,0,0
438150,497_15_35,ITALY,15644,33,achille polonara,0,0,0,0,0,0,0,0,0,0,0,0,0,0,0,0,0,0,0,0,0,0
438151,497_15_35,ITALY,0,TOTALS,ITALY,200,32,64,50,21,40,52.5,11,24,45.8,30,34,88.2,9,20,29,24,26,3,3,2,105
438152,497_15_36,CROATIA,1844,4,ante tomic,21,4,5,80,4,5,80,0,0,0,2,4,50,4,5,9,2,2,2,1,1,10
438153,497_15_36,CROATIA,1846,5,damjan rudez,11,0,5,0,0,2,0,0,3,0,0,0,0,0,1,1,0,0,0,0,0,0
438154,497_15_36,CROATIA,1915,6,rok stipcevic,33,2,9,22.2,0,3,0,2,6,33.3,1,2,50,0,0,0,2,3,0,1,0,7
438155,497_15_36,CROATIA,6280,7,bojan bogdanovic,23,5,11,45.5,4,7,57.1,1,4,25,2,2,100,1,5,6,3,2,0,1,0,13
438156,497_15_36,CROATIA,15894,8,dario saric,29,5,8,62.5,5,6,83.3,0,2,0,5,6,83.3,1,6,7,4,2,2,1,1,15
438157,497_15_36,CROATIA,1251,9,marko tomas,0,0,0,0,0,0,0,0,0,0,0,0,0,0,0,0,0,0,0,0,0,0
438158,497_15_36,CROATIA,4585,10,roko ukic,23,3,8,37.5,2,4,50,1,4,25,0,0,0,2,1,3,2,2,0,0,0,7
438159,497_15_36,CROATIA,1249,11,krunoslav simon,24,4,8,50,2,5,40,2,3,66.7,2,2,100,0,4,4,5,0,2,1,0,12
438160,497_15_36,CROATIA,18342,13,dontaye draper,5,0,0,0,0,0,0,0,0,0,0,0,0,0,1,1,0,0,1,1,0,0
438161,497_15_36,CROATIA,10624,15,miro bilan,4,0,1,0,0,1,0,0,0,0,0,0,0,0,1,1,0,1,2,0,0,0
438162,497_15_36,CROATIA,16607,21,luka zoric,16,3,7,42.9,3,7,42.9,0,0,0,2,2,100,4,2,6,0,1,1,0,0,8
438163,497_15_36,CROATIA,18415,23,mario hezonja,11,0,2,0,0,0,0,0,2,0,1,2,50,1,1,2,3,2,0,1,0,1
438164,497_15_36,CROATIA,0,TOTALS,CROATIA,200,26,64,40.6,20,40,50,6,24,25,15,20,75,13,29,42,21,15,10,7,2,73
438165,497_15_36,MKD,6306,4,vladimir brckov,2,0,0,0,0,0,0,0,0,0,0,0,0,0,1,1,0,0,0,0,0,0
438166,497_15_36,MKD,10169,5,vlado ilievski,27,2,5,40,0,1,0,2,4,50,1,2,50,0,2,2,3,2,2,0,1,7
438167,497_15_36,MKD,7810,6,darko sokolov,3,0,0,0,0,0,0,0,0,0,0,0,0,1,0,1,0,1,1,0,0,0
438168,497_15_36,MKD,2709,7,aleksandar kostoski,25,1,5,20,0,0,0,1,5,20,0,0,0,0,3,3,2,0,2,0,0,3
438169,497_15_36,MKD,5892,8,vojdan stojanovski,26,4,9,44.4,3,6,50,1,3,33.3,0,0,0,0,3,3,3,3,3,0,0,9
438170,497_15_36,MKD,5892,9,damjan stojanovski,16,2,3,66.7,0,0,0,2,3,66.7,3,4,75,0,4,4,1,4,1,0,0,9
438171,497_15_36,MKD,6300,10,marko simonovski,20,2,5,40,1,1,100,1,4,25,0,0,0,0,2,2,0,1,1,0,1,5
438172,497_15_36,MKD,20507,11,ljubomir mladenovski,2,1,1,100,1,1,100,0,0,0,0,0,0,1,1,2,0,0,0,0,0,2
438173,497_15_36,MKD,2714,12,bojan trajkovski,22,2,9,22.2,1,5,20,1,4,25,0,0,0,0,3,3,0,4,0,1,1,5
438174,497_15_36,MKD,11275,13,stojan gjuroski,12,2,5,40,1,2,50,1,3,33.3,0,0,0,1,0,1,0,1,2,0,0,5
438175,497_15_36,MKD,29507,14,richard hendrix,22,0,5,0,0,5,0,0,0,0,0,0,0,2,4,6,3,4,2,0,1,0
438176,497_15_36,MKD,5010,15,predrag samardziski,23,5,10,50,5,10,50,0,0,0,0,0,0,3,2,5,1,3,1,0,1,10
438177,497_15_36,MKD,0,TOTALS,MKD,200,21,57,36.8,12,31,38.7,9,26,34.6,4,6,66.7,8,25,33,13,23,16,1,5,55
438178,497_15_37,TURKEY,20222,4,kartal ozmizrak,5,0,1,0,0,1,0,0,0,0,0,0,0,0,1,1,2,0,0,0,0,0
438179,497_15_37,TURKEY,15304,5,sinan guler,25,3,4,75,2,3,66.7,1,1,100,1,2,50,1,0,1,6,3,3,0,0,8
438180,497_15_37,TURKEY,20219,6,cedi osman,31,4,11,36.4,3,7,42.9,1,4,25,2,4,50,5,4,9,1,2,0,1,1,11
438181,497_15_37,TURKEY,2576,7,baris hersek,8,0,1,0,0,1,0,0,0,0,0,0,0,0,1,1,0,1,0,0,0,0
438182,497_15_37,TURKEY,1802,8,ersan ilyasova,25,5,9,55.6,4,6,66.7,1,3,33.3,0,0,0,2,2,4,0,4,3,0,2,11
438183,497_15_37,TURKEY,1797,9,semih erden,22,6,7,85.7,6,7,85.7,0,0,0,2,2,100,1,2,3,1,3,2,1,0,14
438184,497_15_37,TURKEY,8151,10,melih mahmutoglu,22,1,9,11.1,1,2,50,0,7,0,0,0,0,0,3,3,3,0,1,0,0,2
438185,497_15_37,TURKEY,1796,11,oguz savas,12,2,3,66.7,2,3,66.7,0,0,0,6,7,85.7,0,3,3,0,3,1,1,0,10
438186,497_15_37,TURKEY,24656,12,furkan korkmaz,5,0,1,0,0,0,0,0,1,0,0,0,0,2,1,3,0,0,1,0,0,0
438187,497_15_37,TURKEY,29512,13,ali muhammed,30,7,15,46.7,5,7,71.4,2,8,25,0,0,0,0,2,2,4,2,2,0,0,16
438188,497_15_37,TURKEY,17253,14,huseyin koksal,9,0,0,0,0,0,0,0,0,0,0,0,0,0,1,1,1,2,1,0,0,0
438189,497_15_37,TURKEY,10942,15,furkan aldemir,6,0,0,0,0,0,0,0,0,0,0,0,0,0,0,0,0,1,0,0,0,0
438190,497_15_37,TURKEY,0,TOTALS,TURKEY,200,28,61,45.9,23,37,62.2,5,24,20.8,11,15,73.3,12,20,32,18,21,15,3,3,72
438191,497_15_37,SERBIA,5751,4,milos teodosic,30,6,13,46.2,3,5,60,3,8,37.5,2,2,100,1,2,3,13,2,0,1,0,17
438192,497_15_37,SERBIA,2100,5,marko simonovic,7,0,4,0,0,1,0,0,3,0,1,2,50,0,2,2,0,0,0,0,0,1
438193,497_15_37,SERBIA,29506,6,ognjen kuzmic,17,1,2,50,1,2,50,0,0,0,4,4,100,2,4,6,1,3,0,0,0,6
438194,497_15_37,SERBIA,17361,7,bogdan bogdanovic,19,2,7,28.6,2,3,66.7,0,4,0,1,2,50,1,3,4,2,2,2,0,0,5
438195,497_15_37,SERBIA,15386,8,nemanja bjelica,23,3,5,60,3,5,60,0,0,0,2,2,100,0,1,1,2,0,3,1,0,8
438196,497_15_37,SERBIA,2654,9,stefan markovic,25,2,6,33.3,0,1,0,2,5,40,0,0,0,2,0,2,3,2,1,1,0,6
438197,497_15_37,SERBIA,19860,10,nikola kalinic,25,5,6,83.3,2,3,66.7,3,3,100,2,5,40,0,2,2,4,4,1,3,0,15
438198,497_15_37,SERBIA,15503,11,nemanja nedovic,16,3,4,75,2,2,100,1,2,50,0,0,0,0,1,1,2,3,0,2,0,7
438199,497_15_37,SERBIA,15505,12,dragan milosavljevic,8,0,0,0,0,0,0,0,0,0,0,0,0,0,0,0,1,1,1,1,0,0
438200,497_15_37,SERBIA,2656,13,miroslav raduljica,18,9,12,75,9,12,75,0,0,0,2,4,50,2,4,6,0,3,0,0,0,20
438201,497_15_37,SERBIA,10253,14,zoran erceg,9,1,2,50,1,1,100,0,1,0,2,2,100,2,0,2,0,1,0,0,0,4
438202,497_15_37,SERBIA,17652,15,nikola milutinov,3,1,3,33.3,1,3,33.3,0,0,0,0,0,0,2,0,2,0,0,0,0,1,2
438203,497_15_37,SERBIA,0,TOTALS,SERBIA,200,33,64,51.6,24,38,63.2,9,26,34.6,16,23,69.6,14,21,35,28,21,8,9,1,91
438204,497_15_38,BOSNIA AND HERZEGOVINA,5859,4,muhamed pasalic,3,0,0,0,0,0,0,0,0,0,1,2,50,0,0,0,0,1,1,0,0,1
438205,497_15_38,BOSNIA AND HERZEGOVINA,20566,5,nedim buza,0,0,0,0,0,0,0,0,0,0,0,0,0,0,0,0,0,0,0,0,0,0
438206,497_15_38,BOSNIA AND HERZEGOVINA,7780,6,andrija stipanovic,26,2,4,50,2,4,50,0,0,0,2,4,50,0,5,5,2,2,3,1,0,6
438207,497_15_38,BOSNIA AND HERZEGOVINA,24189,7,marko sutalo,21,1,3,33.3,1,2,50,0,1,0,0,0,0,1,3,4,1,2,0,0,0,2
438208,497_15_38,BOSNIA AND HERZEGOVINA,5026,9,edin bavcic,12,0,1,0,0,1,0,0,0,0,1,2,50,1,2,3,0,2,1,0,1,1
438209,497_15_38,BOSNIA AND HERZEGOVINA,2887,10,nemanja gordic,24,3,11,27.3,2,6,33.3,1,5,20,0,0,0,0,1,1,0,1,2,0,0,7
438210,497_15_38,BOSNIA AND HERZEGOVINA,2891,11,elmedin kikanovic,20,4,6,66.7,4,6,66.7,0,0,0,5,7,71.4,3,2,5,2,2,2,0,0,13
438211,497_15_38,BOSNIA AND HERZEGOVINA,24191,13,dalibor persic,19,2,6,33.3,1,1,100,1,5,20,2,2,100,1,0,1,1,1,2,0,0,7
438212,497_15_38,BOSNIA AND HERZEGOVINA,15282,15,milan milosevic,15,0,2,0,0,2,0,0,0,0,1,2,50,0,4,4,0,1,0,0,0,1
438213,497_15_38,BOSNIA AND HERZEGOVINA,29497,20,alex renfroe,24,2,6,33.3,2,4,50,0,2,0,0,0,0,0,1,1,6,1,5,1,0,4
438214,497_15_38,BOSNIA AND HERZEGOVINA,17436,23,adin vrabac,15,1,1,100,1,1,100,0,0,0,1,2,50,0,3,3,2,4,1,0,0,3
438215,497_15_38,BOSNIA AND HERZEGOVINA,29498,30,drasko albijanic,22,7,10,70,7,9,77.8,0,1,0,0,0,0,0,0,0,0,1,2,1,0,14
438216,497_15_38,BOSNIA AND HERZEGOVINA,0,TOTALS,BOSNIA AND HERZEGOVINA,200,22,50,44,20,36,55.6,2,14,14.3,13,21,61.9,8,24,32,14,18,21,3,1,59
438217,497_15_38,FINLAND,1834,4,mikko koivisto,11,0,3,0,0,1,0,0,2,0,0,0,0,0,0,0,1,1,0,0,0,0
438218,497_15_38,FINLAND,1314,7,shawn huff,19,1,4,25,0,1,0,1,3,33.3,3,3,100,0,1,1,0,1,2,1,0,6
438219,497_15_38,FINLAND,1836,8,gerald lee,20,4,7,57.1,4,7,57.1,0,0,0,2,2,100,2,2,4,3,3,3,0,0,10
438220,497_15_38,FINLAND,11129,9,sasu salin,23,1,6,16.7,0,2,0,1,4,25,2,2,100,1,3,4,2,0,1,3,0,5
438221,497_15_38,FINLAND,4932,10,tuukka kotti,18,4,5,80,4,5,80,0,0,0,0,0,0,0,1,1,0,2,0,1,0,8
438222,497_15_38,FINLAND,2802,11,petteri koponen,23,5,10,50,2,5,40,3,5,60,1,2,50,0,3,3,6,2,1,0,0,14
438223,497_15_38,FINLAND,8436,12,matti nuutinen,20,5,8,62.5,2,4,50,3,4,75,0,0,0,4,4,8,1,1,0,1,0,13
438224,497_15_38,FINLAND,24222,21,ville kaunisto,13,2,2,100,1,1,100,1,1,100,0,0,0,2,1,3,1,4,1,1,0,5
438225,497_15_38,FINLAND,29510,24,joonas caven,2,0,0,0,0,0,0,0,0,0,0,0,0,0,1,1,0,1,1,0,0,0
438226,497_15_38,FINLAND,8428,30,roope ahonen,2,0,1,0,0,0,0,0,1,0,0,0,0,0,0,0,0,2,0,0,0,0
438227,497_15_38,FINLAND,29511,31,jamar wilson,21,7,14,50,5,12,41.7,2,2,100,0,0,0,1,0,1,4,2,1,3,0,16
438228,497_15_38,FINLAND,25454,33,erik jay murphy,28,5,11,45.5,4,5,80,1,6,16.7,0,0,0,1,5,6,4,2,0,0,1,11
438229,497_15_38,FINLAND,0,TOTALS,FINLAND,200,34,71,47.9,22,43,51.2,12,28,42.9,8,9,88.9,12,21,33,22,21,10,10,1,88
438230,497_15_39,GREECE,5050,5,yannis bourousis,20,5,8,62.5,5,7,71.4,0,1,0,1,1,100,4,4,8,2,4,2,0,0,11
438231,497_15_39,GREECE,123,6,nikos zisis,27,4,6,66.7,3,4,75,1,2,50,1,2,50,0,4,4,3,2,0,0,0,10
438232,497_15_39,GREECE,125,7,vassilis spanoulis,31,7,10,70,4,6,66.7,3,4,75,2,5,40,0,2,2,6,1,5,1,0,19
438233,497_15_39,GREECE,12472,8,nick calathes,32,3,5,60,3,5,60,0,0,0,6,6,100,0,2,2,3,2,1,0,0,12
438234,497_15_39,GREECE,1057,9,stratos perperoglou,8,1,3,33.3,1,2,50,0,1,0,0,0,0,0,1,1,0,2,1,0,0,2
438235,497_15_39,GREECE,8304,10,kostas sloukas,9,0,0,0,0,0,0,0,0,0,0,2,0,0,1,1,3,3,1,0,0,0
438236,497_15_39,GREECE,15374,12,kostas kaimakoglou,11,0,0,0,0,0,0,0,0,0,0,0,0,0,3,3,2,1,1,0,0,0
438237,497_15_39,GREECE,10607,13,kostas koufos,21,5,7,71.4,5,7,71.4,0,0,0,0,0,0,3,1,4,0,2,1,0,2,10
438238,497_15_39,GREECE,1056,15,georgios printezis,27,6,8,75,5,6,83.3,1,2,50,3,4,75,1,2,3,1,2,1,0,0,16
438239,497_15_39,GREECE,10606,16,kostas papanikolaou,0,0,0,0,0,0,0,0,0,0,0,0,0,0,0,0,0,0,0,0,0,0
438240,497_15_39,GREECE,8303,17,evangelos mantzaris,0,0,0,0,0,0,0,0,0,0,0,0,0,0,0,0,0,0,0,0,0,0
438241,497_15_39,GREECE,24314,34,giannis antetokounmpo,14,1,5,20,1,2,50,0,3,0,1,2,50,0,2,2,1,3,0,1,1,3
438242,497_15_39,GREECE,0,TOTALS,GREECE,200,32,52,61.5,27,39,69.2,5,13,38.5,14,22,63.6,10,23,33,21,22,14,2,3,83
438243,497_15_39,SLOVENIA,4655,1,nebojsa joksimovic,4,1,2,50,1,2,50,0,0,0,0,0,0,0,0,0,1,1,0,0,0,2
438244,497_15_39,SLOVENIA,13125,5,luka rupnik,0,0,0,0,0,0,0,0,0,0,0,0,0,0,0,0,0,0,0,0,0,0
438245,497_15_39,SLOVENIA,17343,7,klemen prepelic,21,0,4,0,0,1,0,0,3,0,1,2,50,0,3,3,4,4,1,0,0,1
438246,497_15_39,SLOVENIA,15479,9,jaka blazic,30,9,12,75,5,7,71.4,4,5,80,5,6,83.3,2,3,5,2,3,3,0,0,27
438247,497_15_39,SLOVENIA,8251,10,mitja nikolic,3,0,0,0,0,0,0,0,0,0,0,0,0,0,0,0,0,1,0,0,0,0
438248,497_15_39,SLOVENIA,6197,12,zoran dragic,37,9,20,45,7,15,46.7,2,5,40,2,5,40,0,3,3,0,3,2,1,0,22
438249,497_15_39,SLOVENIA,4764,13,miha zupan,11,2,3,66.7,2,2,100,0,1,0,1,1,100,0,0,0,1,4,0,1,0,5
438250,497_15_39,SLOVENIA,24203,15,jure balazic,18,0,3,0,0,2,0,0,1,0,2,2,100,0,0,0,0,3,0,0,0,2
438251,497_15_39,SLOVENIA,1069,17,sasa zagorac,0,0,0,0,0,0,0,0,0,0,0,0,0,0,0,0,0,0,0,0,0,0
438252,497_15_39,SLOVENIA,17344,23,alen omic,16,2,2,100,2,2,100,0,0,0,0,0,0,1,2,3,2,2,2,0,0,4
438253,497_15_39,SLOVENIA,5782,24,jaka klobucar,28,1,6,16.7,1,3,33.3,0,3,0,0,0,0,0,1,1,2,3,2,0,0,2
438254,497_15_39,SLOVENIA,5023,55,uros slokar,32,3,6,50,2,4,50,1,2,50,0,0,0,1,1,2,1,1,0,0,0,7
438255,497_15_39,SLOVENIA,0,TOTALS,SLOVENIA,200,27,58,46.6,20,38,52.6,7,20,35,11,16,68.8,9,14,23,13,25,11,2,0,72
438256,497_15_40,BELGIUM,10156,4,lionel bosco,13,2,4,50,2,3,66.7,0,1,0,3,4,75,1,1,2,5,1,1,1,0,7
438257,497_15_40,BELGIUM,2003,5,sam van rossom,29,3,10,30,2,6,33.3,1,4,25,0,0,0,2,3,5,7,2,1,0,1,7
438258,497_15_40,BELGIUM,4548,7,axel hervelle,21,2,2,100,2,2,100,0,0,0,1,2,50,0,9,9,1,4,4,1,0,5
438259,497_15_40,BELGIUM,6157,8,jean marc mwema,6,0,0,0,0,0,0,0,0,0,0,0,0,1,0,1,1,0,2,0,0,0
438260,497_15_40,BELGIUM,5599,9,jonathan tabu,21,5,13,38.5,3,9,33.3,2,4,50,0,0,0,1,0,1,0,2,0,1,0,12
438261,497_15_40,BELGIUM,8359,10,quentin serron,20,3,8,37.5,1,6,16.7,2,2,100,0,0,0,0,2,2,2,1,0,1,0,8
438262,497_15_40,BELGIUM,24196,12,wen mukubu,5,0,3,0,0,1,0,0,2,0,0,0,0,0,1,1,0,0,1,0,0,0
438263,497_15_40,BELGIUM,11181,13,pierre-antoine gillet,31,4,6,66.7,2,2,100,2,4,50,0,0,0,1,3,4,1,4,0,1,0,10
438264,497_15_40,BELGIUM,10498,14,maxime de zeeuw,13,4,4,100,4,4,100,0,0,0,0,0,0,1,2,3,1,4,3,1,0,8
438265,497_15_40,BELGIUM,19894,22,kevin tumba,15,2,2,100,2,2,100,0,0,0,0,2,0,3,4,7,0,2,1,0,2,4
438266,497_15_40,BELGIUM,15488,23,jean salumu,4,0,2,0,0,1,0,0,1,0,0,0,0,0,0,0,0,0,0,0,0,0
438267,497_15_40,BELGIUM,29508,24,matt lojeski,22,1,4,25,0,2,0,1,2,50,0,0,0,0,1,1,2,2,2,0,0,3
438268,497_15_40,BELGIUM,0,TOTALS,BELGIUM,200,26,58,44.8,18,38,47.4,8,20,40,4,8,50,11,29,40,20,22,16,6,3,64
438269,497_15_40,CZECH REPUBLIC,4677,4,petr benda,27,6,8,75,6,8,75,0,0,0,1,1,100,2,3,5,2,2,0,0,1,13
438270,497_15_40,CZECH REPUBLIC,29502,5,patrik auda,18,2,4,50,1,3,33.3,1,1,100,0,0,0,1,1,2,0,0,0,0,0,5
438271,497_15_40,CZECH REPUBLIC,5478,6,pavel pumprla,22,0,7,0,0,5,0,0,2,0,0,0,0,2,0,2,1,0,3,2,0,0
438272,497_15_40,CZECH REPUBLIC,10700,7,vojtech hruban,14,1,5,20,1,2,50,0,3,0,0,0,0,1,2,3,2,1,0,0,0,2
438273,497_15_40,CZECH REPUBLIC,8325,8,tomas satoransky,34,5,10,50,3,6,50,2,4,50,2,4,50,0,2,2,9,4,2,3,1,14
438274,497_15_40,CZECH REPUBLIC,4774,9,jiri welsch,17,0,1,0,0,0,0,0,1,0,1,2,50,1,4,5,3,4,1,0,0,1
438275,497_15_40,CZECH REPUBLIC,1096,10,pavel houska,0,0,0,0,0,0,0,0,0,0,0,0,0,0,0,0,0,0,0,0,0,0
438276,497_15_40,CZECH REPUBLIC,4775,11,lubos barton,0,0,0,0,0,0,0,0,0,0,0,0,0,0,0,0,0,0,0,0,0,0
438277,497_15_40,CZECH REPUBLIC,8327,12,david jelinek,4,1,1,100,1,1,100,0,0,0,0,0,0,0,0,0,0,1,1,0,0,2
438278,497_15_40,CZECH REPUBLIC,10484,13,jakub sirina,0,0,0,0,0,0,0,0,0,0,0,0,0,0,0,0,0,0,0,0,0,0
438279,497_15_40,CZECH REPUBLIC,29503,14,blake schilb,29,3,8,37.5,1,5,20,2,3,66.7,0,0,0,0,1,1,3,1,2,0,0,8
438280,497_15_40,CZECH REPUBLIC,6362,24,jan vesely,35,8,17,47.1,8,17,47.1,0,0,0,5,8,62.5,3,9,12,1,3,1,1,1,21
438281,497_15_40,CZECH REPUBLIC,0,TOTALS,CZECH REPUBLIC,200,26,61,42.6,21,47,44.7,5,14,35.7,9,15,60,10,23,33,21,16,10,6,3,66
438282,497_15_41,POLAND,15535,0,aleksander czyz,4,0,4,0,0,2,0,0,2,0,0,0,0,0,2,2,0,0,0,0,0,0
438283,497_15_41,POLAND,5694,5,aaron cel,11,2,3,66.7,0,0,0,2,3,66.7,0,0,0,0,2,2,0,4,2,0,0,6
438284,497_15_41,POLAND,29496,6,aj slaughter,28,4,10,40,4,6,66.7,0,4,0,1,2,50,1,1,2,5,0,2,0,0,9
438285,497_15_41,POLAND,7833,7,damian kulig,25,5,9,55.6,2,4,50,3,5,60,0,0,0,0,6,6,1,4,1,0,0,13
438286,497_15_41,POLAND,15981,9,mateusz ponitka,28,3,6,50,3,5,60,0,1,0,0,0,0,3,1,4,6,1,3,1,2,6
438287,497_15_41,POLAND,8034,12,adam waczynski,32,3,7,42.9,2,3,66.7,1,4,25,6,6,100,0,2,2,0,2,3,3,0,13
438288,497_15_41,POLAND,1215,13,marcin gortat,27,5,10,50,5,10,50,0,0,0,1,3,33.3,1,7,8,3,0,5,0,0,11
438289,497_15_41,POLAND,1207,15,lukasz koszarek,14,1,1,100,1,1,100,0,0,0,2,2,100,1,2,3,4,0,1,0,0,4
438290,497_15_41,POLAND,24194,17,przemyslaw zamojski,10,1,1,100,1,1,100,0,0,0,3,3,100,0,0,0,0,3,2,0,0,5
438291,497_15_41,POLAND,12920,24,przemyslaw karnowski,13,2,2,100,2,2,100,0,0,0,0,0,0,1,1,2,1,1,4,0,0,4
438292,497_15_41,POLAND,6186,33,karol gruszecki,8,1,2,50,1,1,100,0,1,0,0,0,0,0,0,0,0,0,0,0,0,2
438293,497_15_41,POLAND,4799,66,robert skibniewski,0,0,0,0,0,0,0,0,0,0,0,0,0,0,0,0,0,0,0,0,0,0
438294,497_15_41,POLAND,0,TOTALS,POLAND,200,27,55,49.1,21,35,60,6,20,30,13,16,81.2,9,24,33,20,15,23,4,2,73
438295,497_15_41,ISRAEL,24229,5,dagan yivzori,5,0,2,0,0,1,0,0,1,0,0,0,0,0,0,0,0,0,0,0,0,0
438296,497_15_41,ISRAEL,21841,6,shawn dawson,1,0,0,0,0,0,0,0,0,0,0,0,0,0,0,0,0,1,0,0,0,0
438297,497_15_41,ISRAEL,2522,7,gal mekel,29,6,13,46.2,6,13,46.2,0,0,0,6,7,85.7,0,1,1,5,2,3,1,0,18
438298,497_15_41,ISRAEL,1023,8,lior eliyahu,16,2,4,50,2,4,50,0,0,0,0,0,0,0,0,0,1,0,2,0,1,4
438299,497_15_41,ISRAEL,1933,9,omri casspi,35,6,13,46.2,4,10,40,2,3,66.7,0,0,0,0,7,7,2,1,1,2,1,14
438300,497_15_41,ISRAEL,1022,10,raviv limonad,27,4,9,44.4,3,8,37.5,1,1,100,0,0,0,0,1,1,5,4,0,1,0,9
438301,497_15_41,ISRAEL,5780,11,elishay kadir,23,4,6,66.7,4,6,66.7,0,0,0,0,0,0,2,2,4,2,4,2,1,0,8
438302,497_15_41,ISRAEL,1685,12,yogev ohayon,24,3,6,50,2,3,66.7,1,3,33.3,0,0,0,0,1,1,0,3,1,4,0,7
438303,497_15_41,ISRAEL,4620,14,yaniv green,8,0,0,0,0,0,0,0,0,0,0,0,0,2,0,2,0,1,2,0,0,0
438304,497_15_41,ISRAEL,29504,15,dor fischer,32,7,14,50,7,14,50,0,0,0,1,2,50,2,6,8,3,3,2,0,1,15
438305,497_15_41,ISRAEL,19712,16,boris rothbart,0,0,0,0,0,0,0,0,0,0,0,0,0,0,0,0,0,0,0,0,0,0
438306,497_15_41,ISRAEL,12887,23,bar timor,0,0,0,0,0,0,0,0,0,0,0,0,0,0,0,0,0,0,0,0,0,0
438307,497_15_41,ISRAEL,0,TOTALS,ISRAEL,200,32,67,47.8,28,59,47.5,4,8,50,7,9,77.8,10,18,28,18,19,13,9,3,75
438308,497_15_42,ITALY,20021,0,amedeo della valle,0,0,0,0,0,0,0,0,0,0,0,0,0,0,0,0,0,0,0,0,0,0
438309,497_15_42,ITALY,1272,3,marco belinelli,33,5,16,31.2,1,2,50,4,14,28.6,3,4,75,0,2,2,1,3,2,0,0,17
438310,497_15_42,ITALY,7944,4,pietro aradori,27,2,5,40,0,3,0,2,2,100,0,0,0,2,7,9,3,1,1,1,0,6
438311,497_15_42,ITALY,12988,5,alessandro gentile,35,6,16,37.5,5,13,38.5,1,3,33.3,2,2,100,1,3,4,4,5,1,2,1,15
438312,497_15_42,ITALY,2667,8,danilo gallinari,39,5,11,45.5,3,5,60,2,6,33.3,13,15,86.7,2,7,9,2,2,1,1,0,25
438313,497_15_42,ITALY,1270,9,andrea bargnani,31,8,12,66.7,7,9,77.8,1,3,33.3,0,0,0,3,2,5,0,5,2,0,2,17
438314,497_15_42,ITALY,15319,12,marco cusin,7,0,0,0,0,0,0,0,0,0,0,0,0,0,2,2,0,1,0,1,0,0
438315,497_15_42,ITALY,1861,13,luigi datome,0,0,0,0,0,0,0,0,0,0,0,0,0,0,0,0,0,0,0,0,0,0
438316,497_15_42,ITALY,10968,17,nicolo melli,4,0,1,0,0,0,0,0,1,0,2,2,100,0,0,0,1,1,0,0,0,2
438317,497_15_42,ITALY,19752,20,andrea cinciarini,23,2,3,66.7,2,2,100,0,1,0,0,0,0,0,3,3,2,3,0,0,0,4
438318,497_15_42,ITALY,10444,23,daniel hackett,24,1,6,16.7,1,4,25,0,2,0,1,2,50,0,3,3,4,4,2,0,0,3
438319,497_15_42,ITALY,15644,33,achille polonara,2,0,0,0,0,0,0,0,0,0,0,0,0,0,0,0,0,2,0,0,0,0
438320,497_15_42,ITALY,0,TOTALS,ITALY,225,29,70,41.4,19,38,50,10,32,31.2,21,25,84,9,29,38,17,27,9,5,3,89
438321,497_15_42,GERMANY,29499,4,maodo lo,11,1,7,14.3,1,4,25,0,3,0,0,0,0,0,1,1,2,0,1,0,0,2
438322,497_15_42,GERMANY,8235,5,niels giffey,4,0,1,0,0,0,0,0,1,0,0,0,0,0,0,0,0,0,0,0,0,0
438323,497_15_42,GERMANY,1192,7,alex king,14,1,2,50,0,0,0,1,2,50,0,0,0,0,2,2,1,5,0,0,0,3
438324,497_15_42,GERMANY,15385,8,heiko schaffartzik,27,2,3,66.7,1,1,100,1,2,50,0,0,0,0,1,1,1,1,0,0,0,5
438325,497_15_42,GERMANY,10446,9,karsten tadda,12,2,3,66.7,2,2,100,0,1,0,0,0,0,0,2,2,1,2,0,0,0,4
438326,497_15_42,GERMANY,10637,11,tibor pleiss,20,3,6,50,3,6,50,0,0,0,4,5,80,2,3,5,1,1,1,0,0,10
438327,497_15_42,GERMANY,6326,12,robin benzing,22,1,3,33.3,0,0,0,1,3,33.3,0,0,0,0,2,2,1,5,0,0,1,3
438328,497_15_42,GERMANY,4711,14,dirk nowitzki,28,4,13,30.8,4,9,44.4,0,4,0,6,6,100,2,8,10,2,3,1,0,0,14
438329,497_15_42,GERMANY,19990,17,dennis schroder,34,11,20,55,10,18,55.6,1,2,50,6,7,85.7,0,4,4,7,1,6,0,0,29
438330,497_15_42,GERMANY,29500,21,paul zipser,35,4,7,57.1,4,6,66.7,0,1,0,3,4,75,1,7,8,1,4,1,0,2,11
438331,497_15_42,GERMANY,1152,25,anton gavel,18,0,2,0,0,1,0,0,1,0,1,2,50,0,0,0,1,3,0,2,0,1
438332,497_15_42,GERMANY,19867,77,johannes voigtmann,0,0,0,0,0,0,0,0,0,0,0,0,0,0,0,0,0,0,0,0,0,0
438333,497_15_42,GERMANY,0,TOTALS,GERMANY,225,29,67,43.3,25,47,53.2,4,20,20,20,24,83.3,7,32,39,18,25,11,2,3,82
438334,497_15_43,MKD,6306,4,vladimir brckov,4,0,0,0,0,0,0,0,0,0,0,0,0,0,0,0,0,0,0,0,0,0
438335,497_15_43,MKD,10169,5,vlado ilievski,27,2,8,25,2,4,50,0,4,0,0,0,0,1,1,2,2,3,3,0,0,4
438336,497_15_43,MKD,7810,6,darko sokolov,0,0,0,0,0,0,0,0,0,0,0,0,0,0,0,0,0,0,0,0,0,0
438337,497_15_43,MKD,2709,7,aleksandar kostoski,26,2,7,28.6,0,0,0,2,7,28.6,6,6,100,1,2,3,2,4,2,0,0,12
438338,497_15_43,MKD,5892,8,vojdan stojanovski,18,2,5,40,2,4,50,0,1,0,0,0,0,0,3,3,3,1,1,1,0,4
438339,497_15_43,MKD,5892,9,damjan stojanovski,24,3,7,42.9,0,0,0,3,7,42.9,5,5,100,2,0,2,1,3,0,1,1,14
438340,497_15_43,MKD,6300,10,marko simonovski,21,2,5,40,0,1,0,2,4,50,0,0,0,1,2,3,1,1,2,0,1,6
438341,497_15_43,MKD,20507,11,ljubomir mladenovski,0,0,0,0,0,0,0,0,0,0,0,0,0,0,0,0,0,0,0,0,0,0
438342,497_15_43,MKD,2714,12,bojan trajkovski,24,5,13,38.5,3,8,37.5,2,5,40,1,2,50,2,3,5,2,5,2,1,1,13
438343,497_15_43,MKD,11275,13,stojan gjuroski,16,1,2,50,0,0,0,1,2,50,0,0,0,0,0,0,2,3,0,0,0,3
438344,497_15_43,MKD,29507,14,richard hendrix,21,7,11,63.6,7,10,70,0,1,0,0,0,0,4,3,7,1,4,5,0,0,14
438345,497_15_43,MKD,5010,15,predrag samardziski,19,2,4,50,2,4,50,0,0,0,1,2,50,2,2,4,2,4,1,1,0,5
438346,497_15_43,MKD,0,TOTALS,MKD,200,26,62,41.9,16,31,51.6,10,31,32.3,13,15,86.7,14,17,31,16,28,16,4,3,75
438347,497_15_43,GEORGIA,24223,0,jacob everse pullen,19,2,5,40,0,2,0,2,3,66.7,0,0,0,0,2,2,3,2,0,0,0,6
438348,497_15_43,GEORGIA,8378,4,nika metreveli,0,0,0,0,0,0,0,0,0,0,0,0,0,0,0,0,0,0,0,0,0,0
438349,497_15_43,GEORGIA,4919,7,zaza pachulia,30,8,12,66.7,8,12,66.7,0,0,0,7,11,63.6,4,10,14,1,2,4,0,0,23
438350,497_15_43,GEORGIA,1690,8,george tsintsadze,32,5,8,62.5,3,4,75,2,4,50,0,0,0,0,1,1,6,3,2,1,0,12
438351,497_15_43,GEORGIA,6436,9,giorgi shermadini,10,1,2,50,1,2,50,0,0,0,4,6,66.7,0,0,0,1,2,0,0,1,6
438352,497_15_43,GEORGIA,15684,10,duda sanadze,11,2,2,100,2,2,100,0,0,0,2,2,100,0,1,1,0,2,1,2,0,6
438353,497_15_43,GEORGIA,1697,11,manuchar markoishvili,31,6,8,75,2,2,100,4,6,66.7,2,4,50,0,3,3,1,3,1,0,0,18
438354,497_15_43,GEORGIA,12467,12,levan patsatsia,0,0,0,0,0,0,0,0,0,0,0,0,0,0,0,0,0,0,0,0,0,0
438355,497_15_43,GEORGIA,1699,13,viktor sanikidze,34,1,7,14.3,1,6,16.7,0,1,0,2,2,100,3,3,6,2,4,1,0,0,4
438356,497_15_43,GEORGIA,16022,15,beka burjanadze,1,0,0,0,0,0,0,0,0,0,0,0,0,0,0,0,0,0,0,0,0,0
438357,497_15_43,GEORGIA,11036,23,tornike shengelia,31,4,10,40,4,8,50,0,2,0,7,8,87.5,3,1,4,2,2,2,2,1,15
438358,497_15_43,GEORGIA,1693,25,besik lezhava,0,0,0,0,0,0,0,0,0,0,0,0,0,0,0,0,0,0,0,0,0,0
438359,497_15_43,GEORGIA,0,TOTALS,GEORGIA,200,29,54,53.7,21,38,55.3,8,16,50,24,33,72.7,11,22,33,16,20,12,5,2,90
438360,497_15_44,LATVIA,19755,5,mareks mejeris,9,0,0,0,0,0,0,0,0,0,0,0,0,0,1,1,1,1,2,0,0,0
438361,497_15_44,LATVIA,2539,6,rolands freimanis,28,3,6,50,3,5,60,0,1,0,1,3,33.3,1,4,5,1,3,1,0,0,7
438362,497_15_44,LATVIA,5029,7,janis blums,18,3,7,42.9,1,1,100,2,6,33.3,4,4,100,0,3,3,3,1,0,0,0,12
438363,497_15_44,LATVIA,6271,9,dairis bertans,29,5,11,45.5,3,6,50,2,5,40,5,6,83.3,0,3,3,5,2,1,1,0,17
438364,497_15_44,LATVIA,12927,10,janis timma,21,3,9,33.3,2,5,40,1,4,25,0,0,0,3,2,5,2,1,0,0,0,7
438365,497_15_44,LATVIA,4604,12,kristaps janicenoks,26,5,11,45.5,4,8,50,1,3,33.3,0,0,0,0,4,4,0,2,0,2,0,11
438366,497_15_44,LATVIA,10585,13,janis strelnieks,29,1,8,12.5,0,4,0,1,4,25,0,0,0,1,2,3,5,2,1,0,0,3
438367,497_15_44,LATVIA,1002,14,kaspars berzins,22,5,8,62.5,4,6,66.7,1,2,50,2,2,100,2,4,6,2,4,0,0,0,13
438368,497_15_44,LATVIA,12931,19,kaspars vecvagars,0,0,0,0,0,0,0,0,0,0,0,0,0,0,0,0,0,0,0,0,0,0
438369,497_15_44,LATVIA,11058,23,haralds karlis,0,0,0,0,0,0,0,0,0,0,0,0,0,0,0,0,0,0,0,0,0,0
438370,497_15_44,LATVIA,29509,31,zanis peiners,4,1,2,50,1,1,100,0,1,0,0,0,0,0,1,1,1,0,0,0,0,2
438371,497_15_44,LATVIA,15602,33,martins meiers,14,1,3,33.3,1,3,33.3,0,0,0,0,0,0,0,1,1,0,3,0,0,0,2
438372,497_15_44,LATVIA,0,TOTALS,LATVIA,200,27,65,41.5,19,39,48.7,8,26,30.8,12,15,80,8,27,35,20,19,7,3,0,74
438373,497_15_44,UKRAINE,5790,4,maksym pustozvonov,23,1,2,50,0,1,0,1,1,100,0,0,0,1,2,3,1,0,2,0,0,3
438374,497_15_44,UKRAINE,29514,5,dzherom dzherri rendl,31,5,10,50,5,8,62.5,0,2,0,1,1,100,0,2,2,5,2,0,1,0,11
438375,497_15_44,UKRAINE,12946,6,olexandr mishula,28,2,5,40,1,3,33.3,1,2,50,1,2,50,0,3,3,3,2,2,0,0,6
438376,497_15_44,UKRAINE,2768,7,denys lukashov,9,1,3,33.3,1,2,50,0,1,0,0,0,0,0,0,0,2,1,0,0,0,2
438377,497_15_44,UKRAINE,2093,8,kyrylo fesenko,35,6,14,42.9,6,14,42.9,0,0,0,9,14,64.3,4,6,10,2,3,1,0,0,21
438378,497_15_44,UKRAINE,7927,9,oleksandr sizov,0,0,0,0,0,0,0,0,0,0,0,0,0,0,0,0,0,0,0,0,0,0
438379,497_15_44,UKRAINE,10714,10,stanislav tymofeyenko,2,0,1,0,0,0,0,0,1,0,0,0,0,0,0,0,0,1,0,0,0,0
438380,497_15_44,UKRAINE,10926,11,oleksandr lypovyy,19,5,5,100,2,2,100,3,3,100,2,2,100,0,4,4,0,4,1,0,0,15
438381,497_15_44,UKRAINE,5791,12,maxym korniyenko,26,3,9,33.3,2,6,33.3,1,3,33.3,1,4,25,1,8,9,0,2,0,1,1,8
438382,497_15_44,UKRAINE,10713,13,ihor zaytsev,18,4,8,50,3,7,42.9,1,1,100,0,0,0,0,0,0,1,4,1,0,0,9
438383,497_15_44,UKRAINE,19863,14,artem pustovyi,0,0,0,0,0,0,0,0,0,0,0,0,0,0,0,0,0,0,0,0,0,0
438384,497_15_44,UKRAINE,12945,15,pavlo krutous,9,0,1,0,0,1,0,0,0,0,0,0,0,1,1,2,0,4,1,0,0,0
438385,497_15_44,UKRAINE,0,TOTALS,UKRAINE,200,27,58,46.6,20,44,45.5,7,14,50,14,23,60.9,10,27,37,14,23,9,2,1,75
438386,497_15_45,RUSSIA,19857,1,andrey zubkov,2,0,0,0,0,0,0,0,0,0,0,0,0,0,0,0,0,0,0,0,0,0
438387,497_15_45,RUSSIA,29505,4,evgenii baburin,5,0,0,0,0,0,0,0,0,0,0,0,0,0,0,0,0,1,0,2,0,0
438388,497_15_45,RUSSIA,8296,5,ruslan pateev,19,4,5,80,4,5,80,0,0,0,1,2,50,0,3,3,0,5,0,0,0,9
438389,497_15_45,RUSSIA,1078,7,vitaly fridzon,29,6,11,54.5,2,6,33.3,4,5,80,4,6,66.7,1,4,5,2,1,3,2,0,20
438390,497_15_45,RUSSIA,1083,9,egor vyaltsev,4,0,1,0,0,0,0,0,1,0,0,0,0,0,0,0,0,1,0,0,0,0
438391,497_15_45,RUSSIA,10610,11,semen antonov,20,5,9,55.6,2,5,40,3,4,75,0,0,0,1,2,3,0,3,2,0,0,13
438392,497_15_45,RUSSIA,5064,12,sergey monya,29,3,8,37.5,1,2,50,2,6,33.3,0,0,0,0,2,2,1,5,0,0,0,8
438393,497_15_45,RUSSIA,2554,13,dmitry khvostov,24,1,6,16.7,1,3,33.3,0,3,0,0,0,0,0,0,0,10,4,3,0,0,2
438394,497_15_45,RUSSIA,1808,14,anton ponkrashov,16,0,7,0,0,4,0,0,3,0,0,0,0,1,0,1,7,1,2,0,2,0
438395,497_15_45,RUSSIA,7770,20,andrey vorontsevich,22,0,1,0,0,0,0,0,1,0,0,0,0,2,7,9,1,2,3,0,2,0
438396,497_15_45,RUSSIA,21941,32,andrei desiatnikov,17,3,4,75,3,4,75,0,0,0,2,5,40,1,1,2,0,2,1,0,0,8
438397,497_15_45,RUSSIA,1809,41,nikita kurbanov,13,3,6,50,2,4,50,1,2,50,0,0,0,0,1,1,1,0,1,0,0,7
438398,497_15_45,RUSSIA,0,TOTALS,RUSSIA,200,25,58,43.1,15,33,45.5,10,25,40,7,13,53.8,9,22,31,22,25,15,4,4,67
438399,497_15_45,FRANCE,11077,4,leo j. p. westermann,11,0,3,0,0,2,0,0,1,0,0,0,0,1,1,2,1,3,0,0,0,0
438400,497_15_45,FRANCE,2588,5,nicolas batum,19,3,8,37.5,2,4,50,1,4,25,1,2,50,0,0,0,0,1,0,1,0,8
438401,497_15_45,FRANCE,11076,7,joffrey lauvergne,21,3,5,60,2,4,50,1,1,100,4,4,100,2,5,7,0,3,1,0,0,11
438402,497_15_45,FRANCE,1864,8,charles kahudi,14,1,2,50,1,2,50,0,0,0,2,2,100,1,2,3,1,1,0,0,1,4
438403,497_15_45,FRANCE,5047,9,tony parker,20,4,9,44.4,2,5,40,2,4,50,2,4,50,0,3,3,4,1,3,0,0,12
438404,497_15_45,FRANCE,12971,10,evan fournier,15,0,3,0,0,2,0,0,1,0,0,0,0,0,0,0,1,2,2,1,0,0
438405,497_15_45,FRANCE,4663,11,florent pietrus,19,0,3,0,0,2,0,0,1,0,1,2,50,1,1,2,1,1,1,2,0,1
438406,497_15_45,FRANCE,10428,12,nando de colo,21,3,5,60,0,0,0,3,5,60,4,4,100,0,1,1,1,3,1,2,1,13
438407,497_15_45,FRANCE,4665,13,boris diaw,17,2,6,33.3,1,4,25,1,2,50,0,0,0,1,0,1,2,1,1,0,0,5
438408,497_15_45,FRANCE,5044,15,mickael gelabale,20,3,7,42.9,3,5,60,0,2,0,2,2,100,0,4,4,0,1,0,0,0,8
438409,497_15_45,FRANCE,17374,16,rudy gobert,23,3,6,50,3,6,50,0,0,0,6,9,66.7,3,7,10,0,2,1,4,1,12
438410,497_15_45,FRANCE,17677,19,mouhammadou jaiteh,0,0,0,0,0,0,0,0,0,0,0,0,0,0,0,0,0,0,0,0,0,0
438411,497_15_45,FRANCE,0,TOTALS,FRANCE,200,22,57,38.6,14,36,38.9,8,21,38.1,22,29,75.9,12,25,37,11,19,13,10,3,74
438412,497_15_46,ICELAND,19926,3,martin hermannsson,20,2,5,40,2,4,50,0,1,0,0,0,0,0,0,0,1,1,1,0,0,4
438413,497_15_46,ICELAND,24208,4,axel karason,6,0,0,0,0,0,0,0,0,0,0,0,0,0,0,0,0,1,1,0,0,0
438414,497_15_46,ICELAND,15700,5,ragnar nathanaelsson,4,0,0,0,0,0,0,0,0,0,0,0,0,0,1,1,0,1,0,0,1,0
438415,497_15_46,ICELAND,4834,6,jakob sigurdarson,22,2,10,20,1,4,25,1,6,16.7,0,0,0,0,1,1,1,4,0,0,0,5
438416,497_15_46,ICELAND,4841,8,hlynur baeringsson,26,4,12,33.3,4,9,44.4,0,3,0,0,0,0,5,3,8,2,3,1,1,1,8
438417,497_15_46,ICELAND,4837,9,jon stefansson,27,7,13,53.8,5,9,55.6,2,4,50,1,1,100,1,3,4,6,2,0,2,0,17
438418,497_15_46,ICELAND,4840,10,helgi magnusson,0,0,0,0,0,0,0,0,0,0,0,0,0,0,0,0,0,0,0,0,0,0
438419,497_15_46,ICELAND,2764,13,hordur vilhjalmsson,20,1,8,12.5,1,3,33.3,0,5,0,0,0,0,0,1,1,3,2,0,0,0,2
438420,497_15_46,ICELAND,4980,14,logi gunnarsson,17,2,7,28.6,1,3,33.3,1,4,25,2,2,100,2,1,3,3,3,1,0,0,7
438421,497_15_46,ICELAND,2071,15,pavel ermolinskij,31,4,7,57.1,0,1,0,4,6,66.7,0,0,0,0,3,3,0,4,2,0,0,12
438422,497_15_46,ICELAND,13211,24,haukur palsson,22,5,8,62.5,2,4,50,3,4,75,1,2,50,0,2,2,2,3,3,0,0,14
438423,497_15_46,ICELAND,15702,29,aegir steinarsson,5,2,3,66.7,2,2,100,0,1,0,0,0,0,1,1,2,1,1,1,0,0,4
438424,497_15_46,ICELAND,0,TOTALS,ICELAND,200,29,73,39.7,18,39,46.2,11,34,32.4,4,5,80,13,16,29,19,25,10,3,2,73
438425,497_15_46,SPAIN,61,4,pau gasol,23,7,11,63.6,7,11,63.6,0,0,0,7,7,100,2,5,7,1,1,1,0,2,21
438426,497_15_46,SPAIN,70,5,rudy fernandez,11,0,3,0,0,1,0,0,2,0,0,0,0,1,3,4,0,0,0,0,0,0
438427,497_15_46,SPAIN,1877,6,sergio rodriguez,21,5,7,71.4,3,3,100,2,4,50,1,1,100,0,3,3,6,2,2,3,0,13
438428,497_15_46,SPAIN,17609,7,guillermo hernangomez,3,0,0,0,0,0,0,0,0,0,0,2,0,0,1,1,1,0,0,0,0,0
438429,497_15_46,SPAIN,5713,8,pau ribas tossas,23,2,4,50,0,1,0,2,3,66.7,0,0,0,0,5,5,3,1,0,0,1,6
438430,497_15_46,SPAIN,66,9,felipe reyes,18,5,8,62.5,5,8,62.5,0,0,0,1,2,50,4,1,5,2,3,3,0,0,11
438431,497_15_46,SPAIN,2628,10,victor claver,13,2,4,50,1,3,33.3,1,1,100,6,6,100,4,2,6,0,0,1,0,0,11
438432,497_15_46,SPAIN,1317,11,fernando san emeterio,24,3,7,42.9,2,2,100,1,5,20,0,0,0,1,1,2,6,2,1,0,0,7
438433,497_15_46,SPAIN,1871,12,sergio llull,25,3,7,42.9,2,3,66.7,1,4,25,1,2,50,0,0,0,5,0,0,0,0,8
438434,497_15_46,SPAIN,6265,13,pablo aguilar,5,0,1,0,0,1,0,0,0,0,0,0,0,0,1,1,1,0,0,0,0,0
438435,497_15_46,SPAIN,17234,14,nikola mirotic,22,7,8,87.5,5,6,83.3,2,2,100,6,9,66.7,1,4,5,1,2,0,1,0,22
438436,497_15_46,SPAIN,19987,15,guillem vives,13,0,1,0,0,0,0,0,1,0,0,0,0,0,2,2,2,2,3,0,1,0
438437,497_15_46,SPAIN,0,TOTALS,SPAIN,200,34,61,55.7,25,39,64.1,9,22,40.9,22,29,75.9,14,31,45,28,13,12,4,4,99
438438,497_15_47,NETHERLANDS,20407,0,yannick franke,8,1,3,33.3,0,2,0,1,1,100,0,0,0,0,0,0,0,0,0,0,0,3
438439,497_15_47,NETHERLANDS,15661,5,leon williams,13,1,2,50,1,2,50,0,0,0,0,0,0,0,2,2,5,1,0,0,0,2
438440,497_15_47,NETHERLANDS,24213,6,worthy de jong,23,2,6,33.3,2,6,33.3,0,0,0,2,2,100,0,5,5,3,2,3,1,0,6
438441,497_15_47,NETHERLANDS,15520,7,charlon kloof,30,3,5,60,1,1,100,2,4,50,2,3,66.7,0,3,3,3,1,3,1,0,10
438442,497_15_47,NETHERLANDS,10671,9,mohamed kherrazi,21,2,2,100,2,2,100,0,0,0,1,2,50,0,1,1,1,3,0,0,0,5
438443,497_15_47,NETHERLANDS,12501,10,ralf de pagter,0,0,0,0,0,0,0,0,0,0,0,0,0,0,0,0,0,0,0,0,0,0
438444,497_15_47,NETHERLANDS,29501,12,kees akerboom,10,1,3,33.3,0,0,0,1,3,33.3,0,0,0,0,2,2,0,2,0,0,0,3
438445,497_15_47,NETHERLANDS,2871,13,roeland schaftenaar,25,7,13,53.8,4,6,66.7,3,7,42.9,2,3,66.7,1,3,4,0,1,0,2,0,19
438446,497_15_47,NETHERLANDS,7480,18,nicolas de jong,33,6,13,46.2,6,13,46.2,0,0,0,0,2,0,1,5,6,2,4,2,1,0,12
438447,497_15_47,NETHERLANDS,5809,21,robin smeulders,17,2,6,33.3,2,6,33.3,0,0,0,1,1,100,2,4,6,1,5,1,0,1,5
438448,497_15_47,NETHERLANDS,5810,23,henk norel,0,0,0,0,0,0,0,0,0,0,0,0,0,0,0,0,0,0,0,0,0,0
438449,497_15_47,NETHERLANDS,10202,44,arvin slagter,20,2,5,40,0,0,0,2,5,40,1,1,100,0,1,1,3,4,0,0,0,7
438450,497_15_47,NETHERLANDS,0,TOTALS,NETHERLANDS,200,27,58,46.6,18,38,47.4,9,20,45,9,14,64.3,5,29,34,18,23,9,5,1,72
438451,497_15_47,CROATIA,1844,4,ante tomic,25,4,7,57.1,4,7,57.1,0,0,0,5,6,83.3,3,5,8,3,1,2,1,0,13
438452,497_15_47,CROATIA,1846,5,damjan rudez,16,1,7,14.3,0,2,0,1,5,20,2,2,100,0,0,0,0,3,1,0,0,5
438453,497_15_47,CROATIA,1915,6,rok stipcevic,7,0,1,0,0,0,0,0,1,0,0,0,0,0,1,1,0,2,1,0,0,0
438454,497_15_47,CROATIA,6280,7,bojan bogdanovic,29,4,14,28.6,3,8,37.5,1,6,16.7,4,5,80,0,1,1,0,3,1,1,0,13
438455,497_15_47,CROATIA,15894,8,dario saric,24,6,11,54.5,4,7,57.1,2,4,50,1,7,14.3,2,5,7,4,2,2,1,0,15
438456,497_15_47,CROATIA,1251,9,marko tomas,0,0,0,0,0,0,0,0,0,0,0,0,0,0,0,0,0,0,0,0,0,0
438457,497_15_47,CROATIA,4585,10,roko ukic,30,2,4,50,2,2,100,0,2,0,0,0,0,0,1,1,3,3,0,0,0,4
438458,497_15_47,CROATIA,1249,11,krunoslav simon,32,6,9,66.7,2,3,66.7,4,6,66.7,2,2,100,2,5,7,8,1,2,1,0,18
438459,497_15_47,CROATIA,18342,13,dontaye draper,9,0,2,0,0,0,0,0,2,0,0,0,0,0,0,0,2,1,0,0,0,0
438460,497_15_47,CROATIA,10624,15,miro bilan,0,0,0,0,0,0,0,0,0,0,0,0,0,0,0,0,0,0,0,0,0,0
438461,497_15_47,CROATIA,16607,21,luka zoric,15,0,3,0,0,3,0,0,0,0,2,2,100,2,4,6,0,1,0,0,0,2
438462,497_15_47,CROATIA,18415,23,mario hezonja,14,3,3,100,2,2,100,1,1,100,1,1,100,0,3,3,0,1,0,0,0,8
438463,497_15_47,CROATIA,0,TOTALS,CROATIA,200,26,61,42.6,17,34,50,9,27,33.3,17,25,68,10,27,37,20,18,9,4,0,78
438464,497_15_48,ESTONIA,11295,4,rain veideman,30,3,4,75,2,3,66.7,1,1,100,3,4,75,0,5,5,2,2,3,0,0,10
438465,497_15_48,ESTONIA,1218,5,tanel sokk,0,0,0,0,0,0,0,0,0,0,0,0,0,0,0,0,0,0,0,0,0,0
438466,497_15_48,ESTONIA,1219,6,gert dorbek,5,0,0,0,0,0,0,0,0,0,0,0,0,0,1,1,0,2,1,0,0,0
438467,497_15_48,ESTONIA,2721,7,sten sokk,28,1,7,14.3,1,4,25,0,3,0,4,4,100,1,1,2,5,2,3,0,0,6
438468,497_15_48,ESTONIA,4625,8,janar talts,25,7,11,63.6,4,5,80,3,6,50,3,3,100,2,2,4,0,5,1,1,0,20
438469,497_15_48,ESTONIA,4622,9,gregor arbet,27,2,7,28.6,2,2,100,0,5,0,0,0,0,0,1,1,1,4,1,0,0,4
438470,497_15_48,ESTONIA,6373,10,erik keedus,0,0,0,0,0,0,0,0,0,0,0,0,0,0,0,0,0,0,0,0,0,0
438471,497_15_48,ESTONIA,6377,11,siim-sander vene,24,2,11,18.2,2,8,25,0,3,0,0,0,0,2,5,7,3,4,2,3,0,4
438472,497_15_48,ESTONIA,15312,13,joosep toome,16,0,3,0,0,2,0,0,1,0,0,0,0,0,1,1,1,5,1,1,2,0
438473,497_15_48,ESTONIA,4771,14,kristjan kangur,24,3,4,75,2,2,100,1,2,50,2,2,100,0,2,2,1,2,2,0,0,9
438474,497_15_48,ESTONIA,1229,15,reinar hallik,0,0,0,0,0,0,0,0,0,0,0,0,0,0,0,0,0,0,0,0,0,0
438475,497_15_48,ESTONIA,8047,20,tanel kurbas,21,3,6,50,3,6,50,0,0,0,3,3,100,0,1,1,1,2,1,0,1,9
438476,497_15_48,ESTONIA,0,TOTALS,ESTONIA,200,21,53,39.6,16,32,50,5,21,23.8,15,16,93.8,5,21,26,14,28,15,5,3,62
438477,497_15_48,LITHUANIA,1726,5,mantas kalnietis,35,2,11,18.2,1,5,20,1,6,16.7,3,3,100,1,0,1,7,2,6,1,0,8
438478,497_15_48,LITHUANIA,8963,6,deividas gailius,11,0,0,0,0,0,0,0,0,0,0,0,0,1,1,2,1,1,1,0,0,0
438479,497_15_48,LITHUANIA,980,8,jonas maciulis,31,4,9,44.4,2,6,33.3,2,3,66.7,5,6,83.3,2,8,10,2,2,3,2,1,15
438480,497_15_48,LITHUANIA,3474,10,renaldas seibutis,32,2,8,25,2,8,25,0,0,0,7,10,70,0,1,1,0,2,2,0,0,11
438481,497_15_48,LITHUANIA,22216,11,domantas sabonis,8,1,3,33.3,1,3,33.3,0,0,0,0,0,0,1,1,2,0,1,0,0,0,2
438482,497_15_48,LITHUANIA,3476,12,antanas kavaliauskas,19,4,5,80,4,5,80,0,0,0,6,7,85.7,2,1,3,2,4,1,0,1,14
438483,497_15_48,LITHUANIA,987,13,paulius jankunas,20,1,1,100,1,1,100,0,0,0,2,4,50,0,3,3,0,3,1,0,0,4
438484,497_15_48,LITHUANIA,24,15,robertas javtokas,16,1,1,100,1,1,100,0,0,0,0,0,0,1,1,2,0,1,0,0,0,2
438485,497_15_48,LITHUANIA,10916,17,jonas valanciunas,0,0,0,0,0,0,0,0,0,0,0,0,0,0,0,0,0,0,0,0,0,0
438486,497_15_48,LITHUANIA,10639,19,mindaugas kuzminskas,23,3,10,30,2,6,33.3,1,4,25,1,2,50,2,6,8,1,0,1,2,0,8
438487,497_15_48,LITHUANIA,29513,21,arturas milaknis,0,0,0,0,0,0,0,0,0,0,0,0,0,0,0,0,0,0,0,0,0,0
438488,497_15_48,LITHUANIA,17685,43,lukas lekavicius,6,0,2,0,0,1,0,0,1,0,0,0,0,0,0,0,0,3,0,0,0,0
438489,497_15_48,LITHUANIA,0,TOTALS,LITHUANIA,200,18,50,36,14,36,38.9,4,14,28.6,24,32,75,12,24,36,13,19,16,5,2,64
438490,497_15_49,SERBIA,5751,4,milos teodosic,27,8,12,66.7,4,5,80,4,7,57.1,6,6,100,0,1,1,8,2,1,1,0,26
438491,497_15_49,SERBIA,2100,5,marko simonovic,0,0,0,0,0,0,0,0,0,0,0,0,0,0,0,0,0,0,0,0,0,0
438492,497_15_49,SERBIA,29506,6,ognjen kuzmic,14,3,5,60,3,5,60,0,0,0,1,1,100,2,2,4,0,2,0,0,0,7
438493,497_15_49,SERBIA,17361,7,bogdan bogdanovic,21,4,11,36.4,2,3,66.7,2,8,25,0,0,0,0,1,1,4,4,1,2,1,10
438494,497_15_49,SERBIA,15386,8,nemanja bjelica,23,8,10,80,7,8,87.5,1,2,50,2,3,66.7,1,7,8,4,2,0,0,0,19
438495,497_15_49,SERBIA,2654,9,stefan markovic,25,2,4,50,1,2,50,1,2,50,0,0,0,0,2,2,2,2,0,0,0,5
438496,497_15_49,SERBIA,19860,10,nikola kalinic,16,2,4,50,2,2,100,0,2,0,1,2,50,1,2,3,2,3,0,0,1,5
438497,497_15_49,SERBIA,15503,11,nemanja nedovic,21,1,6,16.7,0,1,0,1,5,20,4,4,100,2,2,4,4,3,1,1,1,7
438498,497_15_49,SERBIA,15505,12,dragan milosavljevic,10,0,1,0,0,1,0,0,0,0,0,0,0,0,1,1,0,3,0,0,0,0
438499,497_15_49,SERBIA,2656,13,miroslav raduljica,15,6,8,75,6,8,75,0,0,0,2,2,100,2,3,5,3,4,1,0,0,14
438500,497_15_49,SERBIA,10253,14,zoran erceg,24,3,7,42.9,1,3,33.3,2,4,50,0,0,0,0,2,2,2,0,0,0,0,8
438501,497_15_49,SERBIA,17652,15,nikola milutinov,4,0,0,0,0,0,0,0,0,0,0,0,0,0,0,0,0,3,1,0,0,0
438502,497_15_49,SERBIA,0,TOTALS,SERBIA,200,37,68,54.4,26,38,68.4,11,30,36.7,16,18,88.9,9,25,34,29,28,5,4,3,101
438503,497_15_49,ITALY,20021,0,amedeo della valle,9,1,3,33.3,0,0,0,1,3,33.3,0,0,0,0,0,0,1,1,0,0,0,3
438504,497_15_49,ITALY,1272,3,marco belinelli,0,0,0,0,0,0,0,0,0,0,0,0,0,0,0,0,0,0,0,0,0,0
438505,497_15_49,ITALY,7944,4,pietro aradori,35,2,6,33.3,2,4,50,0,2,0,6,6,100,1,5,6,2,2,2,0,0,10
438506,497_15_49,ITALY,12988,5,alessandro gentile,36,8,16,50,7,12,58.3,1,4,25,2,4,50,1,4,5,6,4,2,0,0,19
438507,497_15_49,ITALY,2667,8,danilo gallinari,23,4,5,80,2,2,100,2,3,66.7,4,5,80,1,4,5,2,2,1,0,0,14
438508,497_15_49,ITALY,1270,9,andrea bargnani,27,7,14,50,6,12,50,1,2,50,2,2,100,0,2,2,1,3,1,0,0,17
438509,497_15_49,ITALY,15319,12,marco cusin,7,0,0,0,0,0,0,0,0,0,0,2,0,0,1,1,0,0,0,0,0,0
438510,497_15_49,ITALY,1861,13,luigi datome,0,0,0,0,0,0,0,0,0,0,0,0,0,0,0,0,0,0,0,0,0,0
438511,497_15_49,ITALY,10968,17,nicolo melli,16,1,3,33.3,0,2,0,1,1,100,0,0,0,0,2,2,1,2,0,0,0,3
438512,497_15_49,ITALY,19752,20,andrea cinciarini,21,4,7,57.1,3,5,60,1,2,50,2,4,50,0,2,2,2,2,1,0,0,11
438513,497_15_49,ITALY,10444,23,daniel hackett,19,1,2,50,0,1,0,1,1,100,0,0,0,1,1,2,4,3,1,1,0,3
438514,497_15_49,ITALY,15644,33,achille polonara,7,1,2,50,1,1,100,0,1,0,0,0,0,0,0,0,1,0,0,0,1,2
438515,497_15_49,ITALY,0,TOTALS,ITALY,200,29,58,50,21,39,53.8,8,19,42.1,16,23,69.6,5,23,28,20,19,8,1,1,82
438516,497_15_50,FINLAND,1834,4,mikko koivisto,15,1,3,33.3,0,1,0,1,2,50,0,0,0,1,2,3,1,2,0,0,0,3
438517,497_15_50,FINLAND,1314,7,shawn huff,27,6,9,66.7,4,5,80,2,4,50,3,3,100,0,2,2,1,1,1,0,0,17
438518,497_15_50,FINLAND,1836,8,gerald lee,20,2,6,33.3,2,6,33.3,0,0,0,1,2,50,2,1,3,1,2,3,0,0,5
438519,497_15_50,FINLAND,11129,9,sasu salin,26,2,7,28.6,1,1,100,1,6,16.7,0,0,0,0,3,3,2,2,1,0,0,5
438520,497_15_50,FINLAND,4932,10,tuukka kotti,12,1,7,14.3,1,7,14.3,0,0,0,0,0,0,0,0,0,0,2,2,0,0,2
438521,497_15_50,FINLAND,2802,11,petteri koponen,29,6,15,40,4,9,44.4,2,6,33.3,0,0,0,1,1,2,8,3,1,2,0,14
438522,497_15_50,FINLAND,8436,12,matti nuutinen,23,5,9,55.6,4,7,57.1,1,2,50,0,0,0,2,6,8,1,3,0,0,0,11
438523,497_15_50,FINLAND,24222,21,ville kaunisto,15,0,4,0,0,3,0,0,1,0,0,0,0,3,2,5,1,1,0,0,0,0
438524,497_15_50,FINLAND,29510,24,joonas caven,1,0,0,0,0,0,0,0,0,0,0,0,0,0,0,0,0,0,0,0,0,0
438525,497_15_50,FINLAND,8428,30,roope ahonen,11,1,3,33.3,1,3,33.3,0,0,0,0,0,0,0,2,2,1,2,0,1,0,2
438526,497_15_50,FINLAND,29511,31,jamar wilson,0,0,0,0,0,0,0,0,0,0,0,0,0,0,0,0,0,0,0,0,0,0
438527,497_15_50,FINLAND,25454,33,erik jay murphy,21,3,8,37.5,3,4,75,0,4,0,0,0,0,0,5,5,1,5,2,0,0,6
438528,497_15_50,FINLAND,0,TOTALS,FINLAND,200,27,71,38,20,46,43.5,7,25,28,4,5,80,12,25,37,17,23,10,3,0,65
438529,497_15_50,POLAND,15535,0,aleksander czyz,0,0,0,0,0,0,0,0,0,0,0,0,0,0,0,0,0,0,0,0,0,0
438530,497_15_50,POLAND,5694,5,aaron cel,21,2,6,33.3,2,4,50,0,2,0,2,2,100,0,3,3,1,2,1,1,0,6
438531,497_15_50,POLAND,29496,6,aj slaughter,25,4,8,50,3,5,60,1,3,33.3,4,4,100,2,1,3,8,1,2,0,0,13
438532,497_15_50,POLAND,7833,7,damian kulig,21,3,9,33.3,2,4,50,1,5,20,0,0,0,0,3,3,1,1,0,0,1,7
438533,497_15_50,POLAND,15981,9,mateusz ponitka,25,4,7,57.1,4,5,80,0,2,0,0,1,0,1,5,6,2,0,1,0,0,8
438534,497_15_50,POLAND,8034,12,adam waczynski,34,5,10,50,3,6,50,2,4,50,5,5,100,0,4,4,3,2,0,1,0,17
438535,497_15_50,POLAND,1215,13,marcin gortat,18,4,8,50,4,8,50,0,0,0,2,2,100,0,4,4,2,1,0,0,1,10
438536,497_15_50,POLAND,1207,15,lukasz koszarek,21,1,2,50,0,1,0,1,1,100,0,0,0,1,1,2,3,0,5,0,1,3
438537,497_15_50,POLAND,24194,17,przemyslaw zamojski,17,1,2,50,0,0,0,1,2,50,1,2,50,0,4,4,1,4,0,0,0,4
438538,497_15_50,POLAND,12920,24,przemyslaw karnowski,20,3,5,60,3,5,60,0,0,0,4,6,66.7,2,3,5,0,2,1,0,0,10
438539,497_15_50,POLAND,6186,33,karol gruszecki,0,0,0,0,0,0,0,0,0,0,0,0,0,0,0,0,0,0,0,0,0,0
438540,497_15_50,POLAND,4799,66,robert skibniewski,0,0,0,0,0,0,0,0,0,0,0,0,0,0,0,0,0,0,0,0,0,0
438541,497_15_50,POLAND,0,TOTALS,POLAND,200,27,57,47.4,21,38,55.3,6,19,31.6,18,22,81.8,7,31,38,21,13,12,2,3,78
438542,497_15_51,SLOVENIA,4655,1,nebojsa joksimovic,18,2,2,100,1,1,100,1,1,100,0,0,0,1,2,3,1,2,3,0,0,5
438543,497_15_51,SLOVENIA,13125,5,luka rupnik,0,0,0,0,0,0,0,0,0,0,0,0,0,0,0,0,0,0,0,0,0,0
438544,497_15_51,SLOVENIA,17343,7,klemen prepelic,24,2,4,50,0,1,0,2,3,66.7,1,2,50,0,6,6,2,2,3,1,0,7
438545,497_15_51,SLOVENIA,15479,9,jaka blazic,29,3,11,27.3,3,9,33.3,0,2,0,0,0,0,2,2,4,0,2,2,1,0,6
438546,497_15_51,SLOVENIA,8251,10,mitja nikolic,8,0,0,0,0,0,0,0,0,0,0,0,0,0,1,1,0,2,0,0,0,0
438547,497_15_51,SLOVENIA,6197,12,zoran dragic,27,9,16,56.2,8,10,80,1,6,16.7,1,2,50,1,4,5,2,1,4,0,0,20
438548,497_15_51,SLOVENIA,4764,13,miha zupan,3,0,1,0,0,1,0,0,0,0,0,0,0,0,0,0,1,0,0,0,0,0
438549,497_15_51,SLOVENIA,24203,15,jure balazic,31,3,10,30,3,7,42.9,0,3,0,0,0,0,0,3,3,2,4,0,0,0,6
438550,497_15_51,SLOVENIA,1069,17,sasa zagorac,0,0,0,0,0,0,0,0,0,0,0,0,0,0,0,0,0,0,0,0,0,0
438551,497_15_51,SLOVENIA,17344,23,alen omic,28,6,10,60,6,10,60,0,0,0,2,2,100,4,7,11,2,2,1,2,1,14
438552,497_15_51,SLOVENIA,5782,24,jaka klobucar,21,1,4,25,1,1,100,0,3,0,2,4,50,1,3,4,6,2,0,1,0,4
438553,497_15_51,SLOVENIA,5023,55,uros slokar,11,0,1,0,0,1,0,0,0,0,0,0,0,0,2,2,0,2,1,0,0,0
438554,497_15_51,SLOVENIA,0,TOTALS,SLOVENIA,200,26,59,44.1,22,41,53.7,4,18,22.2,6,10,60,11,32,43,16,19,14,5,1,62
438555,497_15_51,MKD,6306,4,vladimir brckov,0,0,0,0,0,0,0,0,0,0,0,0,0,0,0,0,0,0,0,0,0,0
438556,497_15_51,MKD,10169,5,vlado ilievski,36,5,13,38.5,3,8,37.5,2,5,40,3,4,75,0,2,2,1,2,2,1,0,15
438557,497_15_51,MKD,7810,6,darko sokolov,21,0,5,0,0,3,0,0,2,0,2,2,100,0,2,2,2,0,0,1,0,2
438558,497_15_51,MKD,2709,7,aleksandar kostoski,16,0,5,0,0,3,0,0,2,0,1,2,50,0,2,2,1,5,4,0,0,1
438559,497_15_51,MKD,5892,8,vojdan stojanovski,0,0,0,0,0,0,0,0,0,0,0,0,0,0,0,0,0,0,0,0,0,0
438560,497_15_51,MKD,5892,9,damjan stojanovski,21,3,7,42.9,2,4,50,1,3,33.3,1,1,100,1,1,2,0,3,1,1,0,8
438561,497_15_51,MKD,6300,10,marko simonovski,26,2,6,33.3,1,1,100,1,5,20,0,0,0,1,3,4,3,1,0,0,0,5
438562,497_15_51,MKD,20507,11,ljubomir mladenovski,0,0,0,0,0,0,0,0,0,0,0,0,0,0,0,0,0,0,0,0,0,0
438563,497_15_51,MKD,2714,12,bojan trajkovski,20,3,14,21.4,3,12,25,0,2,0,0,2,0,5,4,9,1,3,3,1,0,6
438564,497_15_51,MKD,11275,13,stojan gjuroski,16,0,1,0,0,0,0,0,1,0,0,0,0,1,1,2,0,1,1,0,0,0
438565,497_15_51,MKD,29507,14,richard hendrix,19,2,5,40,2,5,40,0,0,0,0,0,0,3,3,6,2,2,0,1,1,4
438566,497_15_51,MKD,5010,15,predrag samardziski,25,4,7,57.1,4,7,57.1,0,0,0,2,6,33.3,3,2,5,0,3,1,4,2,10
438567,497_15_51,MKD,0,TOTALS,MKD,200,19,63,30.2,15,43,34.9,4,20,20,9,17,52.9,16,23,39,10,20,13,9,3,51
438568,497_15_52,UKRAINE,5790,4,maksym pustozvonov,19,1,6,16.7,0,2,0,1,4,25,0,0,0,0,0,0,3,4,2,0,0,3
438569,497_15_52,UKRAINE,29514,5,dzherom dzherri rendl,28,4,9,44.4,3,6,50,1,3,33.3,0,2,0,0,2,2,4,0,1,0,0,9
438570,497_15_52,UKRAINE,12946,6,olexandr mishula,22,3,12,25,2,3,66.7,1,9,11.1,0,0,0,1,2,3,2,2,2,1,0,7
438571,497_15_52,UKRAINE,2768,7,denys lukashov,11,1,2,50,1,2,50,0,0,0,1,2,50,1,1,2,0,3,0,0,0,3
438572,497_15_52,UKRAINE,2093,8,kyrylo fesenko,28,9,18,50,9,18,50,0,0,0,2,2,100,4,7,11,2,3,1,0,0,20
438573,497_15_52,UKRAINE,7927,9,oleksandr sizov,0,0,0,0,0,0,0,0,0,0,0,0,0,0,0,0,0,0,0,0,0,0
438574,497_15_52,UKRAINE,10714,10,stanislav tymofeyenko,0,0,0,0,0,0,0,0,0,0,0,0,0,0,0,0,0,0,0,0,0,0
438575,497_15_52,UKRAINE,10926,11,oleksandr lypovyy,32,4,5,80,2,2,100,2,3,66.7,0,1,0,1,4,5,1,3,1,0,0,10
438576,497_15_52,UKRAINE,5791,12,maxym korniyenko,25,3,7,42.9,3,6,50,0,1,0,2,4,50,6,3,9,3,2,1,0,0,8
438577,497_15_52,UKRAINE,10713,13,ihor zaytsev,27,1,6,16.7,0,2,0,1,4,25,6,6,100,2,3,5,1,4,1,0,0,9
438578,497_15_52,UKRAINE,19863,14,artem pustovyi,0,0,0,0,0,0,0,0,0,0,0,0,0,0,0,0,0,0,0,0,0,0
438579,497_15_52,UKRAINE,12945,15,pavlo krutous,9,1,2,50,1,2,50,0,0,0,0,0,0,1,0,1,0,0,0,0,0,2
438580,497_15_52,UKRAINE,0,TOTALS,UKRAINE,200,27,67,40.3,21,43,48.8,6,24,25,11,17,64.7,21,24,45,16,21,12,1,0,71
438581,497_15_52,BELGIUM,10156,4,lionel bosco,0,0,0,0,0,0,0,0,0,0,0,0,0,0,0,0,0,0,0,0,0,0
438582,497_15_52,BELGIUM,2003,5,sam van rossom,31,6,11,54.5,5,6,83.3,1,5,20,1,2,50,1,2,3,6,2,2,0,0,14
438583,497_15_52,BELGIUM,4548,7,axel hervelle,28,3,5,60,3,4,75,0,1,0,4,5,80,3,2,5,2,3,0,0,1,10
438584,497_15_52,BELGIUM,6157,8,jean marc mwema,0,0,0,0,0,0,0,0,0,0,0,0,0,0,0,0,0,0,0,0,0,0
438585,497_15_52,BELGIUM,5599,9,jonathan tabu,24,3,8,37.5,1,3,33.3,2,5,40,1,2,50,2,6,8,4,3,0,1,0,9
438586,497_15_52,BELGIUM,8359,10,quentin serron,29,4,8,50,3,6,50,1,2,50,2,3,66.7,1,5,6,1,2,0,0,0,11
438587,497_15_52,BELGIUM,24196,12,wen mukubu,4,0,0,0,0,0,0,0,0,0,0,0,0,0,0,0,0,1,1,0,0,0
438588,497_15_52,BELGIUM,11181,13,pierre-antoine gillet,28,5,9,55.6,2,5,40,3,4,75,2,2,100,2,1,3,2,1,1,0,0,15
438589,497_15_52,BELGIUM,10498,14,maxime de zeeuw,19,4,11,36.4,3,7,42.9,1,4,25,2,2,100,1,0,1,4,3,0,0,0,11
438590,497_15_52,BELGIUM,19894,22,kevin tumba,5,0,0,0,0,0,0,0,0,0,1,2,50,0,1,1,0,2,0,0,1,1
438591,497_15_52,BELGIUM,15488,23,jean salumu,6,0,0,0,0,0,0,0,0,0,0,0,0,0,0,0,0,0,2,0,0,0
438592,497_15_52,BELGIUM,29508,24,matt lojeski,26,3,10,30,1,4,25,2,6,33.3,0,0,0,2,1,3,4,2,1,0,1,8
438593,497_15_52,BELGIUM,0,TOTALS,BELGIUM,200,28,62,45.2,18,35,51.4,10,27,37,13,18,72.2,13,20,33,23,19,8,1,3,79
438594,497_15_53,BOSNIA AND HERZEGOVINA,5859,4,muhamed pasalic,0,0,0,0,0,0,0,0,0,0,0,0,0,0,0,0,0,0,0,0,0,0
438595,497_15_53,BOSNIA AND HERZEGOVINA,20566,5,nedim buza,22,1,6,16.7,1,3,33.3,0,3,0,1,2,50,0,2,2,5,3,1,0,0,3
438596,497_15_53,BOSNIA AND HERZEGOVINA,7780,6,andrija stipanovic,27,7,13,53.8,7,12,58.3,0,1,0,8,9,88.9,2,4,6,1,3,6,1,1,22
438597,497_15_53,BOSNIA AND HERZEGOVINA,24189,7,marko sutalo,37,3,10,30,2,4,50,1,6,16.7,1,2,50,0,6,6,4,3,2,0,0,8
438598,497_15_53,BOSNIA AND HERZEGOVINA,5026,9,edin bavcic,17,1,2,50,1,2,50,0,0,0,0,0,0,0,2,2,1,4,0,0,0,2
438599,497_15_53,BOSNIA AND HERZEGOVINA,2887,10,nemanja gordic,29,1,5,20,1,2,50,0,3,0,2,2,100,0,3,3,5,2,3,2,0,4
438600,497_15_53,BOSNIA AND HERZEGOVINA,2891,11,elmedin kikanovic,29,5,11,45.5,5,11,45.5,0,0,0,4,6,66.7,5,1,6,1,2,1,0,1,14
438601,497_15_53,BOSNIA AND HERZEGOVINA,24191,13,dalibor persic,2,0,0,0,0,0,0,0,0,0,0,0,0,0,0,0,0,0,1,0,0,0
438602,497_15_53,BOSNIA AND HERZEGOVINA,15282,15,milan milosevic,0,0,0,0,0,0,0,0,0,0,0,0,0,0,0,0,0,0,0,0,0,0
438603,497_15_53,BOSNIA AND HERZEGOVINA,29497,20,alex renfroe,16,0,2,0,0,1,0,0,1,0,0,0,0,1,1,2,0,2,0,1,1,0
438604,497_15_53,BOSNIA AND HERZEGOVINA,17436,23,adin vrabac,19,3,6,50,2,3,66.7,1,3,33.3,1,2,50,1,1,2,2,5,2,3,0,8
438605,497_15_53,BOSNIA AND HERZEGOVINA,29498,30,drasko albijanic,3,0,2,0,0,2,0,0,0,0,0,0,0,0,0,0,0,0,0,0,0,0
438606,497_15_53,BOSNIA AND HERZEGOVINA,0,TOTALS,BOSNIA AND HERZEGOVINA,200,21,57,36.8,19,40,47.5,2,17,11.8,17,23,73.9,10,23,33,19,25,18,7,3,61
438607,497_15_53,RUSSIA,19857,1,andrey zubkov,25,7,10,70,6,7,85.7,1,3,33.3,2,2,100,2,5,7,3,3,0,2,0,17
438608,497_15_53,RUSSIA,29505,4,evgenii baburin,2,0,1,0,0,0,0,0,1,0,0,0,0,0,1,1,0,0,0,0,0,0
438609,497_15_53,RUSSIA,8296,5,ruslan pateev,5,0,0,0,0,0,0,0,0,0,0,0,0,0,1,1,0,3,1,0,0,0
438610,497_15_53,RUSSIA,1078,7,vitaly fridzon,29,5,10,50,1,4,25,4,6,66.7,2,2,100,1,1,2,3,3,2,0,0,16
438611,497_15_53,RUSSIA,1083,9,egor vyaltsev,15,0,2,0,0,0,0,0,2,0,2,2,100,0,1,1,3,2,1,0,0,2
438612,497_15_53,RUSSIA,10610,11,semen antonov,26,3,6,50,2,3,66.7,1,3,33.3,4,5,80,1,3,4,1,1,1,1,1,11
438613,497_15_53,RUSSIA,5064,12,sergey monya,20,2,7,28.6,0,2,0,2,5,40,0,0,0,0,3,3,1,3,6,1,2,6
438614,497_15_53,RUSSIA,2554,13,dmitry khvostov,27,1,8,12.5,1,1,100,0,7,0,1,2,50,1,3,4,5,2,1,0,0,3
438615,497_15_53,RUSSIA,1808,14,anton ponkrashov,13,2,4,50,1,3,33.3,1,1,100,2,3,66.7,0,1,1,2,0,2,0,0,7
438616,497_15_53,RUSSIA,7770,20,andrey vorontsevich,23,4,8,50,1,2,50,3,6,50,4,4,100,1,6,7,3,5,2,4,2,15
438617,497_15_53,RUSSIA,21941,32,andrei desiatnikov,2,0,0,0,0,0,0,0,0,0,0,0,0,0,1,1,0,0,1,0,0,0
438618,497_15_53,RUSSIA,1809,41,nikita kurbanov,14,2,2,100,2,2,100,0,0,0,0,0,0,2,1,3,2,4,1,1,0,4
438619,497_15_53,RUSSIA,0,TOTALS,RUSSIA,200,26,58,44.8,14,24,58.3,12,34,35.3,17,20,85,9,27,36,23,26,18,9,5,81
438620,497_15_54,GERMANY,29499,4,maodo lo,24,6,8,75,4,5,80,2,3,66.7,0,0,0,0,0,0,1,2,1,0,0,14
438621,497_15_54,GERMANY,8235,5,niels giffey,13,1,2,50,1,1,100,0,1,0,0,0,0,0,3,3,0,1,0,0,1,2
438622,497_15_54,GERMANY,1192,7,alex king,0,0,0,0,0,0,0,0,0,0,0,0,0,0,0,0,0,1,0,0,0,0
438623,497_15_54,GERMANY,15385,8,heiko schaffartzik,16,0,3,0,0,1,0,0,2,0,0,0,0,0,2,2,4,2,1,1,0,0
438624,497_15_54,GERMANY,10446,9,karsten tadda,9,0,1,0,0,0,0,0,1,0,0,0,0,0,1,1,0,3,0,0,0,0
438625,497_15_54,GERMANY,10637,11,tibor pleiss,29,4,9,44.4,4,9,44.4,0,0,0,2,2,100,2,8,10,0,3,1,0,1,10
438626,497_15_54,GERMANY,6326,12,robin benzing,16,1,4,25,0,2,0,1,2,50,0,0,0,0,3,3,0,3,1,0,0,3
438627,497_15_54,GERMANY,4711,14,dirk nowitzki,29,3,6,50,1,2,50,2,4,50,2,2,100,0,7,7,1,1,5,0,0,10
438628,497_15_54,GERMANY,19990,17,dennis schroder,31,8,15,53.3,5,9,55.6,3,6,50,7,8,87.5,0,6,6,7,2,2,0,0,26
438629,497_15_54,GERMANY,29500,21,paul zipser,25,3,7,42.9,2,4,50,1,3,33.3,0,0,0,0,3,3,1,4,2,0,0,7
438630,497_15_54,GERMANY,1152,25,anton gavel,3,0,1,0,0,1,0,0,0,0,0,0,0,0,0,0,0,1,0,0,0,0
438631,497_15_54,GERMANY,19867,77,johannes voigtmann,5,2,2,100,2,2,100,0,0,0,0,0,0,0,1,1,0,1,0,0,0,4
438632,497_15_54,GERMANY,0,TOTALS,GERMANY,200,28,58,48.3,19,36,52.8,9,22,40.9,11,12,91.7,3,34,37,14,24,14,1,2,76
438633,497_15_54,SPAIN,61,4,pau gasol,33,6,14,42.9,6,14,42.9,0,0,0,4,6,66.7,3,8,11,6,1,1,0,3,16
438634,497_15_54,SPAIN,70,5,rudy fernandez,24,1,8,12.5,1,5,20,0,3,0,3,4,75,0,5,5,2,1,0,3,0,5
438635,497_15_54,SPAIN,1877,6,sergio rodriguez,23,7,11,63.6,4,7,57.1,3,4,75,2,2,100,1,2,3,3,2,3,0,0,19
438636,497_15_54,SPAIN,17609,7,guillermo hernangomez,3,1,1,100,1,1,100,0,0,0,0,0,0,0,0,0,0,0,0,0,0,2
438637,497_15_54,SPAIN,5713,8,pau ribas tossas,30,3,6,50,1,3,33.3,2,3,66.7,0,0,0,2,1,3,2,4,0,3,0,8
438638,497_15_54,SPAIN,66,9,felipe reyes,15,0,2,0,0,2,0,0,0,0,1,2,50,0,2,2,0,0,0,0,0,1
438639,497_15_54,SPAIN,2628,10,victor claver,0,0,0,0,0,0,0,0,0,0,0,0,0,0,0,0,0,0,0,0,0,0
438640,497_15_54,SPAIN,1317,11,fernando san emeterio,13,0,3,0,0,2,0,0,1,0,0,0,0,0,1,1,1,3,0,1,0,0
438641,497_15_54,SPAIN,1871,12,sergio llull,30,3,10,30,2,4,50,1,6,16.7,7,8,87.5,0,1,1,0,4,1,1,0,14
438642,497_15_54,SPAIN,6265,13,pablo aguilar,0,0,0,0,0,0,0,0,0,0,0,0,0,0,0,0,0,0,0,0,0,0
438643,497_15_54,SPAIN,17234,14,nikola mirotic,29,5,9,55.6,4,5,80,1,4,25,1,2,50,2,5,7,1,1,0,0,0,12
438644,497_15_54,SPAIN,19987,15,guillem vives,0,0,0,0,0,0,0,0,0,0,0,0,0,0,0,0,0,0,0,0,0,0
438645,497_15_54,SPAIN,0,TOTALS,SPAIN,200,26,64,40.6,19,43,44.2,7,21,33.3,18,24,75,9,26,35,15,16,6,8,3,77
438646,497_15_55,GEORGIA,24223,0,jacob everse pullen,23,4,8,50,2,3,66.7,2,5,40,0,0,0,0,1,1,1,1,1,0,0,10
438647,497_15_55,GEORGIA,8378,4,nika metreveli,0,0,0,0,0,0,0,0,0,0,0,0,0,0,0,0,0,0,0,0,0,0
438648,497_15_55,GEORGIA,4919,7,zaza pachulia,25,4,11,36.4,4,11,36.4,0,0,0,4,4,100,0,7,7,3,2,2,1,2,12
438649,497_15_55,GEORGIA,1690,8,george tsintsadze,24,0,0,0,0,0,0,0,0,0,2,2,100,0,3,3,4,3,3,0,0,2
438650,497_15_55,GEORGIA,6436,9,giorgi shermadini,15,0,1,0,0,1,0,0,0,0,2,2,100,0,3,3,2,0,1,1,1,2
438651,497_15_55,GEORGIA,15684,10,duda sanadze,14,5,8,62.5,3,4,75,2,4,50,0,0,0,0,2,2,1,3,0,1,0,12
438652,497_15_55,GEORGIA,1697,11,manuchar markoishvili,26,4,10,40,2,4,50,2,6,33.3,0,0,0,1,1,2,0,0,1,0,0,10
438653,497_15_55,GEORGIA,12467,12,levan patsatsia,0,0,0,0,0,0,0,0,0,0,0,0,0,0,0,0,0,0,0,0,0,0
438654,497_15_55,GEORGIA,1699,13,viktor sanikidze,35,5,6,83.3,4,4,100,1,2,50,1,1,100,1,4,5,4,2,2,0,4,12
438655,497_15_55,GEORGIA,16022,15,beka burjanadze,6,0,1,0,0,0,0,0,1,0,0,0,0,0,0,0,0,2,2,0,0,0
438656,497_15_55,GEORGIA,11036,23,tornike shengelia,32,5,8,62.5,5,7,71.4,0,1,0,1,4,25,1,5,6,5,3,0,2,2,11
438657,497_15_55,GEORGIA,1693,25,besik lezhava,0,0,0,0,0,0,0,0,0,0,0,0,0,0,0,0,0,0,0,0,0,0
438658,497_15_55,GEORGIA,0,TOTALS,GEORGIA,200,27,53,50.9,20,34,58.8,7,19,36.8,10,13,76.9,3,27,30,20,16,13,5,9,71
438659,497_15_55,CROATIA,1844,4,ante tomic,20,4,8,50,4,8,50,0,0,0,2,2,100,1,4,5,2,4,1,0,2,10
438660,497_15_55,CROATIA,1846,5,damjan rudez,13,0,4,0,0,1,0,0,3,0,2,2,100,0,1,1,2,2,2,0,0,2
438661,497_15_55,CROATIA,1915,6,rok stipcevic,17,3,6,50,2,3,66.7,1,3,33.3,1,1,100,4,0,4,5,0,2,1,0,8
438662,497_15_55,CROATIA,6280,7,bojan bogdanovic,31,1,10,10,0,3,0,1,7,14.3,4,4,100,1,4,5,4,1,2,0,0,7
438663,497_15_55,CROATIA,15894,8,dario saric,25,2,9,22.2,2,6,33.3,0,3,0,1,2,50,0,3,3,0,3,3,0,0,5
438664,497_15_55,CROATIA,1251,9,marko tomas,0,0,0,0,0,0,0,0,0,0,0,0,0,0,0,0,0,0,0,0,0,0
438665,497_15_55,CROATIA,4585,10,roko ukic,15,1,2,50,0,1,0,1,1,100,0,0,0,0,0,0,1,0,0,0,0,3
438666,497_15_55,CROATIA,1249,11,krunoslav simon,24,2,5,40,1,2,50,1,3,33.3,0,0,0,0,5,5,4,2,1,0,0,5
438667,497_15_55,CROATIA,18342,13,dontaye draper,10,1,1,100,1,1,100,0,0,0,0,0,0,0,0,0,0,2,2,0,0,2
438668,497_15_55,CROATIA,10624,15,miro bilan,1,0,0,0,0,0,0,0,0,0,0,0,0,0,1,1,0,1,0,0,0,0
438669,497_15_55,CROATIA,16607,21,luka zoric,20,7,14,50,7,14,50,0,0,0,2,2,100,2,2,4,1,2,2,0,0,16
438670,497_15_55,CROATIA,18415,23,mario hezonja,24,0,3,0,0,0,0,0,3,0,0,0,0,2,2,4,2,1,1,0,1,0
438671,497_15_55,CROATIA,0,TOTALS,CROATIA,200,21,62,33.9,17,39,43.6,4,23,17.4,12,13,92.3,13,24,37,21,18,17,1,3,58
438672,497_15_56,LATVIA,19755,5,mareks mejeris,19,0,3,0,0,2,0,0,1,0,0,0,0,2,1,3,1,2,3,0,1,0
438673,497_15_56,LATVIA,2539,6,rolands freimanis,19,5,11,45.5,5,10,50,0,1,0,1,2,50,2,3,5,1,5,0,0,1,11
438674,497_15_56,LATVIA,5029,7,janis blums,23,2,4,50,0,0,0,2,4,50,0,0,0,0,1,1,2,2,1,0,0,6
438675,497_15_56,LATVIA,6271,9,dairis bertans,26,3,8,37.5,2,4,50,1,4,25,2,2,100,0,4,4,3,2,1,1,0,9
438676,497_15_56,LATVIA,12927,10,janis timma,30,5,8,62.5,2,4,50,3,4,75,2,2,100,1,5,6,2,2,2,1,0,15
438677,497_15_56,LATVIA,4604,12,kristaps janicenoks,28,2,6,33.3,2,3,66.7,0,3,0,1,2,50,0,1,1,1,0,0,0,0,5
438678,497_15_56,LATVIA,10585,13,janis strelnieks,30,6,9,66.7,6,8,75,0,1,0,9,12,75,0,5,5,3,1,1,3,0,21
438679,497_15_56,LATVIA,1002,14,kaspars berzins,10,1,2,50,1,2,50,0,0,0,0,0,0,1,2,3,2,1,2,0,1,2
438680,497_15_56,LATVIA,12931,19,kaspars vecvagars,0,0,0,0,0,0,0,0,0,0,0,0,0,0,0,0,0,0,0,0,0,0
438681,497_15_56,LATVIA,11058,23,haralds karlis,0,0,0,0,0,0,0,0,0,0,0,0,0,0,0,0,0,0,0,0,0,0
438682,497_15_56,LATVIA,29509,31,zanis peiners,11,1,4,25,1,3,33.3,0,1,0,1,2,50,0,1,1,0,1,0,1,0,3
438683,497_15_56,LATVIA,15602,33,martins meiers,4,1,1,100,1,1,100,0,0,0,1,1,100,0,2,2,1,1,0,0,0,3
438684,497_15_56,LATVIA,0,TOTALS,LATVIA,200,26,56,46.4,20,37,54.1,6,19,31.6,17,23,73.9,9,27,36,16,17,13,6,3,75
438685,497_15_56,ESTONIA,11295,4,rain veideman,36,2,8,25,0,4,0,2,4,50,0,0,0,1,5,6,8,3,1,0,0,6
438686,497_15_56,ESTONIA,1218,5,tanel sokk,0,0,0,0,0,0,0,0,0,0,0,0,0,0,0,0,0,0,0,0,0,0
438687,497_15_56,ESTONIA,1219,6,gert dorbek,0,0,0,0,0,0,0,0,0,0,0,0,0,0,0,0,0,0,0,0,0,0
438688,497_15_56,ESTONIA,2721,7,sten sokk,24,2,6,33.3,1,2,50,1,4,25,3,3,100,2,2,4,5,5,4,2,0,8
438689,497_15_56,ESTONIA,4625,8,janar talts,25,4,9,44.4,2,6,33.3,2,3,66.7,2,2,100,0,1,1,0,4,2,0,2,12
438690,497_15_56,ESTONIA,4622,9,gregor arbet,33,7,11,63.6,5,7,71.4,2,4,50,0,0,0,2,4,6,1,5,2,0,0,16
438691,497_15_56,ESTONIA,6373,10,erik keedus,0,0,0,0,0,0,0,0,0,0,0,0,0,0,0,0,0,0,0,0,0,0
438692,497_15_56,ESTONIA,6377,11,siim-sander vene,21,0,4,0,0,4,0,0,0,0,0,2,0,0,1,1,2,1,1,0,1,0
438693,497_15_56,ESTONIA,15312,13,joosep toome,8,3,4,75,2,3,66.7,1,1,100,3,3,100,2,0,2,0,3,1,0,0,10
438694,497_15_56,ESTONIA,4771,14,kristjan kangur,30,3,11,27.3,2,7,28.6,1,4,25,2,2,100,1,7,8,1,4,1,1,0,9
438695,497_15_56,ESTONIA,1229,15,reinar hallik,0,0,0,0,0,0,0,0,0,0,0,0,0,0,0,0,0,0,0,0,0,0
438696,497_15_56,ESTONIA,8047,20,tanel kurbas,23,1,6,16.7,0,4,0,1,2,50,0,0,0,0,4,4,0,1,1,0,0,3
438697,497_15_56,ESTONIA,0,TOTALS,ESTONIA,200,22,59,37.3,12,37,32.4,10,22,45.5,10,12,83.3,9,27,36,17,26,14,3,3,64
438698,497_15_57,ISRAEL,24229,5,dagan yivzori,23,2,6,33.3,2,3,66.7,0,3,0,0,0,0,0,4,4,2,2,1,0,0,4
438699,497_15_57,ISRAEL,21841,6,shawn dawson,27,4,6,66.7,2,3,66.7,2,3,66.7,1,2,50,0,0,0,1,2,1,1,1,11
438700,497_15_57,ISRAEL,2522,7,gal mekel,0,0,0,0,0,0,0,0,0,0,0,0,0,0,0,0,0,0,0,0,0,0
438701,497_15_57,ISRAEL,1023,8,lior eliyahu,0,0,0,0,0,0,0,0,0,0,0,0,0,0,0,0,0,0,0,0,0,0
438702,497_15_57,ISRAEL,1933,9,omri casspi,0,0,0,0,0,0,0,0,0,0,0,0,0,0,0,0,0,0,0,0,0,0
438703,497_15_57,ISRAEL,1022,10,raviv limonad,27,5,10,50,4,9,44.4,1,1,100,2,2,100,0,0,0,3,1,3,0,0,13
438704,497_15_57,ISRAEL,5780,11,elishay kadir,36,4,11,36.4,4,11,36.4,0,0,0,0,0,0,2,7,9,4,2,1,1,0,8
438705,497_15_57,ISRAEL,1685,12,yogev ohayon,25,1,7,14.3,1,7,14.3,0,0,0,0,0,0,0,1,1,4,2,1,0,0,2
438706,497_15_57,ISRAEL,4620,14,yaniv green,13,0,4,0,0,4,0,0,0,0,0,0,0,1,2,3,1,2,0,1,3,0
438707,497_15_57,ISRAEL,29504,15,dor fischer,10,1,5,20,1,5,20,0,0,0,1,2,50,2,0,2,1,1,0,1,2,3
438708,497_15_57,ISRAEL,19712,16,boris rothbart,16,4,8,50,3,7,42.9,1,1,100,2,2,100,2,3,5,2,4,1,0,1,11
438709,497_15_57,ISRAEL,12887,23,bar timor,23,4,6,66.7,3,4,75,1,2,50,0,0,0,0,2,2,4,3,4,0,0,9
438710,497_15_57,ISRAEL,0,TOTALS,ISRAEL,200,25,63,39.7,20,53,37.7,5,10,50,6,8,75,8,21,29,22,19,13,4,7,61
438711,497_15_57,FRANCE,11077,4,leo j. p. westermann,13,3,5,60,1,1,100,2,4,50,0,0,0,0,1,1,3,2,2,2,0,8
438712,497_15_57,FRANCE,2588,5,nicolas batum,20,3,6,50,3,4,75,0,2,0,2,2,100,0,3,3,1,0,3,2,1,8
438713,497_15_57,FRANCE,11076,7,joffrey lauvergne,20,7,10,70,7,9,77.8,0,1,0,0,1,0,2,5,7,2,1,3,1,0,14
438714,497_15_57,FRANCE,1864,8,charles kahudi,14,2,5,40,1,3,33.3,1,2,50,0,0,0,1,1,2,1,0,0,0,1,5
438715,497_15_57,FRANCE,5047,9,tony parker,22,0,5,0,0,5,0,0,0,0,0,0,0,0,2,2,4,1,1,0,0,0
438716,497_15_57,FRANCE,12971,10,evan fournier,21,4,8,50,0,2,0,4,6,66.7,0,0,0,0,0,0,2,2,1,0,0,12
438717,497_15_57,FRANCE,4663,11,florent pietrus,18,1,2,50,1,2,50,0,0,0,1,3,33.3,3,3,6,1,0,0,0,0,3
438718,497_15_57,FRANCE,10428,12,nando de colo,17,2,5,40,1,1,100,1,4,25,0,0,0,0,3,3,4,4,0,0,0,5
438719,497_15_57,FRANCE,4665,13,boris diaw,16,2,5,40,2,5,40,0,0,0,0,0,0,1,2,3,3,0,1,0,0,4
438720,497_15_57,FRANCE,5044,15,mickael gelabale,16,3,6,50,3,5,60,0,1,0,4,4,100,2,3,5,0,0,0,0,0,10
438721,497_15_57,FRANCE,17374,16,rudy gobert,19,6,10,60,6,10,60,0,0,0,3,3,100,5,5,10,1,2,2,1,0,15
438722,497_15_57,FRANCE,17677,19,mouhammadou jaiteh,5,1,3,33.3,1,3,33.3,0,0,0,0,0,0,2,0,2,0,0,0,0,0,2
438723,497_15_57,FRANCE,0,TOTALS,FRANCE,200,34,70,48.6,26,50,52,8,20,40,10,13,76.9,17,29,46,22,12,13,6,2,86
438724,497_15_58,TURKEY,20222,4,kartal ozmizrak,1,0,0,0,0,0,0,0,0,0,2,2,100,0,0,0,0,0,0,0,0,2
438725,497_15_58,TURKEY,15304,5,sinan guler,31,4,8,50,3,7,42.9,1,1,100,2,2,100,2,3,5,5,3,0,0,0,11
438726,497_15_58,TURKEY,20219,6,cedi osman,38,8,14,57.1,7,10,70,1,4,25,5,8,62.5,3,1,4,6,5,1,2,0,22
438727,497_15_58,TURKEY,2576,7,baris hersek,16,1,3,33.3,1,2,50,0,1,0,0,0,0,0,1,1,2,0,0,0,0,2
438728,497_15_58,TURKEY,1802,8,ersan ilyasova,28,4,12,33.3,4,8,50,0,4,0,11,14,78.6,3,3,6,6,2,1,0,1,19
438729,497_15_58,TURKEY,1797,9,semih erden,29,8,9,88.9,8,9,88.9,0,0,0,2,2,100,0,2,2,0,2,2,0,1,18
438730,497_15_58,TURKEY,8151,10,melih mahmutoglu,21,1,6,16.7,0,0,0,1,6,16.7,0,0,0,0,3,3,3,3,3,0,0,3
438731,497_15_58,TURKEY,1796,11,oguz savas,1,0,0,0,0,0,0,0,0,0,0,0,0,0,0,0,0,0,0,0,0,0
438732,497_15_58,TURKEY,24656,12,furkan korkmaz,1,0,0,0,0,0,0,0,0,0,0,0,0,0,1,1,0,0,0,0,0,0
438733,497_15_58,TURKEY,29512,13,ali muhammed,39,9,14,64.3,3,6,50,6,8,75,4,4,100,3,9,12,4,2,4,1,0,28
438734,497_15_58,TURKEY,17253,14,huseyin koksal,6,0,3,0,0,1,0,0,2,0,0,0,0,0,2,2,1,1,1,0,0,0
438735,497_15_58,TURKEY,10942,15,furkan aldemir,15,2,5,40,2,5,40,0,0,0,2,2,100,4,5,9,2,1,1,0,0,6
438736,497_15_58,TURKEY,0,TOTALS,TURKEY,225,37,74,50,28,48,58.3,9,26,34.6,28,34,82.4,19,34,53,29,19,13,3,2,111
438737,497_15_58,ICELAND,19926,3,martin hermannsson,11,3,6,50,3,5,60,0,1,0,0,0,0,0,0,0,3,1,0,0,0,6
438738,497_15_58,ICELAND,24208,4,axel karason,0,0,0,0,0,0,0,0,0,0,0,0,0,0,0,0,0,1,0,0,0,0
438739,497_15_58,ICELAND,15700,5,ragnar nathanaelsson,0,0,0,0,0,0,0,0,0,0,0,0,0,0,0,0,0,0,0,0,0,0
438740,497_15_58,ICELAND,4834,6,jakob sigurdarson,31,9,13,69.2,5,5,100,4,8,50,0,0,0,0,1,1,2,2,0,0,0,22
438741,497_15_58,ICELAND,4841,8,hlynur baeringsson,37,5,9,55.6,5,6,83.3,0,3,0,2,4,50,2,6,8,3,3,0,1,0,12
438742,497_15_58,ICELAND,4837,9,jon stefansson,35,4,15,26.7,2,10,20,2,5,40,4,5,80,3,1,4,8,3,2,0,0,14
438743,497_15_58,ICELAND,4840,10,helgi magnusson,0,0,0,0,0,0,0,0,0,0,0,0,0,0,0,0,0,1,0,0,0,0
438744,497_15_58,ICELAND,2764,13,hordur vilhjalmsson,34,1,7,14.3,0,2,0,1,5,20,4,4,100,1,1,2,4,3,2,0,0,7
438745,497_15_58,ICELAND,4980,14,logi gunnarsson,16,6,7,85.7,2,2,100,4,5,80,0,0,0,0,2,2,0,2,1,0,0,16
438746,497_15_58,ICELAND,2071,15,pavel ermolinskij,34,2,9,22.2,1,2,50,1,7,14.3,2,4,50,1,5,6,2,4,1,1,0,7
438747,497_15_58,ICELAND,13211,24,haukur palsson,26,6,11,54.5,1,4,25,5,7,71.4,1,4,25,0,3,3,4,4,0,1,1,18
438748,497_15_58,ICELAND,15702,29,aegir steinarsson,1,0,0,0,0,0,0,0,0,0,0,0,0,0,0,0,1,1,0,0,0,0
438749,497_15_58,ICELAND,0,TOTALS,ICELAND,225,36,77,46.8,19,36,52.8,17,41,41.5,13,21,61.9,10,21,31,27,25,7,3,1,102
438750,497_15_59,GREECE,5050,5,yannis bourousis,20,3,4,75,2,3,66.7,1,1,100,2,5,40,3,3,6,3,3,1,0,0,9
438751,497_15_59,GREECE,123,6,nikos zisis,14,2,4,50,1,3,33.3,1,1,100,0,0,0,0,0,0,3,1,0,0,0,5
438752,497_15_59,GREECE,125,7,vassilis spanoulis,0,0,0,0,0,0,0,0,0,0,0,0,0,0,0,0,0,0,0,0,0,0
438753,497_15_59,GREECE,12472,8,nick calathes,21,2,4,50,1,2,50,1,2,50,1,2,50,0,2,2,5,4,2,1,1,6
438754,497_15_59,GREECE,1057,9,stratos perperoglou,14,2,5,40,1,2,50,1,3,33.3,0,0,0,0,1,1,0,0,0,0,0,5
438755,497_15_59,GREECE,8304,10,kostas sloukas,27,3,9,33.3,2,5,40,1,4,25,2,2,100,1,1,2,3,2,1,0,0,9
438756,497_15_59,GREECE,15374,12,kostas kaimakoglou,21,2,9,22.2,2,4,50,0,5,0,0,0,0,0,1,1,2,1,2,1,0,4
438757,497_15_59,GREECE,10607,13,kostas koufos,20,4,7,57.1,4,7,57.1,0,0,0,1,2,50,1,2,3,1,4,0,0,3,9
438758,497_15_59,GREECE,1056,15,georgios printezis,13,1,2,50,1,2,50,0,0,0,2,2,100,0,2,2,2,1,0,0,0,4
438759,497_15_59,GREECE,10606,16,kostas papanikolaou,10,1,2,50,1,2,50,0,0,0,0,0,0,1,2,3,0,2,2,0,0,2
438760,497_15_59,GREECE,8303,17,evangelos mantzaris,19,2,4,50,2,2,100,0,2,0,0,0,0,1,1,2,1,2,1,0,0,4
438761,497_15_59,GREECE,24314,34,giannis antetokounmpo,22,3,4,75,1,1,100,2,3,66.7,3,4,75,2,9,11,3,4,1,0,0,11
438762,497_15_59,GREECE,0,TOTALS,GREECE,200,25,54,46.3,18,33,54.5,7,21,33.3,11,17,64.7,11,24,35,23,24,13,2,4,68
438763,497_15_59,NETHERLANDS,20407,0,yannick franke,0,0,0,0,0,0,0,0,0,0,0,0,0,0,0,0,0,0,0,0,0,0
438764,497_15_59,NETHERLANDS,15661,5,leon williams,14,1,3,33.3,1,3,33.3,0,0,0,1,4,25,0,0,0,0,2,0,0,0,3
438765,497_15_59,NETHERLANDS,24213,6,worthy de jong,13,2,3,66.7,2,3,66.7,0,0,0,0,0,0,0,0,0,0,0,1,1,0,4
438766,497_15_59,NETHERLANDS,15520,7,charlon kloof,29,3,6,50,2,4,50,1,2,50,8,11,72.7,1,5,6,4,1,2,1,0,15
438767,497_15_59,NETHERLANDS,10671,9,mohamed kherrazi,11,1,1,100,1,1,100,0,0,0,0,0,0,1,1,2,2,1,2,0,0,2
438768,497_15_59,NETHERLANDS,12501,10,ralf de pagter,0,0,0,0,0,0,0,0,0,0,0,0,0,0,0,0,0,0,0,0,0,0
438769,497_15_59,NETHERLANDS,29501,12,kees akerboom,23,2,9,22.2,0,1,0,2,8,25,0,0,0,2,1,3,1,4,1,0,0,6
438770,497_15_59,NETHERLANDS,2871,13,roeland schaftenaar,19,3,6,50,3,6,50,0,0,0,2,2,100,2,2,4,1,0,0,0,0,8
438771,497_15_59,NETHERLANDS,7480,18,nicolas de jong,23,4,9,44.4,4,9,44.4,0,0,0,0,0,0,1,5,6,0,2,1,0,1,8
438772,497_15_59,NETHERLANDS,5809,21,robin smeulders,21,2,6,33.3,2,5,40,0,1,0,1,2,50,2,6,8,0,3,1,0,0,5
438773,497_15_59,NETHERLANDS,5810,23,henk norel,17,5,6,83.3,5,6,83.3,0,0,0,1,4,25,0,0,0,1,2,0,0,0,11
438774,497_15_59,NETHERLANDS,10202,44,arvin slagter,30,1,5,20,0,2,0,1,3,33.3,0,0,0,0,1,1,4,5,2,0,0,3
438775,497_15_59,NETHERLANDS,0,TOTALS,NETHERLANDS,200,24,54,44.4,20,40,50,4,14,28.6,13,23,56.5,11,22,33,13,20,10,2,1,65
438776,497_15_60,CZECH REPUBLIC,4677,4,petr benda,28,5,8,62.5,4,7,57.1,1,1,100,0,0,0,1,2,3,2,2,1,1,1,11
438777,497_15_60,CZECH REPUBLIC,29502,5,patrik auda,1,0,0,0,0,0,0,0,0,0,0,0,0,0,1,1,0,0,0,0,0,0
438778,497_15_60,CZECH REPUBLIC,5478,6,pavel pumprla,25,4,6,66.7,3,5,60,1,1,100,0,0,0,2,2,4,1,0,4,2,0,9
438779,497_15_60,CZECH REPUBLIC,10700,7,vojtech hruban,27,4,7,57.1,2,3,66.7,2,4,50,2,4,50,0,1,1,1,3,0,1,0,12
438780,497_15_60,CZECH REPUBLIC,8325,8,tomas satoransky,40,3,14,21.4,1,8,12.5,2,6,33.3,3,4,75,3,6,9,15,4,5,0,0,11
438781,497_15_60,CZECH REPUBLIC,4774,9,jiri welsch,17,1,1,100,1,1,100,0,0,0,1,2,50,0,1,1,4,3,3,1,0,3
438782,497_15_60,CZECH REPUBLIC,1096,10,pavel houska,16,2,7,28.6,2,4,50,0,3,0,2,2,100,0,2,2,0,2,0,0,0,6
438783,497_15_60,CZECH REPUBLIC,4775,11,lubos barton,0,0,0,0,0,0,0,0,0,0,0,0,0,0,0,0,0,0,0,0,0,0
438784,497_15_60,CZECH REPUBLIC,8327,12,david jelinek,10,1,4,25,0,2,0,1,2,50,0,0,0,0,1,1,2,0,2,0,0,3
438785,497_15_60,CZECH REPUBLIC,10484,13,jakub sirina,0,0,0,0,0,0,0,0,0,0,0,0,0,0,0,0,0,0,0,0,0,0
438786,497_15_60,CZECH REPUBLIC,29503,14,blake schilb,40,7,13,53.8,3,4,75,4,9,44.4,0,1,0,0,8,8,1,4,1,0,0,18
438787,497_15_60,CZECH REPUBLIC,6362,24,jan vesely,21,4,7,57.1,4,7,57.1,0,0,0,0,1,0,0,1,1,1,5,3,0,0,8
438788,497_15_60,CZECH REPUBLIC,0,TOTALS,CZECH REPUBLIC,225,31,67,46.3,20,41,48.8,11,26,42.3,8,14,57.1,8,28,36,27,23,20,5,1,81
438789,497_15_60,LITHUANIA,1726,5,mantas kalnietis,37,6,21,28.6,4,14,28.6,2,7,28.6,1,4,25,1,2,3,4,3,2,0,0,15
438790,497_15_60,LITHUANIA,8963,6,deividas gailius,2,0,0,0,0,0,0,0,0,0,0,0,0,0,0,0,0,0,0,0,0,0
438791,497_15_60,LITHUANIA,980,8,jonas maciulis,36,4,13,30.8,3,10,30,1,3,33.3,2,4,50,0,6,6,1,5,2,2,1,11
438792,497_15_60,LITHUANIA,3474,10,renaldas seibutis,21,2,4,50,2,3,66.7,0,1,0,0,0,0,2,3,5,1,0,3,0,0,4
438793,497_15_60,LITHUANIA,22216,11,domantas sabonis,0,0,0,0,0,0,0,0,0,0,0,0,0,0,0,0,0,0,0,0,0,0
438794,497_15_60,LITHUANIA,3476,12,antanas kavaliauskas,12,2,3,66.7,2,3,66.7,0,0,0,1,1,100,1,2,3,0,2,1,0,0,5
438795,497_15_60,LITHUANIA,987,13,paulius jankunas,16,3,3,100,3,3,100,0,0,0,0,0,0,1,0,1,3,2,1,1,1,6
438796,497_15_60,LITHUANIA,24,15,robertas javtokas,3,0,0,0,0,0,0,0,0,0,0,0,0,0,0,0,0,1,0,0,0,0
438797,497_15_60,LITHUANIA,10916,17,jonas valanciunas,29,4,6,66.7,4,6,66.7,0,0,0,5,6,83.3,4,6,10,1,2,4,2,3,13
438798,497_15_60,LITHUANIA,10639,19,mindaugas kuzminskas,30,6,11,54.5,5,9,55.6,1,2,50,5,5,100,1,6,7,1,3,1,2,0,18
438799,497_15_60,LITHUANIA,29513,21,arturas milaknis,33,4,9,44.4,0,1,0,4,8,50,1,1,100,0,2,2,2,1,2,0,0,13
438800,497_15_60,LITHUANIA,17685,43,lukas lekavicius,6,0,1,0,0,0,0,0,1,0,0,0,0,0,0,0,2,1,1,0,0,0
438801,497_15_60,LITHUANIA,0,TOTALS,LITHUANIA,225,31,71,43.7,23,49,46.9,8,22,36.4,15,21,71.4,10,28,38,15,21,17,7,5,85
438802,497_15_61,LATVIA,19755,5,mareks mejeris,19,3,5,60,3,4,75,0,1,0,2,3,66.7,1,2,3,0,0,0,0,1,8
438803,497_15_61,LATVIA,2539,6,rolands freimanis,21,4,9,44.4,4,7,57.1,0,2,0,0,0,0,0,4,4,0,2,1,0,0,8
438804,497_15_61,LATVIA,5029,7,janis blums,20,2,4,50,2,2,100,0,2,0,0,0,0,0,2,2,0,2,1,0,0,4
438805,497_15_61,LATVIA,6271,9,dairis bertans,29,2,8,25,0,2,0,2,6,33.3,2,4,50,0,2,2,4,4,6,0,0,8
438806,497_15_61,LATVIA,12927,10,janis timma,17,1,2,50,1,1,100,0,1,0,2,2,100,0,5,5,2,0,1,0,0,4
438807,497_15_61,LATVIA,4604,12,kristaps janicenoks,29,2,5,40,0,2,0,2,3,66.7,2,2,100,1,1,2,2,4,2,0,0,8
438808,497_15_61,LATVIA,10585,13,janis strelnieks,34,6,10,60,5,6,83.3,1,4,25,4,4,100,0,6,6,8,3,3,1,0,17
438809,497_15_61,LATVIA,1002,14,kaspars berzins,26,5,7,71.4,4,5,80,1,2,50,2,2,100,0,6,6,3,4,1,0,5,13
438810,497_15_61,LATVIA,12931,19,kaspars vecvagars,0,0,0,0,0,0,0,0,0,0,0,0,0,0,0,0,0,0,0,0,0,0
438811,497_15_61,LATVIA,11058,23,haralds karlis,0,0,0,0,0,0,0,0,0,0,0,0,0,0,0,0,0,0,0,0,0,0
438812,497_15_61,LATVIA,29509,31,zanis peiners,0,0,0,0,0,0,0,0,0,0,0,0,0,0,0,0,0,0,0,0,0,0
438813,497_15_61,LATVIA,15602,33,martins meiers,5,1,3,33.3,1,3,33.3,0,0,0,1,2,50,2,0,2,0,0,0,0,0,3
438814,497_15_61,LATVIA,0,TOTALS,LATVIA,200,26,53,49.1,20,32,62.5,6,21,28.6,15,19,78.9,6,29,35,19,19,16,1,6,73
438815,497_15_61,SLOVENIA,4655,1,nebojsa joksimovic,3,0,1,0,0,1,0,0,0,0,0,0,0,0,1,1,0,0,0,0,0,0
438816,497_15_61,SLOVENIA,13125,5,luka rupnik,0,0,0,0,0,0,0,0,0,0,0,0,0,0,0,0,0,0,0,0,0,0
438817,497_15_61,SLOVENIA,17343,7,klemen prepelic,28,2,8,25,1,2,50,1,6,16.7,2,2,100,2,5,7,5,3,0,0,0,7
438818,497_15_61,SLOVENIA,15479,9,jaka blazic,26,4,11,36.4,4,9,44.4,0,2,0,0,0,0,1,4,5,2,2,1,0,0,8
438819,497_15_61,SLOVENIA,8251,10,mitja nikolic,9,1,2,50,1,1,100,0,1,0,1,2,50,2,0,2,0,3,0,0,0,3
438820,497_15_61,SLOVENIA,6197,12,zoran dragic,34,6,14,42.9,3,7,42.9,3,7,42.9,2,2,100,0,1,1,1,2,3,3,0,17
438821,497_15_61,SLOVENIA,4764,13,miha zupan,11,2,6,33.3,1,4,25,1,2,50,0,0,0,2,1,3,0,3,1,0,1,5
438822,497_15_61,SLOVENIA,24203,15,jure balazic,31,3,8,37.5,2,4,50,1,4,25,2,2,100,1,2,3,2,3,2,1,0,9
438823,497_15_61,SLOVENIA,1069,17,sasa zagorac,0,0,0,0,0,0,0,0,0,0,0,0,0,0,0,0,0,0,0,0,0,0
438824,497_15_61,SLOVENIA,17344,23,alen omic,22,2,7,28.6,2,7,28.6,0,0,0,3,4,75,2,2,4,0,1,0,0,1,7
438825,497_15_61,SLOVENIA,5782,24,jaka klobucar,22,2,4,50,0,1,0,2,3,66.7,0,0,0,0,4,4,3,3,2,0,0,6
438826,497_15_61,SLOVENIA,5023,55,uros slokar,14,2,5,40,2,5,40,0,0,0,0,0,0,0,0,0,0,2,0,0,0,4
438827,497_15_61,SLOVENIA,0,TOTALS,SLOVENIA,200,24,66,36.4,16,41,39,8,25,32,10,12,83.3,13,21,34,13,22,10,4,2,66
438828,497_15_62,GREECE,5050,5,yannis bourousis,20,6,10,60,5,8,62.5,1,2,50,1,2,50,1,2,3,2,3,0,1,2,14
438829,497_15_62,GREECE,123,6,nikos zisis,10,2,2,100,0,0,0,2,2,100,0,0,0,0,2,2,2,3,1,0,0,6
438830,497_15_62,GREECE,125,7,vassilis spanoulis,26,2,7,28.6,2,4,50,0,3,0,3,5,60,0,2,2,6,1,1,0,0,7
438831,497_15_62,GREECE,12472,8,nick calathes,20,2,4,50,2,3,66.7,0,1,0,0,0,0,0,0,0,5,1,0,0,0,4
438832,497_15_62,GREECE,1057,9,stratos perperoglou,5,0,2,0,0,2,0,0,0,0,2,2,100,0,1,1,0,0,0,0,0,2
438833,497_15_62,GREECE,8304,10,kostas sloukas,21,2,5,40,2,4,50,0,1,0,4,4,100,1,2,3,3,1,2,0,0,8
438834,497_15_62,GREECE,15374,12,kostas kaimakoglou,11,0,0,0,0,0,0,0,0,0,1,2,50,0,0,0,0,2,1,0,0,1
438835,497_15_62,GREECE,10607,13,kostas koufos,20,6,9,66.7,6,9,66.7,0,0,0,1,2,50,5,4,9,0,1,0,1,0,13
438836,497_15_62,GREECE,1056,15,georgios printezis,23,4,11,36.4,4,8,50,0,3,0,2,2,100,1,2,3,0,3,0,0,0,10
438837,497_15_62,GREECE,10606,16,kostas papanikolaou,6,0,0,0,0,0,0,0,0,0,0,0,0,0,1,1,1,0,0,0,0,0
438838,497_15_62,GREECE,8303,17,evangelos mantzaris,13,0,0,0,0,0,0,0,0,0,0,2,0,0,4,4,0,2,0,0,0,0
438839,497_15_62,GREECE,24314,34,giannis antetokounmpo,26,4,7,57.1,2,3,66.7,2,4,50,0,0,0,2,8,10,0,1,0,0,0,10
438840,497_15_62,GREECE,0,TOTALS,GREECE,200,28,57,49.1,23,41,56.1,5,16,31.2,14,21,66.7,10,28,38,19,18,7,2,2,75
438841,497_15_62,BELGIUM,10156,4,lionel bosco,9,1,1,100,1,1,100,0,0,0,0,0,0,0,0,0,2,2,1,0,0,2
438842,497_15_62,BELGIUM,2003,5,sam van rossom,27,5,12,41.7,4,4,100,1,8,12.5,2,2,100,1,4,5,3,3,2,0,0,13
438843,497_15_62,BELGIUM,4548,7,axel hervelle,20,1,5,20,1,3,33.3,0,2,0,0,0,0,2,4,6,2,5,1,3,0,2
438844,497_15_62,BELGIUM,6157,8,jean marc mwema,9,0,1,0,0,0,0,0,1,0,0,0,0,0,2,2,1,1,1,0,0,0
438845,497_15_62,BELGIUM,5599,9,jonathan tabu,17,3,8,37.5,3,6,50,0,2,0,0,0,0,1,1,2,1,2,1,0,0,6
438846,497_15_62,BELGIUM,8359,10,quentin serron,21,0,2,0,0,1,0,0,1,0,0,0,0,1,2,3,1,3,2,0,0,0
438847,497_15_62,BELGIUM,24196,12,wen mukubu,4,0,1,0,0,1,0,0,0,0,0,0,0,0,0,0,1,1,0,0,0,0
438848,497_15_62,BELGIUM,11181,13,pierre-antoine gillet,27,5,9,55.6,2,3,66.7,3,6,50,1,2,50,1,3,4,1,1,0,0,0,14
438849,497_15_62,BELGIUM,10498,14,maxime de zeeuw,15,0,3,0,0,2,0,0,1,0,0,2,0,0,1,1,0,0,0,0,0,0
438850,497_15_62,BELGIUM,19894,22,kevin tumba,13,1,1,100,1,1,100,0,0,0,0,1,0,0,1,1,0,3,0,0,2,2
438851,497_15_62,BELGIUM,15488,23,jean salumu,11,1,3,33.3,0,0,0,1,3,33.3,2,2,100,0,1,1,0,2,1,0,0,5
438852,497_15_62,BELGIUM,29508,24,matt lojeski,27,4,9,44.4,2,4,50,2,5,40,0,0,0,0,3,3,1,0,3,0,0,10
438853,497_15_62,BELGIUM,0,TOTALS,BELGIUM,200,21,55,38.2,14,26,53.8,7,29,24.1,5,9,55.6,6,23,29,13,23,12,3,2,54
438854,497_15_63,SPAIN,61,4,pau gasol,31,11,14,78.6,5,7,71.4,6,7,85.7,2,4,50,2,5,7,4,3,2,0,1,30
438855,497_15_63,SPAIN,70,5,rudy fernandez,0,0,0,0,0,0,0,0,0,0,0,0,0,0,0,0,0,0,0,0,0,0
438856,497_15_63,SPAIN,1877,6,sergio rodriguez,25,3,9,33.3,2,6,33.3,1,3,33.3,1,1,100,0,0,0,5,2,3,0,0,8
438857,497_15_63,SPAIN,17609,7,guillermo hernangomez,5,0,0,0,0,0,0,0,0,0,1,2,50,0,0,0,0,0,1,0,0,1
438858,497_15_63,SPAIN,5713,8,pau ribas tossas,30,2,4,50,1,1,100,1,3,33.3,0,0,0,0,2,2,3,1,1,2,0,5
438859,497_15_63,SPAIN,66,9,felipe reyes,19,1,4,25,1,4,25,0,0,0,2,2,100,4,1,5,3,2,1,0,0,4
438860,497_15_63,SPAIN,2628,10,victor claver,25,1,4,25,0,1,0,1,3,33.3,2,2,100,0,6,6,1,3,2,0,0,5
438861,497_15_63,SPAIN,1317,11,fernando san emeterio,19,0,3,0,0,2,0,0,1,0,0,0,0,0,3,3,2,0,2,0,0,0
438862,497_15_63,SPAIN,1871,12,sergio llull,20,4,8,50,3,4,75,1,4,25,3,3,100,0,1,1,3,2,0,0,0,12
438863,497_15_63,SPAIN,6265,13,pablo aguilar,2,0,1,0,0,0,0,0,1,0,0,0,0,0,0,0,0,0,0,0,0,0
438864,497_15_63,SPAIN,17234,14,nikola mirotic,23,6,9,66.7,5,5,100,1,4,25,2,3,66.7,2,6,8,0,1,1,0,0,15
438865,497_15_63,SPAIN,19987,15,guillem vives,2,0,0,0,0,0,0,0,0,0,0,0,0,0,0,0,0,0,1,0,0,0
438866,497_15_63,SPAIN,0,TOTALS,SPAIN,200,28,56,50,17,30,56.7,11,26,42.3,13,17,76.5,10,28,38,21,14,16,2,1,80
438867,497_15_63,POLAND,15535,0,aleksander czyz,2,1,1,100,1,1,100,0,0,0,0,0,0,0,1,1,0,0,0,0,0,2
438868,497_15_63,POLAND,5694,5,aaron cel,15,2,4,50,1,2,50,1,2,50,0,0,0,2,0,2,1,2,0,0,0,5
438869,497_15_63,POLAND,29496,6,aj slaughter,32,4,12,33.3,3,6,50,1,6,16.7,0,0,0,0,1,1,6,0,0,1,0,9
438870,497_15_63,POLAND,7833,7,damian kulig,25,3,3,100,2,2,100,1,1,100,3,5,60,1,5,6,0,3,0,0,0,10
438871,497_15_63,POLAND,15981,9,mateusz ponitka,29,4,9,44.4,3,6,50,1,3,33.3,0,1,0,1,2,3,3,4,1,0,0,9
438872,497_15_63,POLAND,8034,12,adam waczynski,34,4,10,40,4,7,57.1,0,3,0,1,2,50,0,4,4,2,1,4,0,0,9
438873,497_15_63,POLAND,1215,13,marcin gortat,26,3,8,37.5,3,8,37.5,0,0,0,3,4,75,0,2,2,2,5,1,0,0,9
438874,497_15_63,POLAND,1207,15,lukasz koszarek,11,0,3,0,0,2,0,0,1,0,0,0,0,0,1,1,0,0,2,0,0,0
438875,497_15_63,POLAND,24194,17,przemyslaw zamojski,9,2,3,66.7,1,1,100,1,2,50,0,0,0,2,1,3,0,3,0,0,0,5
438876,497_15_63,POLAND,12920,24,przemyslaw karnowski,14,3,8,37.5,3,8,37.5,0,0,0,0,0,0,0,2,2,2,2,0,1,0,6
438877,497_15_63,POLAND,6186,33,karol gruszecki,2,0,0,0,0,0,0,0,0,0,0,0,0,0,0,0,0,0,1,0,0,0
438878,497_15_63,POLAND,4799,66,robert skibniewski,2,1,1,100,1,1,100,0,0,0,0,0,0,0,0,0,0,0,0,2,0,2
438879,497_15_63,POLAND,0,TOTALS,POLAND,200,27,62,43.5,22,44,50,5,18,27.8,7,12,58.3,6,20,26,16,20,9,4,0,66
438880,497_15_64,FRANCE,11077,4,leo j. p. westermann,5,0,2,0,0,1,0,0,1,0,0,0,0,0,0,0,0,1,0,0,0,0
438881,497_15_64,FRANCE,2588,5,nicolas batum,22,4,12,33.3,2,7,28.6,2,5,40,0,0,0,2,3,5,0,3,0,1,1,10
438882,497_15_64,FRANCE,11076,7,joffrey lauvergne,20,4,8,50,2,6,33.3,2,2,100,2,2,100,3,6,9,1,3,3,2,2,12
438883,497_15_64,FRANCE,1864,8,charles kahudi,6,0,0,0,0,0,0,0,0,0,1,2,50,0,1,1,0,0,0,0,1,1
438884,497_15_64,FRANCE,5047,9,tony parker,25,2,8,25,1,4,25,1,4,25,0,0,0,0,0,0,3,2,3,2,0,5
438885,497_15_64,FRANCE,12971,10,evan fournier,18,5,9,55.6,3,4,75,2,5,40,0,0,0,2,4,6,2,2,1,3,0,12
438886,497_15_64,FRANCE,4663,11,florent pietrus,15,0,0,0,0,0,0,0,0,0,0,0,0,0,3,3,0,2,0,0,0,0
438887,497_15_64,FRANCE,10428,12,nando de colo,28,6,9,66.7,4,5,80,2,4,50,1,3,33.3,2,5,7,7,2,3,1,0,15
438888,497_15_64,FRANCE,4665,13,boris diaw,20,2,2,100,2,2,100,0,0,0,0,0,0,0,3,3,5,3,1,0,0,4
438889,497_15_64,FRANCE,5044,15,mickael gelabale,16,2,6,33.3,0,2,0,2,4,50,0,0,0,1,0,1,0,0,1,1,1,6
438890,497_15_64,FRANCE,17374,16,rudy gobert,20,3,3,100,3,3,100,0,0,0,1,2,50,1,2,3,0,2,0,0,1,7
438891,497_15_64,FRANCE,17677,19,mouhammadou jaiteh,5,2,4,50,2,4,50,0,0,0,0,0,0,1,0,1,0,2,1,0,0,4
438892,497_15_64,FRANCE,0,TOTALS,FRANCE,200,30,63,47.6,19,38,50,11,25,44,5,9,55.6,12,29,41,18,22,16,10,6,76
438893,497_15_64,TURKEY,20222,4,kartal ozmizrak,7,0,2,0,0,0,0,0,2,0,0,0,0,0,0,0,0,0,1,0,0,0
438894,497_15_64,TURKEY,15304,5,sinan guler,23,2,4,50,1,2,50,1,2,50,0,0,0,0,1,1,4,2,1,0,0,5
438895,497_15_64,TURKEY,20219,6,cedi osman,37,2,9,22.2,1,5,20,1,4,25,0,0,0,2,5,7,2,2,1,0,0,5
438896,497_15_64,TURKEY,2576,7,baris hersek,9,0,1,0,0,1,0,0,0,0,0,0,0,1,0,1,0,2,0,0,0,0
438897,497_15_64,TURKEY,1802,8,ersan ilyasova,29,5,13,38.5,3,8,37.5,2,5,40,2,4,50,2,8,10,0,1,5,0,0,14
438898,497_15_64,TURKEY,1797,9,semih erden,23,2,2,100,2,2,100,0,0,0,3,4,75,0,2,2,0,3,1,1,0,7
438899,497_15_64,TURKEY,8151,10,melih mahmutoglu,11,0,4,0,0,1,0,0,3,0,0,0,0,0,1,1,0,0,1,1,0,0
438900,497_15_64,TURKEY,1796,11,oguz savas,4,0,2,0,0,2,0,0,0,0,0,0,0,0,0,0,0,0,0,0,0,0
438901,497_15_64,TURKEY,24656,12,furkan korkmaz,8,1,4,25,0,3,0,1,1,100,3,4,75,0,1,1,0,0,2,0,1,6
438902,497_15_64,TURKEY,29512,13,ali muhammed,32,4,13,30.8,3,6,50,1,7,14.3,0,0,0,0,1,1,5,0,2,0,0,9
438903,497_15_64,TURKEY,17253,14,huseyin koksal,5,0,1,0,0,0,0,0,1,0,0,0,0,0,0,0,0,1,0,0,0,0
438904,497_15_64,TURKEY,10942,15,furkan aldemir,13,3,4,75,3,3,100,0,1,0,1,2,50,3,1,4,0,2,0,0,0,7
438905,497_15_64,TURKEY,0,TOTALS,TURKEY,200,19,59,32.2,13,33,39.4,6,26,23.1,9,14,64.3,12,22,34,11,14,14,2,1,53
438906,497_15_65,CROATIA,1844,4,ante tomic,15,0,3,0,0,3,0,0,0,0,0,0,0,1,1,2,0,1,1,0,0,0
438907,497_15_65,CROATIA,1846,5,damjan rudez,8,0,0,0,0,0,0,0,0,0,0,0,0,0,1,1,0,1,1,0,0,0
438908,497_15_65,CROATIA,1915,6,rok stipcevic,15,3,5,60,1,1,100,2,4,50,0,0,0,0,1,1,0,3,0,1,0,8
438909,497_15_65,CROATIA,6280,7,bojan bogdanovic,32,5,14,35.7,4,9,44.4,1,5,20,1,2,50,0,3,3,1,2,2,1,0,12
438910,497_15_65,CROATIA,15894,8,dario saric,31,1,7,14.3,1,5,20,0,2,0,2,2,100,2,6,8,4,1,3,2,1,4
438911,497_15_65,CROATIA,1251,9,marko tomas,0,0,0,0,0,0,0,0,0,0,0,0,0,0,0,0,0,0,0,0,0,0
438912,497_15_65,CROATIA,4585,10,roko ukic,31,3,7,42.9,1,3,33.3,2,4,50,2,2,100,1,1,2,5,2,6,0,0,10
438913,497_15_65,CROATIA,1249,11,krunoslav simon,11,3,5,60,2,2,100,1,3,33.3,2,2,100,0,1,1,1,0,2,1,0,9
438914,497_15_65,CROATIA,18342,13,dontaye draper,3,0,0,0,0,0,0,0,0,0,0,0,0,0,1,1,0,0,0,0,0,0
438915,497_15_65,CROATIA,10624,15,miro bilan,11,1,3,33.3,1,3,33.3,0,0,0,2,2,100,1,0,1,0,0,1,1,0,4
438916,497_15_65,CROATIA,16607,21,luka zoric,14,1,3,33.3,1,3,33.3,0,0,0,0,0,0,0,0,0,1,1,2,0,0,2
438917,497_15_65,CROATIA,18415,23,mario hezonja,29,3,7,42.9,2,4,50,1,3,33.3,3,4,75,0,9,9,1,3,5,2,1,10
438918,497_15_65,CROATIA,0,TOTALS,CROATIA,200,20,54,37,13,33,39.4,7,21,33.3,12,14,85.7,7,24,31,13,14,24,8,2,59
438919,497_15_65,CZECH REPUBLIC,4677,4,petr benda,29,5,11,45.5,4,8,50,1,3,33.3,0,0,0,1,2,3,3,1,0,0,1,11
438920,497_15_65,CZECH REPUBLIC,29502,5,patrik auda,16,3,6,50,2,5,40,1,1,100,2,2,100,2,1,3,2,1,2,0,0,9
438921,497_15_65,CZECH REPUBLIC,5478,6,pavel pumprla,11,0,2,0,0,2,0,0,0,0,0,0,0,0,1,1,0,2,1,1,1,0
438922,497_15_65,CZECH REPUBLIC,10700,7,vojtech hruban,5,0,2,0,0,1,0,0,1,0,0,0,0,1,0,1,0,0,0,0,0,0
438923,497_15_65,CZECH REPUBLIC,8325,8,tomas satoransky,36,4,10,40,4,7,57.1,0,3,0,2,4,50,1,4,5,11,3,5,3,0,10
438924,497_15_65,CZECH REPUBLIC,4774,9,jiri welsch,25,1,5,20,1,4,25,0,1,0,0,0,0,0,1,1,8,3,1,2,0,2
438925,497_15_65,CZECH REPUBLIC,1096,10,pavel houska,0,0,0,0,0,0,0,0,0,0,0,0,0,0,0,0,0,0,0,0,0,0
438926,497_15_65,CZECH REPUBLIC,4775,11,lubos barton,0,1,1,100,0,0,0,1,1,100,0,0,0,0,0,0,0,0,0,0,0,3
438927,497_15_65,CZECH REPUBLIC,8327,12,david jelinek,16,5,8,62.5,3,5,60,2,3,66.7,1,2,50,1,2,3,0,2,0,1,0,13
438928,497_15_65,CZECH REPUBLIC,10484,13,jakub sirina,2,0,0,0,0,0,0,0,0,0,0,0,0,0,1,1,1,0,0,0,0,0
438929,497_15_65,CZECH REPUBLIC,29503,14,blake schilb,25,4,7,57.1,2,3,66.7,2,4,50,2,2,100,0,1,1,2,4,1,2,0,12
438930,497_15_65,CZECH REPUBLIC,6362,24,jan vesely,35,9,12,75,9,12,75,0,0,0,2,3,66.7,1,12,13,0,3,2,2,0,20
438931,497_15_65,CZECH REPUBLIC,0,TOTALS,CZECH REPUBLIC,200,32,64,50,25,47,53.2,7,17,41.2,9,13,69.2,9,26,35,27,19,12,11,2,80
438932,497_15_66,SERBIA,5751,4,milos teodosic,28,2,7,28.6,0,2,0,2,5,40,2,2,100,0,2,2,9,3,4,0,0,8
438933,497_15_66,SERBIA,2100,5,marko simonovic,15,2,4,50,0,0,0,2,4,50,0,0,0,0,2,2,0,0,1,0,0,6
438934,497_15_66,SERBIA,29506,6,ognjen kuzmic,3,0,1,0,0,1,0,0,0,0,0,0,0,0,0,0,0,0,0,0,0,0
438935,497_15_66,SERBIA,17361,7,bogdan bogdanovic,16,3,5,60,1,2,50,2,3,66.7,2,2,100,0,4,4,0,1,2,0,0,10
438936,497_15_66,SERBIA,15386,8,nemanja bjelica,29,8,13,61.5,7,10,70,1,3,33.3,2,3,66.7,1,13,14,2,2,0,0,0,19
438937,497_15_66,SERBIA,2654,9,stefan markovic,18,0,4,0,0,1,0,0,3,0,0,0,0,0,0,0,5,4,2,0,1,0
438938,497_15_66,SERBIA,19860,10,nikola kalinic,21,2,2,100,2,2,100,0,0,0,1,2,50,0,0,0,4,2,2,1,0,5
438939,497_15_66,SERBIA,15503,11,nemanja nedovic,23,1,3,33.3,1,1,100,0,2,0,2,2,100,0,3,3,5,2,2,1,1,4
438940,497_15_66,SERBIA,15505,12,dragan milosavljevic,10,1,1,100,1,1,100,0,0,0,0,0,0,0,0,0,1,0,0,0,0,2
438941,497_15_66,SERBIA,2656,13,miroslav raduljica,19,11,12,91.7,11,12,91.7,0,0,0,5,6,83.3,1,3,4,0,2,1,0,1,27
438942,497_15_66,SERBIA,10253,14,zoran erceg,17,5,6,83.3,3,3,100,2,3,66.7,1,1,100,3,3,6,4,3,0,1,1,13
438943,497_15_66,SERBIA,17652,15,nikola milutinov,2,0,1,0,0,1,0,0,0,0,0,0,0,0,0,0,0,0,0,0,0,0
438944,497_15_66,SERBIA,0,TOTALS,SERBIA,200,35,59,59.3,26,36,72.2,9,23,39.1,15,18,83.3,6,33,39,30,19,14,3,4,94
438945,497_15_66,FINLAND,1834,4,mikko koivisto,2,0,0,0,0,0,0,0,0,0,0,0,0,0,0,0,0,0,0,0,0,0
438946,497_15_66,FINLAND,1314,7,shawn huff,27,2,7,28.6,0,4,0,2,3,66.7,0,0,0,1,3,4,0,1,0,0,0,6
438947,497_15_66,FINLAND,1836,8,gerald lee,13,1,2,50,1,2,50,0,0,0,0,0,0,1,2,3,0,4,2,1,0,2
438948,497_15_66,FINLAND,11129,9,sasu salin,31,10,19,52.6,6,11,54.5,4,8,50,2,2,100,3,1,4,2,1,0,2,0,26
438949,497_15_66,FINLAND,4932,10,tuukka kotti,25,3,5,60,3,5,60,0,0,0,1,2,50,2,5,7,1,3,2,1,0,7
438950,497_15_66,FINLAND,2802,11,petteri koponen,23,4,9,44.4,4,7,57.1,0,2,0,3,5,60,0,0,0,4,2,1,0,0,11
438951,497_15_66,FINLAND,8436,12,matti nuutinen,16,1,5,20,1,2,50,0,3,0,0,0,0,0,0,0,0,1,0,0,0,2
438952,497_15_66,FINLAND,24222,21,ville kaunisto,10,0,3,0,0,1,0,0,2,0,0,0,0,1,0,1,0,2,0,0,0,0
438953,497_15_66,FINLAND,29510,24,joonas caven,1,0,0,0,0,0,0,0,0,0,0,0,0,1,0,1,0,0,0,0,0,0
438954,497_15_66,FINLAND,8428,30,roope ahonen,2,0,1,0,0,0,0,0,1,0,0,0,0,0,0,0,0,0,0,0,0,0
438955,497_15_66,FINLAND,29511,31,jamar wilson,23,6,17,35.3,5,14,35.7,1,3,33.3,2,2,100,0,3,3,4,1,0,1,0,15
438956,497_15_66,FINLAND,25454,33,erik jay murphy,27,5,11,45.5,4,7,57.1,1,4,25,1,2,50,4,4,8,2,4,3,0,1,12
438957,497_15_66,FINLAND,0,TOTALS,FINLAND,200,32,79,40.5,24,53,45.3,8,26,30.8,9,13,69.2,14,20,34,13,19,8,5,1,81
438958,497_15_67,ISRAEL,24229,5,dagan yivzori,10,0,1,0,0,0,0,0,1,0,0,0,0,0,1,1,1,0,1,0,0,0
438959,497_15_67,ISRAEL,21841,6,shawn dawson,19,0,3,0,0,3,0,0,0,0,1,2,50,1,3,4,3,2,1,0,0,1
438960,497_15_67,ISRAEL,2522,7,gal mekel,39,9,15,60,7,13,53.8,2,2,100,0,0,0,0,5,5,3,4,2,0,0,20
438961,497_15_67,ISRAEL,1023,8,lior eliyahu,30,6,13,46.2,6,13,46.2,0,0,0,0,0,0,1,3,4,0,2,2,0,0,12
438962,497_15_67,ISRAEL,1933,9,omri casspi,29,3,9,33.3,2,6,33.3,1,3,33.3,1,4,25,0,6,6,2,2,2,0,1,8
438963,497_15_67,ISRAEL,1022,10,raviv limonad,11,0,1,0,0,1,0,0,0,0,0,0,0,0,1,1,1,3,0,0,0,0
438964,497_15_67,ISRAEL,5780,11,elishay kadir,20,0,4,0,0,4,0,0,0,0,4,4,100,0,3,3,3,4,2,1,0,4
438965,497_15_67,ISRAEL,1685,12,yogev ohayon,20,1,4,25,1,2,50,0,2,0,0,0,0,0,3,3,1,2,0,0,0,2
438966,497_15_67,ISRAEL,4620,14,yaniv green,3,0,1,0,0,1,0,0,0,0,0,0,0,0,0,0,0,1,1,0,0,0
438967,497_15_67,ISRAEL,29504,15,dor fischer,20,2,5,40,2,5,40,0,0,0,1,1,100,0,4,4,2,3,2,0,2,5
438968,497_15_67,ISRAEL,19712,16,boris rothbart,0,0,0,0,0,0,0,0,0,0,0,0,0,0,0,0,0,0,0,0,0,0
438969,497_15_67,ISRAEL,12887,23,bar timor,0,0,0,0,0,0,0,0,0,0,0,0,0,0,0,0,0,0,0,0,0,0
438970,497_15_67,ISRAEL,0,TOTALS,ISRAEL,200,21,56,37.5,18,48,37.5,3,8,37.5,7,11,63.6,5,31,36,16,23,14,1,3,52
438971,497_15_67,ITALY,20021,0,amedeo della valle,10,2,5,40,0,1,0,2,4,50,2,2,100,0,3,3,1,1,0,0,0,8
438972,497_15_67,ITALY,1272,3,marco belinelli,23,5,10,50,1,2,50,4,8,50,0,0,0,1,3,4,4,0,0,1,0,14
438973,497_15_67,ITALY,7944,4,pietro aradori,17,1,5,20,1,4,25,0,1,0,0,0,0,2,2,4,1,1,2,0,0,2
438974,497_15_67,ITALY,12988,5,alessandro gentile,30,8,12,66.7,6,8,75,2,4,50,9,11,81.8,2,3,5,2,3,0,0,1,27
438975,497_15_67,ITALY,2667,8,danilo gallinari,25,3,10,30,3,7,42.9,0,3,0,0,0,0,2,2,4,2,1,1,0,2,6
438976,497_15_67,ITALY,1270,9,andrea bargnani,12,3,7,42.9,2,6,33.3,1,1,100,0,0,0,0,3,3,0,0,0,1,1,7
438977,497_15_67,ITALY,15319,12,marco cusin,17,0,1,0,0,1,0,0,0,0,2,2,100,1,4,5,1,3,2,1,1,2
438978,497_15_67,ITALY,1861,13,luigi datome,0,0,0,0,0,0,0,0,0,0,0,0,0,0,0,0,0,0,0,0,0,0
438979,497_15_67,ITALY,10968,17,nicolo melli,17,2,8,25,1,4,25,1,4,25,0,0,0,3,4,7,1,3,0,0,1,5
438980,497_15_67,ITALY,19752,20,andrea cinciarini,22,1,3,33.3,0,1,0,1,2,50,0,2,0,0,4,4,5,1,1,1,0,3
438981,497_15_67,ITALY,10444,23,daniel hackett,18,3,7,42.9,3,5,60,0,2,0,0,0,0,1,2,3,4,3,0,1,0,6
438982,497_15_67,ITALY,15644,33,achille polonara,10,1,3,33.3,1,2,50,0,1,0,0,0,0,0,1,1,0,0,0,1,0,2
438983,497_15_67,ITALY,0,TOTALS,ITALY,200,29,71,40.8,18,41,43.9,11,30,36.7,13,17,76.5,13,33,46,21,16,6,6,6,82
438984,497_15_68,LITHUANIA,1726,5,mantas kalnietis,36,5,14,35.7,4,6,66.7,1,8,12.5,0,0,0,1,3,4,7,3,1,0,0,11
438985,497_15_68,LITHUANIA,8963,6,deividas gailius,0,0,0,0,0,0,0,0,0,0,0,0,0,0,0,0,0,0,0,0,0,0
438986,497_15_68,LITHUANIA,980,8,jonas maciulis,38,11,13,84.6,8,9,88.9,3,4,75,9,9,100,1,5,6,3,2,2,4,2,34
438987,497_15_68,LITHUANIA,3474,10,renaldas seibutis,25,2,6,33.3,2,3,66.7,0,3,0,3,4,75,2,3,5,3,3,4,0,0,7
438988,497_15_68,LITHUANIA,22216,11,domantas sabonis,0,0,0,0,0,0,0,0,0,0,0,0,0,0,0,0,0,0,0,0,0,0
438989,497_15_68,LITHUANIA,3476,12,antanas kavaliauskas,0,0,0,0,0,0,0,0,0,0,0,0,0,0,0,0,0,0,0,0,0,0
438990,497_15_68,LITHUANIA,987,13,paulius jankunas,32,4,8,50,3,6,50,1,2,50,8,10,80,1,4,5,5,3,2,0,0,17
438991,497_15_68,LITHUANIA,24,15,robertas javtokas,20,1,2,50,1,2,50,0,0,0,0,2,0,2,3,5,3,3,1,1,0,2
438992,497_15_68,LITHUANIA,10916,17,jonas valanciunas,20,2,4,50,2,4,50,0,0,0,1,2,50,0,0,0,0,4,3,0,1,5
438993,497_15_68,LITHUANIA,10639,19,mindaugas kuzminskas,11,1,3,33.3,0,0,0,1,3,33.3,0,0,0,0,2,2,0,3,2,0,0,3
438994,497_15_68,LITHUANIA,29513,21,arturas milaknis,16,2,4,50,0,0,0,2,4,50,0,0,0,1,0,1,0,3,1,0,0,6
438995,497_15_68,LITHUANIA,17685,43,lukas lekavicius,3,0,0,0,0,0,0,0,0,0,0,0,0,0,0,0,1,0,0,0,0,0
438996,497_15_68,LITHUANIA,0,TOTALS,LITHUANIA,200,28,54,51.9,20,30,66.7,8,24,33.3,21,27,77.8,9,22,31,22,24,17,5,3,85
438997,497_15_68,GEORGIA,24223,0,jacob everse pullen,23,4,11,36.4,2,5,40,2,6,33.3,2,2,100,0,2,2,1,1,2,0,0,12
438998,497_15_68,GEORGIA,8378,4,nika metreveli,0,0,0,0,0,0,0,0,0,0,0,0,0,0,0,0,0,0,0,0,0,0
438999,497_15_68,GEORGIA,4919,7,zaza pachulia,35,8,13,61.5,8,13,61.5,0,0,0,7,7,100,3,4,7,3,2,4,0,0,23
439000,497_15_68,GEORGIA,1690,8,george tsintsadze,30,3,8,37.5,1,3,33.3,2,5,40,2,2,100,0,1,1,5,5,2,0,0,10
439001,497_15_68,GEORGIA,6436,9,giorgi shermadini,5,0,0,0,0,0,0,0,0,0,0,0,0,0,0,0,0,2,1,2,0,0
439002,497_15_68,GEORGIA,15684,10,duda sanadze,10,2,3,66.7,0,1,0,2,2,100,0,0,0,0,1,1,0,1,2,0,0,6
439003,497_15_68,GEORGIA,1697,11,manuchar markoishvili,30,3,7,42.9,3,4,75,0,3,0,0,0,0,0,3,3,4,4,1,0,0,6
439004,497_15_68,GEORGIA,12467,12,levan patsatsia,0,0,0,0,0,0,0,0,0,0,0,0,0,0,0,0,0,0,0,0,0,0
439005,497_15_68,GEORGIA,1699,13,viktor sanikidze,36,5,11,45.5,3,6,50,2,5,40,2,2,100,2,5,7,1,4,0,0,0,14
439006,497_15_68,GEORGIA,16022,15,beka burjanadze,5,0,1,0,0,1,0,0,0,0,0,0,0,0,0,0,0,1,0,0,0,0
439007,497_15_68,GEORGIA,11036,23,tornike shengelia,26,3,7,42.9,3,6,50,0,1,0,4,4,100,1,1,2,1,5,3,2,0,10
439008,497_15_68,GEORGIA,1693,25,besik lezhava,0,0,0,0,0,0,0,0,0,0,0,0,0,0,0,0,0,0,0,0,0,0
439009,497_15_68,GEORGIA,0,TOTALS,GEORGIA,200,28,61,45.9,20,39,51.3,8,22,36.4,17,17,100,9,20,29,15,25,15,4,0,81
439010,497_15_69,SPAIN,61,4,pau gasol,31,10,18,55.6,9,16,56.2,1,2,50,6,8,75,2,7,9,3,0,3,0,2,27
439011,497_15_69,SPAIN,70,5,rudy fernandez,19,0,2,0,0,1,0,0,1,0,0,0,0,1,1,2,1,2,0,1,0,0
439012,497_15_69,SPAIN,1877,6,sergio rodriguez,28,3,8,37.5,2,5,40,1,3,33.3,3,4,75,0,3,3,5,1,1,0,0,10
439013,497_15_69,SPAIN,17609,7,guillermo hernangomez,0,0,0,0,0,0,0,0,0,0,0,0,0,0,0,0,0,0,0,0,0,0
439014,497_15_69,SPAIN,5713,8,pau ribas tossas,23,1,2,50,0,1,0,1,1,100,0,0,0,0,0,0,3,2,1,1,0,3
439015,497_15_69,SPAIN,66,9,felipe reyes,18,1,6,16.7,1,5,20,0,1,0,3,4,75,2,3,5,1,4,0,0,0,5
439016,497_15_69,SPAIN,2628,10,victor claver,19,1,2,50,1,2,50,0,0,0,0,0,0,3,5,8,0,3,1,1,0,2
439017,497_15_69,SPAIN,1317,11,fernando san emeterio,0,0,0,0,0,0,0,0,0,0,0,0,0,0,0,0,0,0,0,0,0,0
439018,497_15_69,SPAIN,1871,12,sergio llull,31,3,9,33.3,1,3,33.3,2,6,33.3,0,0,0,0,2,2,2,3,1,0,0,8
439019,497_15_69,SPAIN,6265,13,pablo aguilar,0,0,0,0,0,0,0,0,0,0,0,0,0,0,0,0,0,0,0,0,0,0
439020,497_15_69,SPAIN,17234,14,nikola mirotic,31,4,8,50,2,4,50,2,4,50,8,8,100,1,0,1,2,2,3,0,0,18
439021,497_15_69,SPAIN,19987,15,guillem vives,0,0,0,0,0,0,0,0,0,0,0,0,0,0,0,0,0,0,0,0,0,0
439022,497_15_69,SPAIN,0,TOTALS,SPAIN,200,23,55,41.8,16,37,43.2,7,18,38.9,20,24,83.3,10,23,33,17,17,10,3,2,73
439023,497_15_69,GREECE,5050,5,yannis bourousis,9,2,5,40,2,3,66.7,0,2,0,1,2,50,0,2,2,0,5,0,1,2,5
439024,497_15_69,GREECE,123,6,nikos zisis,18,2,6,33.3,2,3,66.7,0,3,0,1,2,50,0,2,2,3,3,0,0,0,5
439025,497_15_69,GREECE,125,7,vassilis spanoulis,32,4,14,28.6,3,9,33.3,1,5,20,1,2,50,1,1,2,5,1,3,0,0,10
439026,497_15_69,GREECE,12472,8,nick calathes,33,6,11,54.5,4,8,50,2,3,66.7,0,0,0,1,4,5,7,5,2,2,0,14
439027,497_15_69,GREECE,1057,9,stratos perperoglou,3,0,1,0,0,0,0,0,1,0,0,0,0,0,0,0,0,1,0,0,0,0
439028,497_15_69,GREECE,8304,10,kostas sloukas,4,1,1,100,0,0,0,1,1,100,0,0,0,0,0,0,0,0,1,0,0,3
439029,497_15_69,GREECE,15374,12,kostas kaimakoglou,2,0,1,0,0,0,0,0,1,0,0,0,0,0,0,0,1,2,0,0,0,0
439030,497_15_69,GREECE,10607,13,kostas koufos,31,4,6,66.7,4,6,66.7,0,0,0,1,2,50,1,5,6,0,3,0,1,1,9
439031,497_15_69,GREECE,1056,15,georgios printezis,34,6,11,54.5,5,9,55.6,1,2,50,0,0,0,0,1,1,4,2,0,1,0,13
439032,497_15_69,GREECE,10606,16,kostas papanikolaou,0,0,0,0,0,0,0,0,0,0,0,0,0,0,0,0,0,0,0,0,0,0
439033,497_15_69,GREECE,8303,17,evangelos mantzaris,0,0,0,0,0,0,0,0,0,0,0,0,0,0,0,0,0,0,0,0,0,0
439034,497_15_69,GREECE,24314,34,giannis antetokounmpo,34,5,10,50,3,6,50,2,4,50,0,1,0,8,9,17,1,2,4,0,2,12
439035,497_15_69,GREECE,0,TOTALS,GREECE,200,30,66,45.5,23,44,52.3,7,22,31.8,4,9,44.4,13,25,38,21,24,11,5,5,71
439036,497_15_70,FRANCE,11077,4,leo j. p. westermann,3,0,0,0,0,0,0,0,0,0,2,2,100,0,0,0,1,0,0,0,0,2
439037,497_15_70,FRANCE,2588,5,nicolas batum,26,2,6,33.3,2,3,66.7,0,3,0,0,0,0,0,3,3,1,1,1,4,0,4
439038,497_15_70,FRANCE,11076,7,joffrey lauvergne,17,4,6,66.7,4,5,80,0,1,0,2,2,100,3,4,7,1,2,1,1,0,10
439039,497_15_70,FRANCE,1864,8,charles kahudi,15,0,1,0,0,1,0,0,0,0,1,2,50,1,7,8,2,2,0,0,0,1
439040,497_15_70,FRANCE,5047,9,tony parker,30,5,17,29.4,3,13,23.1,2,4,50,6,6,100,0,1,1,6,3,3,1,0,18
439041,497_15_70,FRANCE,12971,10,evan fournier,12,2,6,33.3,2,4,50,0,2,0,3,4,75,0,1,1,1,2,0,0,0,7
439042,497_15_70,FRANCE,4663,11,florent pietrus,14,0,0,0,0,0,0,0,0,0,0,0,0,2,0,2,0,2,1,0,0,0
439043,497_15_70,FRANCE,10428,12,nando de colo,26,4,8,50,3,5,60,1,3,33.3,2,4,50,1,6,7,5,1,2,1,0,11
439044,497_15_70,FRANCE,4665,13,boris diaw,23,7,12,58.3,7,12,58.3,0,0,0,0,0,0,2,1,3,1,3,2,1,1,14
439045,497_15_70,FRANCE,5044,15,mickael gelabale,9,2,2,100,2,2,100,0,0,0,0,0,0,0,0,0,0,1,0,0,0,4
439046,497_15_70,FRANCE,17374,16,rudy gobert,25,4,7,57.1,4,7,57.1,0,0,0,5,6,83.3,4,2,6,0,3,0,0,3,13
439047,497_15_70,FRANCE,17677,19,mouhammadou jaiteh,0,0,0,0,0,0,0,0,0,0,0,0,0,0,0,0,0,0,0,0,0,0
439048,497_15_70,FRANCE,0,TOTALS,FRANCE,200,30,65,46.2,27,52,51.9,3,13,23.1,21,26,80.8,15,26,41,18,20,12,8,4,84
439049,497_15_70,LATVIA,19755,5,mareks mejeris,12,1,4,25,1,3,33.3,0,1,0,1,2,50,0,5,5,1,2,1,0,0,3
439050,497_15_70,LATVIA,2539,6,rolands freimanis,22,3,9,33.3,3,8,37.5,0,1,0,3,5,60,3,5,8,0,1,0,0,0,9
439051,497_15_70,LATVIA,5029,7,janis blums,16,0,4,0,0,1,0,0,3,0,0,0,0,0,1,1,0,0,0,1,0,0
439052,497_15_70,LATVIA,6271,9,dairis bertans,29,5,10,50,5,8,62.5,0,2,0,2,3,66.7,1,0,1,3,1,1,0,0,12
439053,497_15_70,LATVIA,12927,10,janis timma,15,2,4,50,1,2,50,1,2,50,0,0,0,2,2,4,0,3,2,1,2,5
439054,497_15_70,LATVIA,4604,12,kristaps janicenoks,26,6,7,85.7,3,4,75,3,3,100,1,2,50,1,0,1,1,2,2,1,0,16
439055,497_15_70,LATVIA,10585,13,janis strelnieks,32,6,13,46.2,4,8,50,2,5,40,0,0,0,0,3,3,7,3,3,1,0,14
439056,497_15_70,LATVIA,1002,14,kaspars berzins,16,1,5,20,1,4,25,0,1,0,0,0,0,0,2,2,0,4,3,1,0,2
439057,497_15_70,LATVIA,12931,19,kaspars vecvagars,0,1,1,100,1,1,100,0,0,0,0,0,0,0,0,0,0,0,0,0,0,2
439058,497_15_70,LATVIA,11058,23,haralds karlis,4,0,1,0,0,0,0,0,1,0,0,0,0,0,0,0,0,1,0,0,0,0
439059,497_15_70,LATVIA,29509,31,zanis peiners,9,0,2,0,0,0,0,0,2,0,0,0,0,0,0,0,0,2,1,0,1,0
439060,497_15_70,LATVIA,15602,33,martins meiers,19,3,6,50,3,6,50,0,0,0,1,2,50,3,1,4,1,3,2,0,2,7
439061,497_15_70,LATVIA,0,TOTALS,LATVIA,200,28,66,42.4,22,45,48.9,6,21,28.6,8,14,57.1,13,22,35,13,22,15,5,5,70
439062,497_15_71,SERBIA,5751,4,milos teodosic,30,3,11,27.3,3,5,60,0,6,0,6,7,85.7,0,2,2,14,1,3,1,0,12
439063,497_15_71,SERBIA,2100,5,marko simonovic,15,0,1,0,0,0,0,0,1,0,0,0,0,0,4,4,0,2,0,1,1,0
439064,497_15_71,SERBIA,29506,6,ognjen kuzmic,5,0,2,0,0,2,0,0,0,0,0,0,0,1,0,1,0,0,0,0,0,0
439065,497_15_71,SERBIA,17361,7,bogdan bogdanovic,20,2,6,33.3,1,2,50,1,4,25,1,2,50,0,3,3,2,1,1,1,1,6
439066,497_15_71,SERBIA,15386,8,nemanja bjelica,28,5,8,62.5,3,3,100,2,5,40,2,2,100,1,9,10,2,5,3,2,0,14
439067,497_15_71,SERBIA,2654,9,stefan markovic,20,4,6,66.7,3,3,100,1,3,33.3,2,2,100,0,0,0,4,3,1,1,0,11
439068,497_15_71,SERBIA,19860,10,nikola kalinic,17,1,1,100,1,1,100,0,0,0,0,0,0,0,1,1,0,1,2,1,0,2
439069,497_15_71,SERBIA,15503,11,nemanja nedovic,12,4,6,66.7,4,5,80,0,1,0,0,0,0,0,1,1,1,0,1,0,0,8
439070,497_15_71,SERBIA,15505,12,dragan milosavljevic,9,0,1,0,0,0,0,0,1,0,0,0,0,0,0,0,0,1,0,0,0,0
439071,497_15_71,SERBIA,2656,13,miroslav raduljica,15,6,9,66.7,6,9,66.7,0,0,0,4,6,66.7,3,2,5,1,4,0,0,0,16
439072,497_15_71,SERBIA,10253,14,zoran erceg,28,6,7,85.7,3,3,100,3,4,75,5,5,100,0,3,3,2,3,0,0,0,20
439073,497_15_71,SERBIA,17652,15,nikola milutinov,1,0,0,0,0,0,0,0,0,0,0,0,0,0,0,0,0,0,0,0,0,0
439074,497_15_71,SERBIA,0,TOTALS,SERBIA,200,31,58,53.4,24,33,72.7,7,25,28,20,24,83.3,7,26,33,26,21,11,7,2,89
439075,497_15_71,CZECH REPUBLIC,4677,4,petr benda,20,1,5,20,1,4,25,0,1,0,0,0,0,0,1,1,3,2,2,2,0,2
439076,497_15_71,CZECH REPUBLIC,29502,5,patrik auda,4,0,0,0,0,0,0,0,0,0,0,0,0,0,0,0,0,1,0,1,0,0
439077,497_15_71,CZECH REPUBLIC,5478,6,pavel pumprla,24,2,5,40,2,3,66.7,0,2,0,1,2,50,2,3,5,4,4,3,1,0,5
439078,497_15_71,CZECH REPUBLIC,10700,7,vojtech hruban,13,2,6,33.3,1,4,25,1,2,50,0,0,0,1,0,1,1,1,1,0,0,5
439079,497_15_71,CZECH REPUBLIC,8325,8,tomas satoransky,34,7,11,63.6,4,6,66.7,3,5,60,3,3,100,0,4,4,4,3,2,1,1,20
439080,497_15_71,CZECH REPUBLIC,4774,9,jiri welsch,16,0,2,0,0,1,0,0,1,0,4,4,100,0,1,1,3,4,1,0,0,4
439081,497_15_71,CZECH REPUBLIC,1096,10,pavel houska,13,2,5,40,1,1,100,1,4,25,0,0,0,0,1,1,2,2,0,0,0,5
439082,497_15_71,CZECH REPUBLIC,4775,11,lubos barton,0,0,0,0,0,0,0,0,0,0,0,0,0,0,0,0,0,0,0,0,0,0
439083,497_15_71,CZECH REPUBLIC,8327,12,david jelinek,8,0,3,0,0,1,0,0,2,0,0,0,0,0,0,0,1,0,1,0,0,0
439084,497_15_71,CZECH REPUBLIC,10484,13,jakub sirina,2,0,0,0,0,0,0,0,0,0,0,0,0,0,0,0,0,0,0,0,0,0
439085,497_15_71,CZECH REPUBLIC,29503,14,blake schilb,31,4,10,40,3,7,42.9,1,3,33.3,2,2,100,1,2,3,2,2,3,0,0,11
439086,497_15_71,CZECH REPUBLIC,6362,24,jan vesely,35,10,12,83.3,10,12,83.3,0,0,0,3,7,42.9,1,9,10,0,2,1,0,1,23
439087,497_15_71,CZECH REPUBLIC,0,TOTALS,CZECH REPUBLIC,200,28,59,47.5,22,39,56.4,6,20,30,13,18,72.2,7,22,29,20,21,15,5,2,75
439088,497_15_72,ITALY,20021,0,amedeo della valle,0,0,0,0,0,0,0,0,0,0,0,0,0,0,0,0,0,0,0,0,0,0
439089,497_15_72,ITALY,1272,3,marco belinelli,37,7,16,43.8,4,5,80,3,11,27.3,1,2,50,0,2,2,4,4,3,1,0,18
439090,497_15_72,ITALY,7944,4,pietro aradori,17,3,6,50,2,3,66.7,1,3,33.3,1,2,50,0,4,4,1,2,0,0,0,8
439091,497_15_72,ITALY,12988,5,alessandro gentile,36,6,12,50,6,11,54.5,0,1,0,0,0,0,1,3,4,0,4,2,1,0,12
439092,497_15_72,ITALY,2667,8,danilo gallinari,39,5,11,45.5,3,8,37.5,2,3,66.7,5,7,71.4,2,4,6,4,1,1,3,0,17
439093,497_15_72,ITALY,1270,9,andrea bargnani,39,8,22,36.4,7,15,46.7,1,7,14.3,4,4,100,1,4,5,0,2,1,0,1,21
439094,497_15_72,ITALY,15319,12,marco cusin,6,2,3,66.7,2,3,66.7,0,0,0,0,0,0,2,0,2,0,1,0,0,0,4
439095,497_15_72,ITALY,1861,13,luigi datome,0,0,0,0,0,0,0,0,0,0,0,0,0,0,0,0,0,0,0,0,0,0
439096,497_15_72,ITALY,10968,17,nicolo melli,6,1,1,100,1,1,100,0,0,0,0,0,0,1,0,1,0,0,0,1,0,2
439097,497_15_72,ITALY,19752,20,andrea cinciarini,22,1,3,33.3,0,1,0,1,2,50,0,0,0,1,3,4,5,2,0,0,0,3
439098,497_15_72,ITALY,10444,23,daniel hackett,23,0,1,0,0,0,0,0,1,0,0,0,0,0,2,2,2,3,0,1,0,0
439099,497_15_72,ITALY,15644,33,achille polonara,0,0,0,0,0,0,0,0,0,0,0,0,0,0,0,0,0,0,0,0,0,0
439100,497_15_72,ITALY,0,TOTALS,ITALY,225,33,75,44,25,47,53.2,8,28,28.6,11,15,73.3,9,23,32,16,19,7,7,1,85
439101,497_15_72,LITHUANIA,1726,5,mantas kalnietis,40,5,11,45.5,3,7,42.9,2,4,50,2,2,100,0,2,2,11,2,4,0,0,14
439102,497_15_72,LITHUANIA,8963,6,deividas gailius,0,0,0,0,0,0,0,0,0,0,0,0,0,0,0,0,0,0,0,0,0,0
439103,497_15_72,LITHUANIA,980,8,jonas maciulis,41,8,14,57.1,5,10,50,3,4,75,0,0,0,1,9,10,3,2,4,0,1,19
439104,497_15_72,LITHUANIA,3474,10,renaldas seibutis,33,3,10,30,3,10,30,0,0,0,0,0,0,0,2,2,9,1,2,0,0,6
439105,497_15_72,LITHUANIA,22216,11,domantas sabonis,0,0,0,0,0,0,0,0,0,0,0,0,0,0,0,0,0,0,0,0,0,0
439106,497_15_72,LITHUANIA,3476,12,antanas kavaliauskas,0,0,0,0,0,0,0,0,0,0,0,0,0,0,0,0,0,0,0,0,0,0
439107,497_15_72,LITHUANIA,987,13,paulius jankunas,20,2,4,50,1,2,50,1,2,50,2,2,100,0,2,2,1,3,0,0,0,7
439108,497_15_72,LITHUANIA,24,15,robertas javtokas,6,0,0,0,0,0,0,0,0,0,1,2,50,0,0,0,1,5,0,0,0,1
439109,497_15_72,LITHUANIA,10916,17,jonas valanciunas,38,11,13,84.6,11,13,84.6,0,0,0,4,4,100,2,13,15,0,3,1,0,0,26
439110,497_15_72,LITHUANIA,10639,19,mindaugas kuzminskas,30,4,6,66.7,2,3,66.7,2,3,66.7,3,4,75,0,3,3,3,3,1,1,0,13
439111,497_15_72,LITHUANIA,29513,21,arturas milaknis,15,3,6,50,0,1,0,3,5,60,0,0,0,0,0,0,0,2,0,0,0,9
439112,497_15_72,LITHUANIA,17685,43,lukas lekavicius,2,0,0,0,0,0,0,0,0,0,0,0,0,0,0,0,0,0,0,0,0,0
439113,497_15_72,LITHUANIA,0,TOTALS,LITHUANIA,225,36,64,56.2,25,46,54.3,11,18,61.1,12,14,85.7,5,32,37,28,21,12,1,1,95
439114,497_15_73,GREECE,5050,5,yannis bourousis,26,5,12,41.7,5,10,50,0,2,0,10,10,100,2,4,6,0,4,2,1,1,20
439115,497_15_73,GREECE,123,6,nikos zisis,22,2,6,33.3,1,4,25,1,2,50,7,8,87.5,0,1,1,3,4,0,1,0,12
439116,497_15_73,GREECE,125,7,vassilis spanoulis,31,4,7,57.1,2,3,66.7,2,4,50,6,7,85.7,0,2,2,4,1,4,1,0,16
439117,497_15_73,GREECE,12472,8,nick calathes,30,6,9,66.7,3,5,60,3,4,75,0,0,0,2,1,3,5,4,3,2,0,15
439118,497_15_73,GREECE,1057,9,stratos perperoglou,0,0,0,0,0,0,0,0,0,0,0,0,0,0,0,0,0,0,0,0,0,0
439119,497_15_73,GREECE,8304,10,kostas sloukas,24,2,4,50,2,4,50,0,0,0,2,2,100,0,1,1,3,1,0,0,0,6
439120,497_15_73,GREECE,15374,12,kostas kaimakoglou,4,0,1,0,0,1,0,0,0,0,0,0,0,1,0,1,0,0,0,0,0,0
439121,497_15_73,GREECE,10607,13,kostas koufos,14,2,4,50,2,4,50,0,0,0,1,2,50,1,6,7,1,2,2,0,0,5
439122,497_15_73,GREECE,1056,15,georgios printezis,24,2,6,33.3,0,2,0,2,4,50,2,2,100,1,3,4,2,2,3,0,0,8
439123,497_15_73,GREECE,10606,16,kostas papanikolaou,0,0,0,0,0,0,0,0,0,0,0,0,0,0,0,0,0,0,0,0,0,0
439124,497_15_73,GREECE,8303,17,evangelos mantzaris,0,0,0,0,0,0,0,0,0,0,0,0,0,0,0,0,0,0,0,0,0,0
439125,497_15_73,GREECE,24314,34,giannis antetokounmpo,25,5,11,45.5,3,6,50,2,5,40,3,4,75,1,6,7,1,5,1,1,0,15
439126,497_15_73,GREECE,0,TOTALS,GREECE,200,28,60,46.7,18,39,46.2,10,21,47.6,31,35,88.6,8,26,34,19,23,16,6,1,97
439127,497_15_73,LATVIA,19755,5,mareks mejeris,19,4,5,80,3,4,75,1,1,100,5,6,83.3,3,3,6,1,1,2,1,1,14
439128,497_15_73,LATVIA,2539,6,rolands freimanis,21,5,8,62.5,5,6,83.3,0,2,0,0,0,0,2,3,5,1,2,4,1,0,10
439129,497_15_73,LATVIA,5029,7,janis blums,21,0,6,0,0,1,0,0,5,0,2,2,100,0,1,1,0,2,1,0,0,2
439130,497_15_73,LATVIA,6271,9,dairis bertans,30,6,14,42.9,6,9,66.7,0,5,0,2,2,100,0,1,1,3,5,3,1,0,14
439131,497_15_73,LATVIA,12927,10,janis timma,18,2,3,66.7,0,0,0,2,3,66.7,0,2,0,0,3,3,5,3,2,0,1,6
439132,497_15_73,LATVIA,4604,12,kristaps janicenoks,25,8,11,72.7,3,6,50,5,5,100,1,1,100,0,4,4,2,4,1,1,0,22
439133,497_15_73,LATVIA,10585,13,janis strelnieks,29,1,8,12.5,1,2,50,0,6,0,0,0,0,0,2,2,7,1,2,0,0,2
439134,497_15_73,LATVIA,1002,14,kaspars berzins,16,1,2,50,1,1,100,0,1,0,3,4,75,0,4,4,1,5,1,0,0,5
439135,497_15_73,LATVIA,12931,19,kaspars vecvagars,1,1,2,50,1,1,100,0,1,0,0,0,0,0,0,0,4,1,0,0,0,2
439136,497_15_73,LATVIA,11058,23,haralds karlis,0,0,0,0,0,0,0,0,0,0,0,0,0,0,0,0,0,0,0,0,0,0
439137,497_15_73,LATVIA,29509,31,zanis peiners,0,0,0,0,0,0,0,0,0,0,0,0,0,0,0,0,0,0,0,0,0,0
439138,497_15_73,LATVIA,15602,33,martins meiers,20,4,4,100,4,4,100,0,0,0,5,6,83.3,0,1,1,0,5,0,1,0,13
439139,497_15_73,LATVIA,0,TOTALS,LATVIA,200,32,63,50.8,24,34,70.6,8,29,27.6,18,23,78.3,8,23,31,24,30,16,5,2,90
439140,497_15_74,CZECH REPUBLIC,4677,4,petr benda,16,1,3,33.3,1,3,33.3,0,0,0,0,0,0,0,0,0,1,1,0,0,0,2
439141,497_15_74,CZECH REPUBLIC,29502,5,patrik auda,7,0,4,0,0,4,0,0,0,0,0,0,0,1,0,1,0,1,1,1,0,0
439142,497_15_74,CZECH REPUBLIC,5478,6,pavel pumprla,23,1,5,20,1,4,25,0,1,0,1,2,50,1,1,2,2,4,1,0,0,3
439143,497_15_74,CZECH REPUBLIC,10700,7,vojtech hruban,21,2,6,33.3,1,4,25,1,2,50,0,0,0,1,1,2,2,0,1,0,0,5
439144,497_15_74,CZECH REPUBLIC,8325,8,tomas satoransky,34,5,10,50,3,6,50,2,4,50,0,0,0,0,3,3,6,2,4,0,0,12
439145,497_15_74,CZECH REPUBLIC,4774,9,jiri welsch,15,2,5,40,2,5,40,0,0,0,0,1,0,0,1,1,5,2,1,0,0,4
439146,497_15_74,CZECH REPUBLIC,1096,10,pavel houska,19,2,4,50,1,3,33.3,1,1,100,0,0,0,1,2,3,0,2,0,0,0,5
439147,497_15_74,CZECH REPUBLIC,4775,11,lubos barton,4,1,1,100,1,1,100,0,0,0,0,0,0,0,0,0,0,1,0,1,0,2
439148,497_15_74,CZECH REPUBLIC,8327,12,david jelinek,4,0,2,0,0,2,0,0,0,0,0,0,0,0,0,0,0,1,0,0,0,0
439149,497_15_74,CZECH REPUBLIC,10484,13,jakub sirina,6,1,2,50,1,2,50,0,0,0,1,2,50,0,0,0,0,1,0,0,0,3
439150,497_15_74,CZECH REPUBLIC,29503,14,blake schilb,19,3,4,75,2,2,100,1,2,50,1,1,100,0,1,1,4,1,0,0,0,8
439151,497_15_74,CZECH REPUBLIC,6362,24,jan vesely,32,9,17,52.9,9,17,52.9,0,0,0,8,11,72.7,3,9,12,2,2,2,0,0,26
439152,497_15_74,CZECH REPUBLIC,0,TOTALS,CZECH REPUBLIC,200,27,63,42.9,22,53,41.5,5,10,50,11,17,64.7,8,20,28,22,18,10,2,0,70
439153,497_15_74,ITALY,20021,0,amedeo della valle,1,0,1,0,0,0,0,0,1,0,0,0,0,0,0,0,0,0,0,0,0,0
439154,497_15_74,ITALY,1272,3,marco belinelli,27,5,9,55.6,3,6,50,2,3,66.7,0,0,0,0,7,7,4,3,2,0,1,12
439155,497_15_74,ITALY,7944,4,pietro aradori,23,2,7,28.6,1,4,25,1,3,33.3,2,2,100,0,3,3,2,3,2,0,0,7
439156,497_15_74,ITALY,12988,5,alessandro gentile,28,3,7,42.9,2,5,40,1,2,50,8,8,100,3,1,4,3,5,3,0,1,15
439157,497_15_74,ITALY,2667,8,danilo gallinari,24,6,9,66.7,5,6,83.3,1,3,33.3,2,2,100,0,8,8,3,0,0,1,2,15
439158,497_15_74,ITALY,1270,9,andrea bargnani,25,8,14,57.1,5,11,45.5,3,3,100,2,2,100,1,1,2,1,2,1,0,0,21
439159,497_15_74,ITALY,15319,12,marco cusin,15,2,3,66.7,2,3,66.7,0,0,0,0,0,0,1,2,3,0,1,1,0,3,4
439160,497_15_74,ITALY,1861,13,luigi datome,0,0,0,0,0,0,0,0,0,0,0,0,0,0,0,0,0,0,0,0,0,0
439161,497_15_74,ITALY,10968,17,nicolo melli,16,2,2,100,2,2,100,0,0,0,0,2,0,1,0,1,1,1,0,0,1,4
439162,497_15_74,ITALY,19752,20,andrea cinciarini,25,1,4,25,1,3,33.3,0,1,0,3,4,75,0,4,4,2,2,0,0,1,5
439163,497_15_74,ITALY,10444,23,daniel hackett,15,1,2,50,1,2,50,0,0,0,0,0,0,0,3,3,1,1,2,1,0,2
439164,497_15_74,ITALY,15644,33,achille polonara,1,0,0,0,0,0,0,0,0,0,0,0,0,0,0,0,0,0,0,0,0,0
439165,497_15_74,ITALY,0,TOTALS,ITALY,200,30,58,51.7,22,42,52.4,8,16,50,17,20,85,8,30,38,17,19,13,2,9,85
439166,497_15_75,SPAIN,61,4,pau gasol,36,12,21,57.1,12,19,63.2,0,2,0,16,18,88.9,4,7,11,1,2,2,1,3,40
439167,497_15_75,SPAIN,70,5,rudy fernandez,31,1,8,12.5,0,2,0,1,6,16.7,4,4,100,1,4,5,1,1,0,3,3,7
439168,497_15_75,SPAIN,1877,6,sergio rodriguez,31,6,10,60,5,8,62.5,1,2,50,2,2,100,0,4,4,3,3,1,0,0,15
439169,497_15_75,SPAIN,17609,7,guillermo hernangomez,0,0,0,0,0,0,0,0,0,0,0,0,0,0,0,0,0,0,0,0,0,0
439170,497_15_75,SPAIN,5713,8,pau ribas tossas,21,0,3,0,0,2,0,0,1,0,0,0,0,0,0,0,3,3,0,0,0,0
439171,497_15_75,SPAIN,66,9,felipe reyes,28,0,3,0,0,2,0,0,1,0,2,2,100,1,6,7,1,4,1,0,1,2
439172,497_15_75,SPAIN,2628,10,victor claver,14,1,5,20,1,3,33.3,0,2,0,0,0,0,4,2,6,1,2,0,1,0,2
439173,497_15_75,SPAIN,1317,11,fernando san emeterio,0,0,0,0,0,0,0,0,0,0,0,0,0,0,0,0,0,0,0,0,0,0
439174,497_15_75,SPAIN,1871,12,sergio llull,39,3,9,33.3,2,7,28.6,1,2,50,0,0,0,1,2,3,5,1,1,0,0,7
439175,497_15_75,SPAIN,6265,13,pablo aguilar,0,0,0,0,0,0,0,0,0,0,0,0,0,0,0,0,0,0,0,0,0,0
439176,497_15_75,SPAIN,17234,14,nikola mirotic,25,3,9,33.3,2,4,50,1,5,20,0,0,0,1,1,2,3,3,4,0,1,7
439177,497_15_75,SPAIN,19987,15,guillem vives,0,0,0,0,0,0,0,0,0,0,0,0,0,0,0,0,0,0,0,0,0,0
439178,497_15_75,SPAIN,0,TOTALS,SPAIN,225,26,68,38.2,22,47,46.8,4,21,19,24,26,92.3,16,28,44,18,19,9,5,8,80
439179,497_15_75,FRANCE,11077,4,leo j. p. westermann,0,0,0,0,0,0,0,0,0,0,0,0,0,0,0,0,0,0,0,0,0,0
439180,497_15_75,FRANCE,2588,5,nicolas batum,37,3,14,21.4,1,6,16.7,2,8,25,6,9,66.7,2,5,7,2,3,1,2,0,14
439181,497_15_75,FRANCE,11076,7,joffrey lauvergne,15,5,7,71.4,4,6,66.7,1,1,100,0,0,0,1,0,1,0,4,2,0,0,11
439182,497_15_75,FRANCE,1864,8,charles kahudi,0,0,0,0,0,0,0,0,0,0,0,0,0,0,0,0,0,0,0,0,0,0
439183,497_15_75,FRANCE,5047,9,tony parker,37,4,17,23.5,3,13,23.1,1,4,25,1,4,25,1,3,4,6,3,3,0,0,10
439184,497_15_75,FRANCE,12971,10,evan fournier,6,1,2,50,0,1,0,1,1,100,0,0,0,0,0,0,0,3,0,0,1,3
439185,497_15_75,FRANCE,4663,11,florent pietrus,6,0,0,0,0,0,0,0,0,0,0,0,0,1,0,1,0,2,0,0,0,0
439186,497_15_75,FRANCE,10428,12,nando de colo,37,6,12,50,4,9,44.4,2,3,66.7,0,0,0,2,2,4,3,3,3,0,0,14
439187,497_15_75,FRANCE,4665,13,boris diaw,39,2,7,28.6,2,6,33.3,0,1,0,1,2,50,1,5,6,4,3,1,0,0,5
439188,497_15_75,FRANCE,5044,15,mickael gelabale,17,4,7,57.1,2,4,50,2,3,66.7,0,0,0,1,1,2,1,2,0,0,0,10
439189,497_15_75,FRANCE,17374,16,rudy gobert,31,3,7,42.9,3,7,42.9,0,0,0,2,2,100,7,6,13,0,5,1,1,2,8
439190,497_15_75,FRANCE,17677,19,mouhammadou jaiteh,0,0,0,0,0,0,0,0,0,0,0,0,0,0,0,0,0,0,0,0,0,0
439191,497_15_75,FRANCE,0,TOTALS,FRANCE,225,28,73,38.4,19,52,36.5,9,21,42.9,10,17,58.8,18,26,44,16,28,12,3,3,75
439192,497_15_76,LATVIA,19755,5,mareks mejeris,19,1,2,50,1,2,50,0,0,0,2,4,50,2,5,7,2,3,3,1,0,4
439193,497_15_76,LATVIA,2539,6,rolands freimanis,17,3,6,50,3,6,50,0,0,0,0,0,0,0,3,3,1,3,2,0,1,6
439194,497_15_76,LATVIA,5029,7,janis blums,9,0,3,0,0,1,0,0,2,0,0,0,0,0,1,1,1,0,0,0,0,0
439195,497_15_76,LATVIA,6271,9,dairis bertans,18,1,7,14.3,1,4,25,0,3,0,0,0,0,1,1,2,1,3,3,0,0,2
439196,497_15_76,LATVIA,12927,10,janis timma,23,5,8,62.5,4,4,100,1,4,25,0,0,0,2,4,6,2,2,1,0,0,11
439197,497_15_76,LATVIA,4604,12,kristaps janicenoks,17,2,5,40,2,3,66.7,0,2,0,0,0,0,1,1,2,1,0,3,1,0,4
439198,497_15_76,LATVIA,10585,13,janis strelnieks,22,3,7,42.9,3,6,50,0,1,0,1,2,50,1,2,3,2,1,0,1,0,7
439199,497_15_76,LATVIA,1002,14,kaspars berzins,18,3,5,60,3,5,60,0,0,0,1,1,100,3,5,8,2,4,1,0,0,7
439200,497_15_76,LATVIA,12931,19,kaspars vecvagars,16,2,5,40,0,3,0,2,2,100,0,0,0,1,0,1,0,2,3,0,0,6
439201,497_15_76,LATVIA,11058,23,haralds karlis,14,2,4,50,1,1,100,1,3,33.3,0,0,0,0,0,0,1,2,0,0,0,5
439202,497_15_76,LATVIA,29509,31,zanis peiners,15,2,10,20,2,6,33.3,0,4,0,4,4,100,2,0,2,3,2,3,4,0,8
439203,497_15_76,LATVIA,15602,33,martins meiers,12,1,3,33.3,1,3,33.3,0,0,0,8,10,80,3,1,4,0,1,1,0,0,10
439204,497_15_76,LATVIA,0,TOTALS,LATVIA,200,25,65,38.5,21,44,47.7,4,21,19,16,21,76.2,18,25,43,16,23,20,7,1,70
439205,497_15_76,CZECH REPUBLIC,4677,4,petr benda,0,0,0,0,0,0,0,0,0,0,0,0,0,0,0,0,0,0,0,0,0,0
439206,497_15_76,CZECH REPUBLIC,29502,5,patrik auda,21,2,8,25,2,7,28.6,0,1,0,9,9,100,0,3,3,2,1,0,0,0,13
439207,497_15_76,CZECH REPUBLIC,5478,6,pavel pumprla,22,3,5,60,3,4,75,0,1,0,1,1,100,0,2,2,1,1,1,0,0,7
439208,497_15_76,CZECH REPUBLIC,10700,7,vojtech hruban,17,5,8,62.5,5,7,71.4,0,1,0,1,1,100,0,0,0,1,4,0,0,0,11
439209,497_15_76,CZECH REPUBLIC,8325,8,tomas satoransky,28,6,10,60,5,6,83.3,1,4,25,3,5,60,1,3,4,3,3,3,2,0,16
439210,497_15_76,CZECH REPUBLIC,4774,9,jiri welsch,17,1,2,50,1,2,50,0,0,0,0,0,0,0,2,2,5,2,1,0,0,2
439211,497_15_76,CZECH REPUBLIC,1096,10,pavel houska,14,4,5,80,4,4,100,0,1,0,2,2,100,2,3,5,0,2,1,1,1,10
439212,497_15_76,CZECH REPUBLIC,4775,11,lubos barton,10,2,4,50,2,2,100,0,2,0,0,0,0,2,3,5,2,3,2,1,1,4
439213,497_15_76,CZECH REPUBLIC,8327,12,david jelinek,16,3,8,37.5,2,3,66.7,1,5,20,3,3,100,0,1,1,3,0,1,0,1,10
439214,497_15_76,CZECH REPUBLIC,10484,13,jakub sirina,10,0,0,0,0,0,0,0,0,0,0,0,0,0,1,1,3,0,0,0,0,0
439215,497_15_76,CZECH REPUBLIC,29503,14,blake schilb,20,0,3,0,0,2,0,0,1,0,0,0,0,0,2,2,7,1,1,0,0,0
439216,497_15_76,CZECH REPUBLIC,6362,24,jan vesely,25,11,13,84.6,11,13,84.6,0,0,0,2,5,40,2,4,6,1,1,1,0,0,24
439217,497_15_76,CZECH REPUBLIC,0,TOTALS,CZECH REPUBLIC,200,37,66,56.1,35,50,70,2,16,12.5,21,26,80.8,8,24,32,28,18,11,4,3,97
439218,497_15_77,SERBIA,5751,4,milos teodosic,29,4,11,36.4,2,6,33.3,2,5,40,6,6,100,1,2,3,3,3,2,1,1,16
439219,497_15_77,SERBIA,2100,5,marko simonovic,13,0,1,0,0,0,0,0,1,0,0,0,0,1,3,4,0,2,0,0,0,0
439220,497_15_77,SERBIA,29506,6,ognjen kuzmic,8,0,0,0,0,0,0,0,0,0,0,0,0,0,2,2,0,1,0,0,0,0
439221,497_15_77,SERBIA,17361,7,bogdan bogdanovic,25,4,12,33.3,3,5,60,1,7,14.3,0,0,0,0,2,2,3,1,0,0,0,9
439222,497_15_77,SERBIA,15386,8,nemanja bjelica,28,3,8,37.5,1,3,33.3,2,5,40,2,2,100,1,2,3,2,5,3,1,0,10
439223,497_15_77,SERBIA,2654,9,stefan markovic,31,3,10,30,2,5,40,1,5,20,0,0,0,1,3,4,1,2,2,1,1,7
439224,497_15_77,SERBIA,19860,10,nikola kalinic,7,1,1,100,1,1,100,0,0,0,0,2,0,0,1,1,0,1,0,1,0,2
439225,497_15_77,SERBIA,15503,11,nemanja nedovic,13,2,4,50,2,2,100,0,2,0,2,3,66.7,0,2,2,2,2,2,1,0,6
439226,497_15_77,SERBIA,15505,12,dragan milosavljevic,4,0,0,0,0,0,0,0,0,0,0,0,0,0,0,0,0,1,0,0,0,0
439227,497_15_77,SERBIA,2656,13,miroslav raduljica,19,2,7,28.6,2,7,28.6,0,0,0,6,6,100,1,3,4,0,4,2,1,1,10
439228,497_15_77,SERBIA,10253,14,zoran erceg,23,0,4,0,0,1,0,0,3,0,4,6,66.7,0,0,0,2,1,1,1,0,4
439229,497_15_77,SERBIA,17652,15,nikola milutinov,0,0,0,0,0,0,0,0,0,0,0,0,0,0,0,0,0,0,0,0,0,0
439230,497_15_77,SERBIA,0,TOTALS,SERBIA,200,19,58,32.8,13,30,43.3,6,28,21.4,20,25,80,7,22,29,13,23,12,7,3,64
439231,497_15_77,LITHUANIA,1726,5,mantas kalnietis,37,5,9,55.6,4,7,57.1,1,2,50,1,2,50,0,5,5,9,4,8,1,1,12
439232,497_15_77,LITHUANIA,8963,6,deividas gailius,0,0,0,0,0,0,0,0,0,0,0,0,0,0,0,0,0,0,0,0,0,0
439233,497_15_77,LITHUANIA,980,8,jonas maciulis,25,2,6,33.3,2,5,40,0,1,0,5,5,100,0,6,6,0,4,0,3,0,9
439234,497_15_77,LITHUANIA,3474,10,renaldas seibutis,28,5,13,38.5,5,11,45.5,0,2,0,3,4,75,0,3,3,2,3,0,0,1,13
439235,497_15_77,LITHUANIA,22216,11,domantas sabonis,0,0,0,0,0,0,0,0,0,0,0,0,0,0,0,0,0,0,0,0,0,0
439236,497_15_77,LITHUANIA,3476,12,antanas kavaliauskas,9,0,1,0,0,1,0,0,0,0,0,0,0,1,1,2,1,4,0,0,0,0
439237,497_15_77,LITHUANIA,987,13,paulius jankunas,26,1,4,25,1,3,33.3,0,1,0,0,0,0,1,3,4,0,4,3,0,0,2
439238,497_15_77,LITHUANIA,24,15,robertas javtokas,0,0,0,0,0,0,0,0,0,0,0,0,0,0,0,0,0,0,0,0,0,0
439239,497_15_77,LITHUANIA,10916,17,jonas valanciunas,27,5,6,83.3,5,6,83.3,0,0,0,5,6,83.3,1,2,3,0,4,3,1,4,15
439240,497_15_77,LITHUANIA,10639,19,mindaugas kuzminskas,33,6,11,54.5,6,7,85.7,0,4,0,1,1,100,3,6,9,1,1,1,0,0,13
439241,497_15_77,LITHUANIA,29513,21,arturas milaknis,15,1,5,20,0,1,0,1,4,25,0,0,0,0,1,1,0,1,2,0,0,3
439242,497_15_77,LITHUANIA,17685,43,lukas lekavicius,0,0,0,0,0,0,0,0,0,0,0,0,0,0,0,0,0,0,0,0,0,0
439243,497_15_77,LITHUANIA,0,TOTALS,LITHUANIA,200,25,55,45.5,23,41,56.1,2,14,14.3,15,18,83.3,8,32,40,13,25,20,5,6,67
439244,497_15_78,FRANCE,11077,4,leo j. p. westermann,0,0,0,0,0,0,0,0,0,0,0,0,0,0,0,0,0,0,0,0,0,0
439245,497_15_78,FRANCE,2588,5,nicolas batum,20,3,9,33.3,3,6,50,0,3,0,1,2,50,0,3,3,3,2,0,2,0,7
439246,497_15_78,FRANCE,11076,7,joffrey lauvergne,9,0,2,0,0,1,0,0,1,0,1,2,50,0,2,2,1,2,0,0,0,1
439247,497_15_78,FRANCE,1864,8,charles kahudi,11,1,5,20,1,5,20,0,0,0,0,0,0,3,2,5,1,3,0,0,0,2
439248,497_15_78,FRANCE,5047,9,tony parker,32,3,12,25,3,10,30,0,2,0,7,7,100,0,2,2,4,0,3,1,0,13
439249,497_15_78,FRANCE,12971,10,evan fournier,22,6,7,85.7,3,3,100,3,4,75,0,0,0,1,4,5,2,3,0,1,0,15
439250,497_15_78,FRANCE,4663,11,florent pietrus,11,0,1,0,0,1,0,0,0,0,0,0,0,2,1,3,0,3,0,0,1,0
439251,497_15_78,FRANCE,10428,12,nando de colo,23,7,12,58.3,5,6,83.3,2,6,33.3,4,4,100,0,3,3,4,4,2,1,0,20
439252,497_15_78,FRANCE,4665,13,boris diaw,26,2,5,40,2,5,40,0,0,0,0,0,0,0,1,1,6,3,3,0,0,4
439253,497_15_78,FRANCE,5044,15,mickael gelabale,15,2,2,100,2,2,100,0,0,0,0,0,0,1,2,3,0,2,0,1,1,4
439254,497_15_78,FRANCE,17374,16,rudy gobert,31,6,13,46.2,6,13,46.2,0,0,0,3,7,42.9,7,7,14,0,2,0,1,3,15
439255,497_15_78,FRANCE,17677,19,mouhammadou jaiteh,0,0,0,0,0,0,0,0,0,0,0,0,0,0,0,0,0,0,0,0,0,0
439256,497_15_78,FRANCE,0,TOTALS,FRANCE,200,30,68,44.1,25,52,48.1,5,16,31.2,16,22,72.7,16,27,43,21,24,10,7,5,81
439257,497_15_78,SERBIA,5751,4,milos teodosic,27,0,9,0,0,3,0,0,6,0,3,3,100,0,4,4,3,3,3,0,0,3
439258,497_15_78,SERBIA,2100,5,marko simonovic,15,1,2,50,0,0,0,1,2,50,0,0,0,0,0,0,0,3,1,0,0,3
439259,497_15_78,SERBIA,29506,6,ognjen kuzmic,3,0,0,0,0,0,0,0,0,0,0,0,0,0,2,2,0,1,0,0,0,0
439260,497_15_78,SERBIA,17361,7,bogdan bogdanovic,25,5,9,55.6,3,3,100,2,6,33.3,2,2,100,0,0,0,3,4,4,1,0,14
439261,497_15_78,SERBIA,15386,8,nemanja bjelica,32,4,11,36.4,2,5,40,2,6,33.3,2,2,100,0,6,6,3,5,2,1,1,12
439262,497_15_78,SERBIA,2654,9,stefan markovic,31,3,7,42.9,1,1,100,2,6,33.3,0,0,0,0,1,1,2,3,0,1,0,8
439263,497_15_78,SERBIA,19860,10,nikola kalinic,7,0,0,0,0,0,0,0,0,0,1,2,50,0,1,1,0,0,0,0,0,1
439264,497_15_78,SERBIA,15503,11,nemanja nedovic,22,2,4,50,1,2,50,1,2,50,4,4,100,0,0,0,1,2,0,0,0,9
439265,497_15_78,SERBIA,15505,12,dragan milosavljevic,0,0,0,0,0,0,0,0,0,0,0,0,0,0,0,0,0,0,0,0,0,0
439266,497_15_78,SERBIA,2656,13,miroslav raduljica,24,5,8,62.5,5,8,62.5,0,0,0,1,1,100,3,5,8,4,4,1,0,0,11
439267,497_15_78,SERBIA,10253,14,zoran erceg,14,2,5,40,2,2,100,0,3,0,3,6,50,0,1,1,1,1,1,0,0,7
439268,497_15_78,SERBIA,17652,15,nikola milutinov,0,0,0,0,0,0,0,0,0,0,0,0,0,0,0,0,0,0,0,0,0,0
439269,497_15_78,SERBIA,0,TOTALS,SERBIA,200,22,55,40,14,24,58.3,8,31,25.8,16,20,80,7,22,29,17,27,13,3,1,68
439270,497_15_79,SPAIN,61,4,pau gasol,32,9,18,50,8,17,47.1,1,1,100,6,8,75,4,8,12,4,1,0,1,3,25
439271,497_15_79,SPAIN,70,5,rudy fernandez,21,4,7,57.1,3,3,100,1,4,25,2,2,100,0,1,1,1,2,1,2,0,11
439272,497_15_79,SPAIN,1877,6,sergio rodriguez,23,2,6,33.3,2,3,66.7,0,3,0,0,0,0,0,2,2,6,1,2,0,0,4
439273,497_15_79,SPAIN,17609,7,guillermo hernangomez,0,0,0,0,0,0,0,0,0,0,0,0,0,0,0,0,0,0,0,0,0,0
439274,497_15_79,SPAIN,5713,8,pau ribas tossas,20,2,4,50,1,1,100,1,3,33.3,0,0,0,0,1,1,0,2,0,0,0,5
439275,497_15_79,SPAIN,66,9,felipe reyes,18,2,4,50,2,3,66.7,0,1,0,4,4,100,1,0,1,1,3,1,0,1,8
439276,497_15_79,SPAIN,2628,10,victor claver,15,3,4,75,2,2,100,1,2,50,0,0,0,2,4,6,0,3,1,0,2,7
439277,497_15_79,SPAIN,1317,11,fernando san emeterio,10,0,1,0,0,1,0,0,0,0,0,0,0,1,0,1,0,1,0,0,0,0
439278,497_15_79,SPAIN,1871,12,sergio llull,31,5,7,71.4,3,5,60,2,2,100,0,0,0,0,6,6,5,2,4,1,0,12
439279,497_15_79,SPAIN,6265,13,pablo aguilar,1,0,0,0,0,0,0,0,0,0,0,0,0,0,0,0,0,1,0,0,0,0
439280,497_15_79,SPAIN,17234,14,nikola mirotic,28,3,8,37.5,1,3,33.3,2,5,40,0,0,0,0,2,2,2,3,0,1,0,8
439281,497_15_79,SPAIN,19987,15,guillem vives,1,0,1,0,0,0,0,0,1,0,0,0,0,0,1,1,0,0,0,0,0,0
439282,497_15_79,SPAIN,0,TOTALS,SPAIN,200,30,60,50,22,38,57.9,8,22,36.4,12,14,85.7,8,28,36,19,20,10,5,6,80
439283,497_15_79,LITHUANIA,1726,5,mantas kalnietis,36,5,15,33.3,2,9,22.2,3,6,50,0,0,0,0,1,1,6,0,3,2,0,13
439284,497_15_79,LITHUANIA,8963,6,deividas gailius,1,0,0,0,0,0,0,0,0,0,1,2,50,0,0,0,0,0,0,0,0,1
439285,497_15_79,LITHUANIA,980,8,jonas maciulis,28,3,8,37.5,2,4,50,1,4,25,1,2,50,2,2,4,2,3,3,1,1,8
439286,497_15_79,LITHUANIA,3474,10,renaldas seibutis,27,4,9,44.4,2,5,40,2,4,50,3,4,75,1,3,4,0,0,3,0,0,13
439287,497_15_79,LITHUANIA,22216,11,domantas sabonis,1,0,1,0,0,1,0,0,0,0,0,0,0,0,0,0,0,0,0,0,0,0
439288,497_15_79,LITHUANIA,3476,12,antanas kavaliauskas,13,1,4,25,1,4,25,0,0,0,2,2,100,3,2,5,0,4,1,0,0,4
439289,497_15_79,LITHUANIA,987,13,paulius jankunas,20,0,4,0,0,0,0,0,4,0,3,6,50,1,3,4,0,4,1,0,0,3
439290,497_15_79,LITHUANIA,24,15,robertas javtokas,1,0,0,0,0,0,0,0,0,0,0,0,0,0,0,0,0,1,0,0,0,0
439291,497_15_79,LITHUANIA,10916,17,jonas valanciunas,26,5,10,50,5,10,50,0,0,0,0,0,0,4,5,9,2,5,1,0,0,10
439292,497_15_79,LITHUANIA,10639,19,mindaugas kuzminskas,26,4,9,44.4,4,7,57.1,0,2,0,0,0,0,1,5,6,2,1,1,0,0,8
439293,497_15_79,LITHUANIA,29513,21,arturas milaknis,9,1,3,33.3,0,1,0,1,2,50,0,1,0,0,0,0,0,1,0,0,0,3
439294,497_15_79,LITHUANIA,17685,43,lukas lekavicius,12,0,2,0,0,2,0,0,0,0,0,0,0,0,0,0,2,0,0,1,0,0
439295,497_15_79,LITHUANIA,0,TOTALS,LITHUANIA,200,23,65,35.4,16,43,37.2,7,22,31.8,10,17,58.8,18,23,41,14,19,13,4,1,63
439296,498_13_01,SWITZERLAND,12691,4,jonathan malu kazadi-muyombu,23,4,7,57.1,4,5,80,0,2,0,1,2,50,1,3,4,4,1,1,1,0,9
439297,498_13_01,SWITZERLAND,7804,6,dusan mladjan,26,5,10,50,2,4,50,3,6,50,0,0,0,1,3,4,2,4,3,1,0,13
439298,498_13_01,SWITZERLAND,12693,7,stefan petkovic,17,2,5,40,0,1,0,2,4,50,2,2,100,0,1,1,3,0,0,2,0,8
439299,498_13_01,SWITZERLAND,1260,8,cedric lionel mafuta,15,1,1,100,0,0,0,1,1,100,0,0,0,0,5,5,2,2,0,0,0,3
439300,498_13_01,SWITZERLAND,15690,9,jeremy jaunin,8,0,1,0,0,1,0,0,0,0,1,2,50,0,1,1,1,0,0,0,0,1
439301,498_13_01,SWITZERLAND,19748,10,roberto kovac,20,1,5,20,0,0,0,1,5,20,0,0,0,0,1,1,2,1,0,0,0,3
439302,498_13_01,SWITZERLAND,15691,11,jonathan eric dubas,22,4,10,40,4,9,44.4,0,1,0,2,3,66.7,2,5,7,1,3,4,1,0,10
439303,498_13_01,SWITZERLAND,16102,13,clint capela,23,5,9,55.6,5,9,55.6,0,0,0,0,0,0,2,9,11,0,2,0,0,2,10
439304,498_13_01,SWITZERLAND,10246,14,derek stockalper,0,0,0,0,0,0,0,0,0,0,0,0,0,0,0,0,0,0,0,0,0,0
439305,498_13_01,SWITZERLAND,4860,15,oliver matthias vogt,17,3,6,50,3,5,60,0,1,0,2,2,100,0,2,2,0,2,0,0,0,8
439306,498_13_01,SWITZERLAND,17270,22,florian jacques steinmann,10,0,1,0,0,0,0,0,1,0,0,0,0,0,0,0,0,1,0,0,1,0
439307,498_13_01,SWITZERLAND,16096,25,marko mladjan,20,5,5,100,2,2,100,3,3,100,0,0,0,1,3,4,0,0,0,0,0,13
439308,498_13_01,SWITZERLAND,0,TOTALS,SWITZERLAND,200,30,60,50,20,36,55.6,10,24,41.7,8,11,72.7,7,33,40,15,16,8,5,3,78
439309,498_13_01,DENMARK,5021,4,adama kasper darbo,28,3,11,27.3,2,6,33.3,1,5,20,0,0,0,0,0,0,1,0,1,0,0,7
439310,498_13_01,DENMARK,10160,5,frederik nielsen,14,0,2,0,0,0,0,0,2,0,0,0,0,0,1,1,1,1,2,1,0,0
439311,498_13_01,DENMARK,15325,6,mikkel venneberg plannthin,18,3,9,33.3,2,6,33.3,1,3,33.3,0,0,0,0,1,1,0,1,0,1,0,7
439312,498_13_01,DENMARK,16162,7,esben reinholt,23,1,7,14.3,0,3,0,1,4,25,0,2,0,1,3,4,0,0,0,1,0,3
439313,498_13_01,DENMARK,29515,8,david erle harder,12,0,2,0,0,1,0,0,1,0,0,0,0,1,0,1,0,2,0,1,0,0
439314,498_13_01,DENMARK,13182,9,christian benzon,6,0,1,0,0,1,0,0,0,0,0,2,0,0,0,0,0,2,1,0,0,0
439315,498_13_01,DENMARK,17663,10,jacob enevold jensen,12,1,4,25,1,4,25,0,0,0,0,0,0,0,3,3,0,1,2,0,0,2
439316,498_13_01,DENMARK,10649,11,mathias seilund,10,0,5,0,0,4,0,0,1,0,0,0,0,0,0,0,1,3,1,0,0,0
439317,498_13_01,DENMARK,12662,12,alexander heidenheim bak,19,0,3,0,0,2,0,0,1,0,0,0,0,1,1,2,0,2,0,0,0,0
439318,498_13_01,DENMARK,4984,13,nicolai iversen,27,6,9,66.7,5,7,71.4,1,2,50,0,0,0,3,2,5,1,1,1,0,0,13
439319,498_13_01,DENMARK,20091,15,alexander birketoft,10,0,3,0,0,2,0,0,1,0,0,0,0,2,1,3,0,2,1,0,0,0
439320,498_13_01,DENMARK,12663,22,jonas zohore bergstedt,20,2,4,50,1,2,50,1,2,50,0,2,0,0,4,4,1,3,1,1,0,5
439321,498_13_01,DENMARK,0,TOTALS,DENMARK,200,16,60,26.7,11,38,28.9,5,22,22.7,0,6,0,8,16,24,5,18,11,5,0,37
439322,498_13_02,ROMANIA,2115,4,andrei mandache,37,7,12,58.3,5,8,62.5,2,4,50,2,2,100,0,2,2,2,3,4,5,0,18
439323,498_13_02,ROMANIA,5016,5,adrian tudor,31,4,6,66.7,2,4,50,2,2,100,0,1,0,2,1,3,5,2,2,1,0,10
439324,498_13_02,ROMANIA,5017,6,ionut florin dragusin,11,0,2,0,0,2,0,0,0,0,0,0,0,1,3,4,1,3,2,0,0,0
439325,498_13_02,ROMANIA,12540,7,daniel ionut popescu,4,0,1,0,0,1,0,0,0,0,0,0,0,1,0,1,0,1,2,1,0,0
439326,498_13_02,ROMANIA,10208,8,brice kabengele kalala,22,5,9,55.6,4,4,100,1,5,20,0,0,0,0,3,3,2,3,3,2,1,11
439327,498_13_02,ROMANIA,19741,9,adrian vasile stefan,0,0,0,0,0,0,0,0,0,0,0,0,0,0,0,0,0,0,0,0,0,0
439328,498_13_02,ROMANIA,10212,10,andrei daniel capusan,4,0,0,0,0,0,0,0,0,0,0,0,0,0,0,0,0,1,0,0,0,0
439329,498_13_02,ROMANIA,2915,11,catalin baciu,5,1,1,100,1,1,100,0,0,0,1,2,50,0,1,1,0,1,0,0,0,3
439330,498_13_02,ROMANIA,2125,14,titus nicoara,21,2,7,28.6,2,5,40,0,2,0,2,2,100,2,1,3,1,4,1,0,0,6
439331,498_13_02,ROMANIA,4965,15,mihai vlad silvasan,17,1,7,14.3,1,4,25,0,3,0,0,0,0,0,4,4,2,3,3,1,0,2
439332,498_13_02,ROMANIA,11102,21,bogdan tibirna,25,4,8,50,4,8,50,0,0,0,1,3,33.3,3,2,5,0,2,0,2,1,9
439333,498_13_02,ROMANIA,12712,22,adrian gutoaia,24,2,8,25,2,5,40,0,3,0,5,6,83.3,1,3,4,1,4,0,1,0,9
439334,498_13_02,ROMANIA,0,TOTALS,ROMANIA,200,26,61,42.6,21,42,50,5,19,26.3,11,16,68.8,11,21,32,14,27,17,13,2,68
439335,498_13_02,BULGARIA,1667,4,deyan ivanov,30,9,20,45,7,18,38.9,2,2,100,7,10,70,5,3,8,1,1,1,1,0,27
439336,498_13_02,BULGARIA,1667,5,kaloyan ivanov,24,3,7,42.9,1,4,25,2,3,66.7,7,7,100,0,5,5,2,1,1,1,0,15
439337,498_13_02,BULGARIA,2852,8,chavdar kostov,17,2,4,50,2,4,50,0,0,0,0,1,0,1,1,2,2,3,0,0,0,4
439338,498_13_02,BULGARIA,29516,9,branko mirkovic,32,6,9,66.7,4,6,66.7,2,3,66.7,6,6,100,2,3,5,6,4,3,3,0,20
439339,498_13_02,BULGARIA,8347,10,bozhidar avramov,27,1,4,25,0,1,0,1,3,33.3,4,4,100,1,4,5,3,1,2,4,0,7
439340,498_13_02,BULGARIA,2855,11,ivan lilov,36,3,10,30,0,3,0,3,7,42.9,0,0,0,3,3,6,4,1,5,2,1,9
439341,498_13_02,BULGARIA,8346,12,aleksandar georgiev,3,0,0,0,0,0,0,0,0,0,0,0,0,0,0,0,0,1,0,0,0,0
439342,498_13_02,BULGARIA,13084,14,pavlin ivanov,1,0,0,0,0,0,0,0,0,0,0,0,0,0,0,0,0,0,0,0,0,0
439343,498_13_02,BULGARIA,7959,15,kostadin marshavelski,0,0,0,0,0,0,0,0,0,0,0,0,0,0,0,0,0,0,0,0,0,0
439344,498_13_02,BULGARIA,5588,21,nikolay varbanov,17,1,2,50,1,2,50,0,0,0,0,0,0,1,3,4,0,4,4,1,1,2
439345,498_13_02,BULGARIA,10177,24,veselin veselinov,10,0,1,0,0,1,0,0,0,0,0,0,0,0,0,0,1,1,2,0,0,0
439346,498_13_02,BULGARIA,10445,34,martin durchev,4,0,1,0,0,0,0,0,1,0,0,0,0,1,0,1,0,1,0,1,0,0
439347,498_13_02,BULGARIA,0,TOTALS,BULGARIA,200,25,58,43.1,15,39,38.5,10,19,52.6,24,28,85.7,15,27,42,19,18,18,13,2,84
439348,498_13_03,BELARUS,4907,4,pavel ulyanko,24,4,9,44.4,2,6,33.3,2,3,66.7,2,3,66.7,0,3,3,3,3,2,1,1,12
439349,498_13_03,BELARUS,15346,5,siarhei charykau,28,5,7,71.4,3,4,75,2,3,66.7,0,0,0,0,2,2,0,2,2,1,0,12
439350,498_13_03,BELARUS,1653,6,maksim shustau,12,1,4,25,1,2,50,0,2,0,2,2,100,0,2,2,2,2,1,0,0,4
439351,498_13_03,BELARUS,5477,7,artsiom parakhouski,26,7,11,63.6,7,11,63.6,0,0,0,0,0,0,2,5,7,1,5,2,3,4,14
439352,498_13_03,BELARUS,2847,8,mikita meshcharakou,7,0,2,0,0,2,0,0,0,0,0,0,0,0,2,2,1,2,0,0,0,0
439353,498_13_03,BELARUS,991,9,dzmitry akulich,0,0,0,0,0,0,0,0,0,0,0,0,0,0,0,0,0,0,0,0,0,0
439354,498_13_03,BELARUS,13157,10,vitali liutych,26,5,9,55.6,3,6,50,2,3,66.7,5,8,62.5,1,3,4,2,2,2,0,1,17
439355,498_13_03,BELARUS,999,11,yury mishukou,0,0,0,0,0,0,0,0,0,0,0,0,0,0,0,0,0,0,0,0,0,0
439356,498_13_03,BELARUS,998,12,aliaksandr pustahvar,26,3,13,23.1,2,7,28.6,1,6,16.7,2,2,100,2,6,8,0,2,0,3,0,9
439357,498_13_03,BELARUS,11187,13,uladzimir krysevich,3,0,0,0,0,0,0,0,0,0,1,2,50,2,1,3,0,2,1,0,0,1
439358,498_13_03,BELARUS,4915,14,aliaksandr kudrautsau,30,3,12,25,2,7,28.6,1,5,20,3,4,75,1,3,4,8,3,3,2,0,10
439359,498_13_03,BELARUS,1645,15,aliaksei trastsinetski,19,0,1,0,0,1,0,0,0,0,0,0,0,1,3,4,1,2,0,0,0,0
439360,498_13_03,BELARUS,0,TOTALS,BELARUS,200,28,68,41.2,20,46,43.5,8,22,36.4,15,21,71.4,9,36,45,18,25,14,10,6,79
439361,498_13_03,HUNGARY,4535,4,balazs simon,29,5,13,38.5,3,9,33.3,2,4,50,4,6,66.7,0,3,3,0,3,0,0,0,16
439362,498_13_03,HUNGARY,6487,5,gergely toth,0,0,0,0,0,0,0,0,0,0,0,0,0,0,0,0,0,0,0,0,0,0
439363,498_13_03,HUNGARY,12503,6,akos keller,16,5,9,55.6,5,9,55.6,0,0,0,3,5,60,3,8,11,0,5,2,0,0,13
439364,498_13_03,HUNGARY,1125,7,krisztian wittmann,20,1,5,20,1,3,33.3,0,2,0,1,1,100,0,2,2,3,1,2,0,0,3
439365,498_13_03,HUNGARY,8415,9,david vojvoda,32,6,14,42.9,3,6,50,3,8,37.5,2,2,100,0,1,1,2,2,3,1,0,17
439366,498_13_03,HUNGARY,19714,11,obadiah trotter,26,5,13,38.5,5,10,50,0,3,0,0,2,0,0,4,4,4,3,2,0,1,10
439367,498_13_03,HUNGARY,2751,13,adam toth,19,2,3,66.7,2,3,66.7,0,0,0,2,4,50,2,2,4,0,3,3,0,0,6
439368,498_13_03,HUNGARY,1941,14,zsolt andras szabo,28,0,2,0,0,0,0,0,2,0,2,2,100,0,7,7,1,3,2,0,0,2
439369,498_13_03,HUNGARY,1123,15,csaba ferencz,14,1,2,50,0,0,0,1,2,50,0,0,0,0,1,1,0,3,0,0,0,3
439370,498_13_03,HUNGARY,1942,21,norbert toth,17,1,4,25,0,2,0,1,2,50,2,2,100,1,2,3,1,4,1,0,0,5
439371,498_13_03,HUNGARY,10440,25,jozsef lekli,0,0,0,0,0,0,0,0,0,0,0,0,0,0,0,0,0,0,0,0,0,0
439372,498_13_03,HUNGARY,24341,32,rosco allen,0,0,0,0,0,0,0,0,0,0,0,0,0,0,0,0,0,0,0,0,0,0
439373,498_13_03,HUNGARY,0,TOTALS,HUNGARY,200,26,65,40,19,42,45.2,7,23,30.4,16,24,66.7,8,34,42,11,27,15,1,1,75
439374,498_13_04,AUSTRIA,2103,5,thomas schreiner,20,1,2,50,0,0,0,1,2,50,2,2,100,1,6,7,4,2,2,3,0,5
439375,498_13_04,AUSTRIA,16191,6,jozo rados,10,0,1,0,0,1,0,0,0,0,0,2,0,0,3,3,1,3,0,0,1,0
439376,498_13_04,AUSTRIA,10194,7,davor lamesic,18,5,7,71.4,5,7,71.4,0,0,0,4,9,44.4,2,3,5,1,2,1,1,0,14
439377,498_13_04,AUSTRIA,15362,13,jason david detrick,23,4,10,40,2,5,40,2,5,40,0,2,0,0,2,2,4,1,1,1,2,10
439378,498_13_04,AUSTRIA,8392,20,romed vieider,15,3,8,37.5,1,4,25,2,4,50,0,0,0,0,1,1,0,0,1,0,1,8
439379,498_13_04,AUSTRIA,19730,23,kevin francis payton,8,0,1,0,0,1,0,0,0,0,0,0,0,0,1,1,1,1,1,0,0,0
439380,498_13_04,AUSTRIA,8396,24,rasid mahalbasic,19,6,8,75,6,8,75,0,0,0,9,11,81.8,4,9,13,0,2,3,0,2,21
439381,498_13_04,AUSTRIA,7853,31,benedikt danek,20,1,4,25,1,1,100,0,3,0,1,2,50,1,0,1,3,1,1,2,0,3
439382,498_13_04,AUSTRIA,2106,32,richard poiger,17,6,7,85.7,6,6,100,0,1,0,5,5,100,2,4,6,0,1,3,2,1,17
439383,498_13_04,AUSTRIA,6415,34,moritz lanegger,18,1,2,50,0,1,0,1,1,100,2,2,100,1,1,2,3,3,2,1,0,5
439384,498_13_04,AUSTRIA,11250,42,thomas klepeisz,19,4,6,66.7,2,2,100,2,4,50,0,0,0,1,0,1,6,0,0,2,0,10
439385,498_13_04,AUSTRIA,15717,43,anton maresch,13,5,7,71.4,2,4,50,3,3,100,5,6,83.3,0,2,2,0,1,0,2,0,18
439386,498_13_04,AUSTRIA,0,TOTALS,AUSTRIA,200,36,63,57.1,25,40,62.5,11,23,47.8,28,41,68.3,12,32,44,23,17,15,14,7,111
439387,498_13_04,LUXEMBOURG,5918,5,pitt koster,25,2,6,33.3,2,5,40,0,1,0,0,0,0,1,2,3,0,3,3,2,0,4
439388,498_13_04,LUXEMBOURG,2966,6,raul leandro birenbaum,30,6,12,50,2,4,50,4,8,50,0,0,0,1,2,3,2,0,2,0,0,16
439389,498_13_04,LUXEMBOURG,8344,8,christopher c. g. jones,24,7,16,43.8,3,6,50,4,10,40,4,7,57.1,1,2,3,3,2,3,5,1,22
439390,498_13_04,LUXEMBOURG,1283,9,jairo emanuel delgado ferreira,12,2,5,40,1,3,33.3,1,2,50,0,0,0,1,0,1,1,3,2,1,0,5
439391,498_13_04,LUXEMBOURG,1993,13,samy picard,28,5,15,33.3,5,11,45.5,0,4,0,4,6,66.7,3,3,6,1,1,4,0,0,14
439392,498_13_04,LUXEMBOURG,24209,15,pablo genevo,23,2,5,40,2,5,40,0,0,0,5,6,83.3,2,4,6,1,4,1,1,0,9
439393,498_13_04,LUXEMBOURG,19728,20,alexandre rodenbourg,19,1,4,25,1,1,100,0,3,0,0,0,0,0,1,1,1,4,1,0,0,2
439394,498_13_04,LUXEMBOURG,19729,22,laurent majerus,13,1,2,50,1,2,50,0,0,0,0,0,0,2,2,4,1,2,0,0,0,2
439395,498_13_04,LUXEMBOURG,19747,24,joe biever,7,0,1,0,0,1,0,0,0,0,0,0,0,0,1,1,0,4,2,0,0,0
439396,498_13_04,LUXEMBOURG,8340,30,jean nicolas c. kox,13,1,3,33.3,1,2,50,0,1,0,1,2,50,0,3,3,0,3,0,0,0,3
439397,498_13_04,LUXEMBOURG,29517,33,dominique benseghir,5,0,3,0,0,0,0,0,3,0,0,2,0,2,0,2,0,2,0,0,0,0
439398,498_13_04,LUXEMBOURG,0,TOTALS,LUXEMBOURG,200,27,72,37.5,18,40,45,9,32,28.1,14,23,60.9,15,21,36,10,28,19,9,1,77
439399,498_13_05,DENMARK,5021,4,adama kasper darbo,28,3,7,42.9,3,7,42.9,0,0,0,3,4,75,1,1,2,2,5,3,1,0,9
439400,498_13_05,DENMARK,10160,5,frederik nielsen,17,0,0,0,0,0,0,0,0,0,0,0,0,0,1,1,2,3,0,0,0,0
439401,498_13_05,DENMARK,15325,6,mikkel venneberg plannthin,27,3,8,37.5,1,3,33.3,2,5,40,4,4,100,1,1,2,1,2,2,0,0,12
439402,498_13_05,DENMARK,16162,7,esben reinholt,29,9,17,52.9,7,12,58.3,2,5,40,5,6,83.3,3,1,4,0,0,1,1,1,25
439403,498_13_05,DENMARK,29515,8,david erle harder,11,1,3,33.3,0,1,0,1,2,50,0,0,0,0,0,0,0,0,0,1,0,3
439404,498_13_05,DENMARK,13182,9,christian benzon,4,0,0,0,0,0,0,0,0,0,0,0,0,0,0,0,0,1,0,0,0,0
439405,498_13_05,DENMARK,17663,10,jacob enevold jensen,5,0,1,0,0,1,0,0,0,0,0,0,0,0,1,1,0,1,0,0,0,0
439406,498_13_05,DENMARK,10649,11,mathias seilund,6,0,0,0,0,0,0,0,0,0,0,0,0,0,0,0,0,0,0,0,0,0
439407,498_13_05,DENMARK,12662,12,alexander heidenheim bak,8,1,2,50,1,2,50,0,0,0,0,0,0,0,2,2,0,3,0,0,0,2
439408,498_13_05,DENMARK,4984,13,nicolai iversen,33,6,13,46.2,6,11,54.5,0,2,0,0,0,0,1,8,9,1,3,2,1,1,12
439409,498_13_05,DENMARK,20091,15,alexander birketoft,7,2,2,100,1,1,100,1,1,100,0,0,0,0,4,4,1,0,0,0,0,5
439410,498_13_05,DENMARK,12663,22,jonas zohore bergstedt,26,2,13,15.4,2,13,15.4,0,0,0,0,2,0,6,4,10,0,3,0,1,1,4
439411,498_13_05,DENMARK,0,TOTALS,DENMARK,200,27,66,40.9,21,51,41.2,6,15,40,12,16,75,13,25,38,7,21,9,5,3,72
439412,498_13_05,AUSTRIA,2103,5,thomas schreiner,29,2,6,33.3,0,2,0,2,4,50,2,2,100,0,5,5,7,2,0,0,0,8
439413,498_13_05,AUSTRIA,10194,7,davor lamesic,25,6,11,54.5,5,9,55.6,1,2,50,4,7,57.1,2,2,4,3,2,1,0,0,17
439414,498_13_05,AUSTRIA,15362,13,jason david detrick,28,7,16,43.8,4,8,50,3,8,37.5,1,1,100,0,1,1,1,2,0,0,1,18
439415,498_13_05,AUSTRIA,8392,20,romed vieider,3,0,1,0,0,1,0,0,0,0,0,0,0,0,0,0,0,0,0,0,0,0
439416,498_13_05,AUSTRIA,19730,23,kevin francis payton,8,1,1,100,1,1,100,0,0,0,0,0,0,0,2,2,1,0,0,0,0,2
439417,498_13_05,AUSTRIA,8396,24,rasid mahalbasic,28,10,15,66.7,10,15,66.7,0,0,0,3,4,75,2,8,10,1,3,2,2,0,23
439418,498_13_05,AUSTRIA,7853,31,benedikt danek,16,0,2,0,0,1,0,0,1,0,0,0,0,0,0,0,2,2,1,2,0,0
439419,498_13_05,AUSTRIA,2106,32,richard poiger,19,2,3,66.7,2,3,66.7,0,0,0,0,0,0,1,2,3,0,2,2,0,0,4
439420,498_13_05,AUSTRIA,6415,34,moritz lanegger,18,0,1,0,0,1,0,0,0,0,1,4,25,0,4,4,2,4,1,0,0,1
439421,498_13_05,AUSTRIA,13271,41,maximilian hopfgartner,6,0,2,0,0,2,0,0,0,0,0,0,0,0,1,1,0,0,1,0,0,0
439422,498_13_05,AUSTRIA,11250,42,thomas klepeisz,12,1,1,100,0,0,0,1,1,100,0,0,0,0,1,1,1,1,1,0,0,3
439423,498_13_05,AUSTRIA,15717,43,anton maresch,8,1,3,33.3,1,2,50,0,1,0,2,2,100,0,0,0,0,2,0,0,0,4
439424,498_13_05,AUSTRIA,0,TOTALS,AUSTRIA,200,30,62,48.4,23,45,51.1,7,17,41.2,13,20,65,9,27,36,18,20,9,4,1,80
439425,498_13_06,LUXEMBOURG,5918,5,pitt koster,24,5,11,45.5,4,9,44.4,1,2,50,0,1,0,0,5,5,3,2,1,0,0,11
439426,498_13_06,LUXEMBOURG,2966,6,raul leandro birenbaum,24,3,7,42.9,1,1,100,2,6,33.3,0,0,0,0,3,3,0,3,3,0,0,8
439427,498_13_06,LUXEMBOURG,8344,8,christopher c. g. jones,20,3,5,60,2,3,66.7,1,2,50,1,2,50,1,1,2,2,4,4,1,0,8
439428,498_13_06,LUXEMBOURG,1283,9,jairo emanuel delgado ferreira,27,2,11,18.2,0,4,0,2,7,28.6,0,0,0,2,0,2,4,4,1,1,0,6
439429,498_13_06,LUXEMBOURG,1993,13,samy picard,34,5,16,31.2,4,11,36.4,1,5,20,7,8,87.5,1,6,7,1,3,3,1,0,18
439430,498_13_06,LUXEMBOURG,24209,15,pablo genevo,22,1,5,20,1,5,20,0,0,0,0,0,0,2,1,3,0,1,0,0,2,2
439431,498_13_06,LUXEMBOURG,19728,20,alexandre rodenbourg,21,0,1,0,0,1,0,0,0,0,0,0,0,3,3,6,0,4,2,0,0,0
439432,498_13_06,LUXEMBOURG,19729,22,laurent majerus,8,0,0,0,0,0,0,0,0,0,0,0,0,0,0,0,0,0,1,0,0,0
439433,498_13_06,LUXEMBOURG,19747,24,joe biever,6,1,1,100,1,1,100,0,0,0,0,0,0,0,0,0,0,1,0,0,0,2
439434,498_13_06,LUXEMBOURG,8340,30,jean nicolas c. kox,13,1,3,33.3,1,2,50,0,1,0,0,0,0,0,0,0,0,1,1,1,0,2
439435,498_13_06,LUXEMBOURG,29517,33,dominique benseghir,1,0,0,0,0,0,0,0,0,0,0,0,0,0,1,1,0,1,0,0,0,0
439436,498_13_06,LUXEMBOURG,0,TOTALS,LUXEMBOURG,200,21,60,35,14,37,37.8,7,23,30.4,8,11,72.7,10,23,33,10,24,19,4,2,57
439437,498_13_06,SWITZERLAND,12691,4,jonathan malu kazadi-muyombu,30,2,7,28.6,1,4,25,1,3,33.3,2,2,100,2,3,5,1,4,4,1,0,7
439438,498_13_06,SWITZERLAND,7804,6,dusan mladjan,21,6,11,54.5,2,2,100,4,9,44.4,1,2,50,0,3,3,2,2,3,0,0,17
439439,498_13_06,SWITZERLAND,12693,7,stefan petkovic,19,1,6,16.7,0,1,0,1,5,20,0,0,0,2,0,2,4,0,0,0,0,3
439440,498_13_06,SWITZERLAND,1260,8,cedric lionel mafuta,17,2,5,40,2,4,50,0,1,0,0,0,0,3,1,4,2,1,0,0,0,4
439441,498_13_06,SWITZERLAND,15690,9,jeremy jaunin,9,0,1,0,0,1,0,0,0,0,0,0,0,1,1,2,0,0,1,1,0,0
439442,498_13_06,SWITZERLAND,19748,10,roberto kovac,23,2,9,22.2,1,3,33.3,1,6,16.7,6,6,100,1,2,3,1,3,0,2,0,11
439443,498_13_06,SWITZERLAND,15691,11,jonathan eric dubas,26,3,5,60,3,4,75,0,1,0,4,6,66.7,2,6,8,3,2,3,1,2,10
439444,498_13_06,SWITZERLAND,16102,13,clint capela,26,3,5,60,3,5,60,0,0,0,6,9,66.7,2,7,9,0,2,2,3,3,12
439445,498_13_06,SWITZERLAND,4860,15,oliver matthias vogt,22,3,5,60,3,4,75,0,1,0,4,4,100,0,2,2,2,2,3,0,0,10
439446,498_13_06,SWITZERLAND,17392,21,evrard adam atcho,6,0,0,0,0,0,0,0,0,0,1,2,50,0,1,1,0,0,0,0,0,1
439447,498_13_06,SWITZERLAND,16096,25,marko mladjan,0,0,0,0,0,0,0,0,0,0,0,0,0,0,0,0,0,0,0,0,0,0
439448,498_13_06,SWITZERLAND,0,TOTALS,SWITZERLAND,200,22,54,40.7,15,28,53.6,7,26,26.9,24,31,77.4,13,29,42,15,16,17,8,5,75
439449,498_13_07,HUNGARY,4535,4,balazs simon,24,3,6,50,2,3,66.7,1,3,33.3,3,3,100,1,4,5,6,3,1,1,0,10
439450,498_13_07,HUNGARY,6487,5,gergely toth,0,0,0,0,0,0,0,0,0,0,0,0,0,0,0,0,0,0,0,0,0,0
439451,498_13_07,HUNGARY,12503,6,akos keller,17,4,5,80,4,5,80,0,0,0,1,2,50,5,2,7,0,2,2,1,2,9
439452,498_13_07,HUNGARY,1125,7,krisztian wittmann,21,0,5,0,0,3,0,0,2,0,2,2,100,0,2,2,3,3,0,2,0,2
439453,498_13_07,HUNGARY,8415,9,david vojvoda,32,7,13,53.8,4,7,57.1,3,6,50,0,0,0,1,4,5,1,1,2,4,0,17
439454,498_13_07,HUNGARY,29518,10,peter kovacs,3,0,0,0,0,0,0,0,0,0,0,0,0,0,1,1,1,0,0,1,0,0
439455,498_13_07,HUNGARY,19714,11,obadiah trotter,24,2,5,40,0,2,0,2,3,66.7,1,2,50,1,5,6,4,0,4,1,2,7
439456,498_13_07,HUNGARY,2751,13,adam toth,16,4,6,66.7,4,6,66.7,0,0,0,0,0,0,2,0,2,0,3,3,0,0,8
439457,498_13_07,HUNGARY,1941,14,zsolt andras szabo,20,4,9,44.4,2,3,66.7,2,6,33.3,1,1,100,0,7,7,2,2,0,0,0,11
439458,498_13_07,HUNGARY,1123,15,csaba ferencz,16,2,9,22.2,1,3,33.3,1,6,16.7,1,2,50,1,2,3,0,0,0,0,0,6
439459,498_13_07,HUNGARY,1942,21,norbert toth,20,2,5,40,1,3,33.3,1,2,50,0,0,0,0,2,2,0,3,2,2,0,5
439460,498_13_07,HUNGARY,10440,25,jozsef lekli,7,0,1,0,0,1,0,0,0,0,0,0,0,0,2,2,0,2,2,0,0,0
439461,498_13_07,HUNGARY,0,TOTALS,HUNGARY,200,28,64,43.8,18,36,50,10,28,35.7,9,12,75,11,32,43,17,19,18,12,4,75
439462,498_13_07,SLOVAK REPUBLIC,8446,4,richard korner,21,2,8,25,2,7,28.6,0,1,0,1,2,50,2,4,6,0,1,1,0,1,5
439463,498_13_07,SLOVAK REPUBLIC,8022,5,maros rendla,0,0,0,0,0,0,0,0,0,0,0,0,0,0,0,0,0,0,0,0,0,0
439464,498_13_07,SLOVAK REPUBLIC,8444,6,marek jass,1,0,0,0,0,0,0,0,0,0,0,0,0,0,0,0,0,0,0,0,0,0
439465,498_13_07,SLOVAK REPUBLIC,17785,7,oliver tot,24,1,6,16.7,1,4,25,0,2,0,0,0,0,0,3,3,1,1,2,1,0,2
439466,498_13_07,SLOVAK REPUBLIC,10469,8,milan ziak,18,2,8,25,1,3,33.3,1,5,20,3,4,75,0,1,1,0,0,4,2,0,8
439467,498_13_07,SLOVAK REPUBLIC,5862,9,martin bilik,20,1,6,16.7,1,2,50,0,4,0,0,0,0,2,2,4,0,2,3,0,0,2
439468,498_13_07,SLOVAK REPUBLIC,6339,11,peter dorazil,28,7,17,41.2,7,16,43.8,0,1,0,2,2,100,4,6,10,0,1,5,3,0,16
439469,498_13_07,SLOVAK REPUBLIC,5861,12,michal batka,30,2,6,33.3,2,6,33.3,0,0,0,0,0,0,3,5,8,0,2,2,1,0,4
439470,498_13_07,SLOVAK REPUBLIC,15367,13,marek kozlik,16,1,3,33.3,0,1,0,1,2,50,0,0,0,2,1,3,0,0,1,2,0,3
439471,498_13_07,SLOVAK REPUBLIC,12668,13,andrej kuffa,15,0,2,0,0,1,0,0,1,0,0,0,0,0,2,2,1,1,0,1,0,0
439472,498_13_07,SLOVAK REPUBLIC,17784,14,jakub petras,3,0,0,0,0,0,0,0,0,0,0,0,0,0,0,0,0,0,0,0,0,0
439473,498_13_07,SLOVAK REPUBLIC,8441,15,richard grznar,22,1,7,14.3,1,6,16.7,0,1,0,1,2,50,0,2,2,2,4,2,0,0,3
439474,498_13_07,SLOVAK REPUBLIC,0,TOTALS,SLOVAK REPUBLIC,200,17,63,27,15,46,32.6,2,17,11.8,7,10,70,13,28,41,4,12,20,10,1,43
439475,498_13_08,BULGARIA,1667,4,deyan ivanov,26,5,8,62.5,5,7,71.4,0,1,0,2,6,33.3,5,8,13,5,2,3,0,0,12
439476,498_13_08,BULGARIA,1667,5,kaloyan ivanov,23,4,9,44.4,3,7,42.9,1,2,50,3,5,60,2,5,7,1,4,2,0,1,12
439477,498_13_08,BULGARIA,2852,8,chavdar kostov,25,2,4,50,1,3,33.3,1,1,100,0,2,0,1,3,4,2,1,1,0,0,5
439478,498_13_08,BULGARIA,29516,9,branko mirkovic,27,2,5,40,0,3,0,2,2,100,4,4,100,3,5,8,3,2,6,1,0,10
439479,498_13_08,BULGARIA,8347,10,bozhidar avramov,20,3,5,60,2,3,66.7,1,2,50,0,2,0,0,3,3,3,2,1,1,0,7
439480,498_13_08,BULGARIA,2855,11,ivan lilov,21,7,10,70,7,8,87.5,0,2,0,0,0,0,0,6,6,1,2,2,0,0,14
439481,498_13_08,BULGARIA,8346,12,aleksandar georgiev,15,4,9,44.4,4,6,66.7,0,3,0,2,3,66.7,2,1,3,2,2,0,0,0,10
439482,498_13_08,BULGARIA,1675,13,asen velikov,13,2,2,100,0,0,0,2,2,100,0,0,0,0,1,1,2,0,2,0,0,6
439483,498_13_08,BULGARIA,5588,21,nikolay varbanov,8,3,5,60,3,5,60,0,0,0,0,0,0,0,3,3,0,1,1,0,0,6
439484,498_13_08,BULGARIA,10177,24,veselin veselinov,8,1,1,100,1,1,100,0,0,0,0,0,0,1,0,1,1,3,1,0,0,2
439485,498_13_08,BULGARIA,8350,32,hristo zahariev,8,2,4,50,2,2,100,0,2,0,0,0,0,1,1,2,0,0,0,0,0,4
439486,498_13_08,BULGARIA,10445,34,martin durchev,6,0,2,0,0,0,0,0,2,0,0,0,0,1,1,2,1,1,1,1,0,0
439487,498_13_08,BULGARIA,0,TOTALS,BULGARIA,200,35,64,54.7,28,45,62.2,7,19,36.8,11,22,50,17,39,56,21,20,20,3,1,88
439488,498_13_08,ICELAND,2061,4,brynjar bjornsson,0,0,0,0,0,0,0,0,0,0,0,0,0,0,0,0,0,0,0,0,0,0
439489,498_13_08,ICELAND,13211,5,haukur palsson,13,2,6,33.3,1,3,33.3,1,3,33.3,0,0,0,0,1,1,0,5,1,0,0,5
439490,498_13_08,ICELAND,4834,6,jakob sigurdarson,38,7,14,50,4,8,50,3,6,50,2,4,50,0,4,4,2,4,1,2,0,19
439491,498_13_08,ICELAND,22003,7,stefan karel torfason,0,0,0,0,0,0,0,0,0,0,0,0,0,0,0,0,0,0,0,0,0,0
439492,498_13_08,ICELAND,4841,8,hlynur baeringsson,35,5,11,45.5,4,8,50,1,3,33.3,0,1,0,1,2,3,1,4,3,0,0,11
439493,498_13_08,ICELAND,4837,9,jon arnor stefansson,32,5,15,33.3,4,12,33.3,1,3,33.3,2,2,100,0,1,1,2,3,1,1,0,13
439494,498_13_08,ICELAND,19926,10,martin hermannsson,0,0,0,0,0,0,0,0,0,0,0,0,0,0,0,0,0,0,0,0,0,0
439495,498_13_08,ICELAND,24208,11,axel karason,0,0,0,0,0,0,0,0,0,0,0,0,0,0,0,0,0,0,0,0,0,0
439496,498_13_08,ICELAND,15700,12,ragnar agust nathanaelsson,8,0,1,0,0,1,0,0,0,0,1,2,50,0,1,1,0,1,0,0,1,1
439497,498_13_08,ICELAND,2764,13,hordur vilhjalmsson,24,0,4,0,0,1,0,0,3,0,0,0,0,1,0,1,2,2,2,2,0,0
439498,498_13_08,ICELAND,4980,14,logi gunnarsson,17,2,6,33.3,1,2,50,1,4,25,1,2,50,0,0,0,0,2,0,0,0,6
439499,498_13_08,ICELAND,2071,15,pavel ermolinskij,33,2,8,25,2,5,40,0,3,0,0,0,0,2,8,10,4,3,3,3,0,4
439500,498_13_08,ICELAND,0,TOTALS,ICELAND,200,23,65,35.4,16,40,40,7,25,28,6,11,54.5,4,18,22,11,24,12,8,1,59
439501,498_13_09,ESTONIA,11295,4,rain veideman,18,2,4,50,1,2,50,1,2,50,0,0,0,0,0,0,0,5,2,0,0,5
439502,498_13_09,ESTONIA,1218,5,tanel sokk,16,5,12,41.7,4,10,40,1,2,50,0,1,0,3,2,5,1,2,2,1,0,11
439503,498_13_09,ESTONIA,1219,6,gert dorbek,19,1,6,16.7,1,2,50,0,4,0,0,2,0,3,0,3,3,5,1,1,0,2
439504,498_13_09,ESTONIA,1220,7,kristo saage,0,0,0,0,0,0,0,0,0,0,0,0,0,0,0,0,0,0,0,0,0,0
439505,498_13_09,ESTONIA,4625,8,janar talts,35,5,12,41.7,4,6,66.7,1,6,16.7,1,2,50,7,6,13,4,2,2,0,0,12
439506,498_13_09,ESTONIA,4622,9,gregor arbet,34,8,16,50,4,5,80,4,11,36.4,0,0,0,2,2,4,0,3,1,1,0,20
439507,498_13_09,ESTONIA,2721,10,sten sokk,36,1,8,12.5,1,3,33.3,0,5,0,2,3,66.7,1,1,2,7,3,3,1,0,4
439508,498_13_09,ESTONIA,1229,15,reinar hallik,31,3,6,50,0,0,0,3,6,50,1,2,50,3,4,7,1,5,2,2,1,10
439509,498_13_09,ESTONIA,11290,21,martin dorbek,2,0,0,0,0,0,0,0,0,0,0,0,0,0,0,0,0,0,1,0,0,0
439510,498_13_09,ESTONIA,8048,22,timo eichfuss,9,1,4,25,1,2,50,0,2,0,0,0,0,2,1,3,0,0,0,0,0,2
439511,498_13_09,ESTONIA,8373,24,kristjan kitsing,0,0,0,0,0,0,0,0,0,0,0,0,0,0,0,0,0,0,0,0,0,0
439512,498_13_09,ESTONIA,0,TOTALS,ESTONIA,200,26,68,38.2,16,30,53.3,10,38,26.3,4,10,40,21,19,40,16,25,16,6,1,66
439513,498_13_09,PORTUGAL,2730,4,jose silva,12,1,3,33.3,0,0,0,1,3,33.3,0,0,0,0,1,1,1,2,0,1,0,3
439514,498_13_09,PORTUGAL,2918,5,claudio fonseca,31,6,9,66.7,6,9,66.7,0,0,0,0,1,0,3,2,5,0,1,2,1,1,12
439515,498_13_09,PORTUGAL,8195,6,jose barbosa,0,0,0,0,0,0,0,0,0,0,0,0,0,0,0,0,0,0,0,0,0,0
439516,498_13_09,PORTUGAL,5596,7,joao gomes,22,2,6,33.3,1,3,33.3,1,3,33.3,1,3,33.3,1,1,2,3,2,2,1,0,6
439517,498_13_09,PORTUGAL,10266,8,mario fernandes,31,5,10,50,2,2,100,3,8,37.5,0,0,0,2,5,7,6,4,3,1,0,13
439518,498_13_09,PORTUGAL,4778,10,carlos andrade,34,5,8,62.5,1,2,50,4,6,66.7,2,4,50,0,5,5,5,5,4,2,0,16
439519,498_13_09,PORTUGAL,10956,11,miguel queiroz,0,0,0,0,0,0,0,0,0,0,0,0,0,0,0,0,0,0,0,0,0,0
439520,498_13_09,PORTUGAL,1168,12,marco goncalves,9,0,2,0,0,2,0,0,0,0,0,0,0,0,3,3,0,0,0,0,0,0
439521,498_13_09,PORTUGAL,7851,13,joao balseiro,6,0,1,0,0,0,0,0,1,0,0,0,0,0,0,0,0,1,0,0,0,0
439522,498_13_09,PORTUGAL,4779,14,miguel a. saraiva miranda,15,0,2,0,0,1,0,0,1,0,0,0,0,0,3,3,0,1,1,0,0,0
439523,498_13_09,PORTUGAL,4735,15,joao santos,32,4,10,40,2,4,50,2,6,33.3,4,6,66.7,1,1,2,1,3,1,1,0,14
439524,498_13_09,PORTUGAL,17260,21,tomas barroso,9,1,1,100,0,0,0,1,1,100,5,6,83.3,0,0,0,0,1,2,0,0,8
439525,498_13_09,PORTUGAL,0,TOTALS,PORTUGAL,200,24,52,46.2,12,23,52.2,12,29,41.4,12,20,60,10,24,34,16,20,15,7,1,72
439526,498_13_10,ROMANIA,2115,4,andrei mandache,37,3,10,30,2,5,40,1,5,20,0,1,0,2,4,6,7,4,4,2,0,7
439527,498_13_10,ROMANIA,5016,5,adrian tudor,30,0,4,0,0,0,0,0,4,0,2,2,100,0,3,3,4,2,2,0,0,2
439528,498_13_10,ROMANIA,5017,6,ionut florin dragusin,7,0,1,0,0,1,0,0,0,0,0,0,0,0,0,0,1,4,4,0,1,0
439529,498_13_10,ROMANIA,12540,7,daniel ionut popescu,2,0,0,0,0,0,0,0,0,0,0,0,0,0,0,0,0,0,1,0,0,0
439530,498_13_10,ROMANIA,10208,8,brice kabengele kalala,0,0,0,0,0,0,0,0,0,0,0,0,0,0,0,0,0,0,0,0,0,0
439531,498_13_10,ROMANIA,19741,9,adrian vasile stefan,14,1,3,33.3,0,2,0,1,1,100,0,0,0,1,1,2,1,0,1,0,0,3
439532,498_13_10,ROMANIA,10212,10,andrei daniel capusan,14,4,6,66.7,4,6,66.7,0,0,0,0,0,0,0,4,4,1,4,0,0,0,8
439533,498_13_10,ROMANIA,2915,11,catalin baciu,4,0,1,0,0,1,0,0,0,0,0,0,0,0,2,2,0,0,0,0,1,0
439534,498_13_10,ROMANIA,2125,14,titus nicoara,19,6,10,60,6,10,60,0,0,0,3,5,60,1,4,5,0,2,2,1,1,15
439535,498_13_10,ROMANIA,4965,15,mihai vlad silvasan,29,3,10,30,3,7,42.9,0,3,0,1,2,50,2,11,13,5,2,2,3,0,7
439536,498_13_10,ROMANIA,11102,21,bogdan tibirna,13,1,3,33.3,1,3,33.3,0,0,0,1,2,50,3,1,4,1,2,1,0,1,3
439537,498_13_10,ROMANIA,12712,22,adrian gutoaia,29,7,10,70,6,7,85.7,1,3,33.3,4,5,80,1,3,4,1,3,2,0,0,19
439538,498_13_10,ROMANIA,0,TOTALS,ROMANIA,200,25,58,43.1,22,42,52.4,3,16,18.8,11,17,64.7,11,35,46,21,23,19,6,4,64
439539,498_13_10,ICELAND,2061,4,brynjar bjornsson,0,0,0,0,0,0,0,0,0,0,0,0,0,0,0,0,0,0,0,0,0,0
439540,498_13_10,ICELAND,13211,5,haukur palsson,34,9,16,56.2,6,10,60,3,6,50,3,4,75,1,1,2,2,1,4,0,0,24
439541,498_13_10,ICELAND,4834,6,jakob sigurdarson,34,5,15,33.3,2,7,28.6,3,8,37.5,2,2,100,2,2,4,0,3,0,1,0,15
439542,498_13_10,ICELAND,22003,7,stefan karel torfason,0,0,0,0,0,0,0,0,0,0,0,0,0,0,0,0,0,0,0,0,0,0
439543,498_13_10,ICELAND,4841,8,hlynur baeringsson,36,3,8,37.5,3,6,50,0,2,0,1,2,50,3,7,10,8,3,1,1,0,7
439544,498_13_10,ICELAND,4837,9,jon arnor stefansson,26,3,8,37.5,1,5,20,2,3,66.7,2,2,100,1,1,2,2,5,3,2,0,10
439545,498_13_10,ICELAND,19926,10,martin hermannsson,0,0,0,0,0,0,0,0,0,0,0,0,0,0,0,0,0,0,0,0,0,0
439546,498_13_10,ICELAND,24208,11,axel karason,0,0,0,0,0,0,0,0,0,0,0,0,0,0,0,0,0,0,0,0,0,0
439547,498_13_10,ICELAND,15700,12,ragnar agust nathanaelsson,9,2,2,100,2,2,100,0,0,0,0,1,0,1,2,3,1,2,0,0,0,4
439548,498_13_10,ICELAND,2764,13,hordur vilhjalmsson,23,0,5,0,0,3,0,0,2,0,0,2,0,1,2,3,3,3,0,2,1,0
439549,498_13_10,ICELAND,4980,14,logi gunnarsson,3,0,1,0,0,0,0,0,1,0,0,0,0,0,0,0,0,0,0,0,0,0
439550,498_13_10,ICELAND,2071,15,pavel ermolinskij,35,3,8,37.5,2,4,50,1,4,25,5,11,45.5,0,6,6,2,0,3,2,0,12
439551,498_13_10,ICELAND,0,TOTALS,ICELAND,200,25,63,39.7,16,37,43.2,9,26,34.6,13,24,54.2,11,24,35,18,17,11,8,1,72
439552,498_13_11,SLOVAK REPUBLIC,8446,4,richard korner,14,6,7,85.7,5,5,100,1,2,50,3,3,100,1,1,2,4,1,0,0,0,16
439553,498_13_11,SLOVAK REPUBLIC,8022,5,maros rendla,8,0,4,0,0,3,0,0,1,0,0,0,0,1,0,1,1,2,1,0,0,0
439554,498_13_11,SLOVAK REPUBLIC,8444,6,marek jass,26,3,5,60,1,2,50,2,3,66.7,1,2,50,0,0,0,2,3,0,3,0,9
439555,498_13_11,SLOVAK REPUBLIC,17785,7,oliver tot,7,1,5,20,1,3,33.3,0,2,0,0,0,0,0,2,2,1,0,0,0,0,2
439556,498_13_11,SLOVAK REPUBLIC,10469,8,milan ziak,26,6,14,42.9,4,9,44.4,2,5,40,2,2,100,0,2,2,5,3,3,1,0,16
439557,498_13_11,SLOVAK REPUBLIC,5862,9,martin bilik,7,1,4,25,0,1,0,1,3,33.3,0,0,0,0,0,0,0,2,0,0,0,3
439558,498_13_11,SLOVAK REPUBLIC,6339,11,peter dorazil,28,4,9,44.4,4,9,44.4,0,0,0,2,4,50,6,5,11,0,5,2,2,1,10
439559,498_13_11,SLOVAK REPUBLIC,5861,12,michal batka,34,11,15,73.3,6,7,85.7,5,8,62.5,0,0,0,2,4,6,2,4,1,0,1,27
439560,498_13_11,SLOVAK REPUBLIC,15367,13,marek kozlik,19,0,4,0,0,2,0,0,2,0,0,0,0,1,0,1,2,3,2,0,0,0
439561,498_13_11,SLOVAK REPUBLIC,12668,13,andrej kuffa,10,2,3,66.7,1,1,100,1,2,50,0,0,0,1,1,2,2,2,0,0,0,5
439562,498_13_11,SLOVAK REPUBLIC,17784,14,jakub petras,1,0,0,0,0,0,0,0,0,0,0,0,0,0,0,0,0,0,0,0,0,0
439563,498_13_11,SLOVAK REPUBLIC,8441,15,richard grznar,20,2,4,50,1,3,33.3,1,1,100,4,6,66.7,0,2,2,4,5,0,4,0,9
439564,498_13_11,SLOVAK REPUBLIC,0,TOTALS,SLOVAK REPUBLIC,200,36,74,48.6,23,45,51.1,13,29,44.8,12,17,70.6,12,18,30,23,30,9,10,2,97
439565,498_13_11,BELARUS,4907,4,pavel ulyanko,1,0,0,0,0,0,0,0,0,0,0,0,0,0,0,0,0,0,0,0,0,0
439566,498_13_11,BELARUS,15346,5,siarhei charykau,28,3,8,37.5,2,6,33.3,1,2,50,0,0,0,1,2,3,3,4,2,0,0,7
439567,498_13_11,BELARUS,1653,6,maksim shustau,4,0,1,0,0,0,0,0,1,0,0,0,0,0,0,0,0,0,0,0,0,0
439568,498_13_11,BELARUS,5477,7,artsiom parakhouski,31,9,10,90,9,10,90,0,0,0,4,6,66.7,6,7,13,1,2,2,2,4,22
439569,498_13_11,BELARUS,2847,8,mikita meshcharakou,16,1,1,100,0,0,0,1,1,100,2,2,100,1,3,4,0,4,1,0,0,5
439570,498_13_11,BELARUS,991,9,dzmitry akulich,9,0,0,0,0,0,0,0,0,0,1,2,50,0,1,1,2,0,1,0,0,1
439571,498_13_11,BELARUS,13157,10,vitali liutych,28,9,11,81.8,6,8,75,3,3,100,12,14,85.7,0,1,1,0,2,6,0,0,33
439572,498_13_11,BELARUS,999,11,yury mishukou,7,0,0,0,0,0,0,0,0,0,0,0,0,0,1,1,0,1,1,0,0,0
439573,498_13_11,BELARUS,998,12,aliaksandr pustahvar,21,1,8,12.5,1,5,20,0,3,0,2,2,100,1,3,4,0,3,1,0,0,4
439574,498_13_11,BELARUS,11187,13,uladzimir krysevich,7,1,1,100,1,1,100,0,0,0,0,0,0,0,0,0,0,2,1,0,0,2
439575,498_13_11,BELARUS,4915,14,aliaksandr kudrautsau,31,2,9,22.2,2,4,50,0,5,0,3,6,50,1,2,3,3,3,2,1,0,7
439576,498_13_11,BELARUS,1645,15,aliaksei trastsinetski,17,2,4,50,2,4,50,0,0,0,0,0,0,2,2,4,0,0,1,1,0,4
439577,498_13_11,BELARUS,0,TOTALS,BELARUS,200,28,53,52.8,23,38,60.5,5,15,33.3,24,32,75,12,23,35,9,21,19,4,4,85
439578,498_13_12,LUXEMBOURG,5918,5,pitt koster,28,3,9,33.3,3,8,37.5,0,1,0,0,0,0,0,2,2,6,2,0,1,0,6
439579,498_13_12,LUXEMBOURG,2966,6,raul leandro birenbaum,31,2,6,33.3,1,2,50,1,4,25,0,0,0,1,4,5,1,3,1,0,0,5
439580,498_13_12,LUXEMBOURG,8344,8,christopher c. g. jones,34,4,16,25,4,10,40,0,6,0,1,2,50,1,5,6,5,3,4,3,1,9
439581,498_13_12,LUXEMBOURG,1283,9,jairo emanuel delgado ferreira,25,3,6,50,3,3,100,0,3,0,0,1,0,2,2,4,0,2,1,0,0,6
439582,498_13_12,LUXEMBOURG,1993,13,samy picard,36,10,18,55.6,8,11,72.7,2,7,28.6,4,4,100,1,4,5,1,3,1,1,1,26
439583,498_13_12,LUXEMBOURG,24209,15,pablo genevo,27,1,5,20,1,5,20,0,0,0,0,0,0,3,4,7,0,1,1,0,0,2
439584,498_13_12,LUXEMBOURG,19728,20,alexandre rodenbourg,9,2,2,100,1,1,100,1,1,100,0,0,0,0,0,0,0,2,1,0,0,5
439585,498_13_12,LUXEMBOURG,19729,22,laurent majerus,0,0,0,0,0,0,0,0,0,0,0,0,0,0,0,0,0,0,0,0,0,0
439586,498_13_12,LUXEMBOURG,19747,24,joe biever,0,0,0,0,0,0,0,0,0,0,0,0,0,0,0,0,0,0,0,0,0,0
439587,498_13_12,LUXEMBOURG,8340,30,jean nicolas c. kox,11,1,4,25,1,3,33.3,0,1,0,1,2,50,0,0,0,0,4,1,0,0,3
439588,498_13_12,LUXEMBOURG,29517,33,dominique benseghir,0,0,0,0,0,0,0,0,0,0,0,0,0,0,0,0,0,0,0,0,0,0
439589,498_13_12,LUXEMBOURG,0,TOTALS,LUXEMBOURG,200,26,66,39.4,22,43,51.2,4,23,17.4,6,9,66.7,8,23,31,13,20,11,5,2,62
439590,498_13_12,DENMARK,5021,4,adama kasper darbo,31,3,12,25,1,6,16.7,2,6,33.3,1,2,50,1,8,9,2,4,4,2,0,9
439591,498_13_12,DENMARK,10160,5,frederik nielsen,10,0,1,0,0,0,0,0,1,0,0,0,0,1,0,1,0,0,0,0,0,0
439592,498_13_12,DENMARK,15325,6,mikkel venneberg plannthin,25,3,5,60,2,2,100,1,3,33.3,4,6,66.7,1,4,5,4,1,1,1,0,11
439593,498_13_12,DENMARK,16162,7,esben reinholt,27,10,16,62.5,8,10,80,2,6,33.3,2,4,50,3,2,5,0,0,3,0,0,24
439594,498_13_12,DENMARK,29515,8,david erle harder,20,3,7,42.9,1,2,50,2,5,40,0,0,0,0,2,2,2,3,1,1,0,8
439595,498_13_12,DENMARK,13182,9,christian benzon,0,0,0,0,0,0,0,0,0,0,0,0,0,0,0,0,0,0,0,0,0,0
439596,498_13_12,DENMARK,17663,10,jacob enevold jensen,7,0,1,0,0,1,0,0,0,0,0,0,0,0,0,0,0,1,1,0,0,0
439597,498_13_12,DENMARK,12662,12,alexander heidenheim bak,27,3,6,50,3,4,75,0,2,0,0,0,0,3,3,6,1,4,2,0,0,6
439598,498_13_12,DENMARK,4984,13,nicolai iversen,31,6,9,66.7,5,8,62.5,1,1,100,2,3,66.7,1,4,5,0,1,2,0,0,15
439599,498_13_12,DENMARK,20091,15,alexander birketoft,6,0,3,0,0,3,0,0,0,0,0,0,0,2,1,3,0,0,1,0,0,0
439600,498_13_12,DENMARK,12663,22,jonas zohore bergstedt,16,0,5,0,0,5,0,0,0,0,0,0,0,3,3,6,2,3,3,0,0,0
439601,498_13_12,DENMARK,0,TOTALS,DENMARK,200,28,65,43.1,20,41,48.8,8,24,33.3,9,15,60,16,34,50,11,17,19,4,0,73
439602,498_13_13,SWITZERLAND,12691,4,jonathan malu kazadi-muyombu,34,8,14,57.1,6,11,54.5,2,3,66.7,1,1,100,1,2,3,2,2,2,2,0,19
439603,498_13_13,SWITZERLAND,7804,6,dusan mladjan,28,3,10,30,1,4,25,2,6,33.3,1,3,33.3,0,4,4,3,3,0,1,0,9
439604,498_13_13,SWITZERLAND,12693,7,stefan petkovic,21,1,5,20,0,2,0,1,3,33.3,3,4,75,0,1,1,3,2,0,0,0,6
439605,498_13_13,SWITZERLAND,1260,8,cedric lionel mafuta,15,1,2,50,1,2,50,0,0,0,0,0,0,0,1,1,1,3,1,0,0,2
439606,498_13_13,SWITZERLAND,15690,9,jeremy jaunin,0,0,0,0,0,0,0,0,0,0,0,0,0,0,0,0,0,0,0,0,0,0
439607,498_13_13,SWITZERLAND,19748,10,roberto kovac,23,3,5,60,2,2,100,1,3,33.3,1,2,50,0,1,1,1,0,1,2,0,8
439608,498_13_13,SWITZERLAND,15691,11,jonathan eric dubas,23,2,7,28.6,2,6,33.3,0,1,0,2,2,100,2,3,5,2,3,1,0,0,6
439609,498_13_13,SWITZERLAND,16102,13,clint capela,27,6,9,66.7,6,9,66.7,0,0,0,1,2,50,3,6,9,1,4,4,1,1,13
439610,498_13_13,SWITZERLAND,4860,15,oliver matthias vogt,15,1,9,11.1,1,7,14.3,0,2,0,0,2,0,2,1,3,0,3,1,0,1,2
439611,498_13_13,SWITZERLAND,17392,21,evrard adam atcho,0,0,0,0,0,0,0,0,0,0,0,0,0,0,0,0,0,0,0,0,0,0
439612,498_13_13,SWITZERLAND,16096,25,marko mladjan,15,2,3,66.7,2,2,100,0,1,0,0,0,0,1,4,5,0,2,0,0,0,4
439613,498_13_13,SWITZERLAND,0,TOTALS,SWITZERLAND,200,27,64,42.2,21,45,46.7,6,19,31.6,9,16,56.2,9,23,32,13,22,11,6,2,69
439614,498_13_13,AUSTRIA,2103,5,thomas schreiner,30,2,5,40,1,2,50,1,3,33.3,2,2,100,0,2,2,2,1,3,0,0,7
439615,498_13_13,AUSTRIA,16191,6,jozo rados,0,0,0,0,0,0,0,0,0,0,0,0,0,0,0,0,0,0,0,0,0,0
439616,498_13_13,AUSTRIA,10194,7,davor lamesic,30,6,13,46.2,6,11,54.5,0,2,0,2,3,66.7,2,4,6,1,4,3,1,0,14
439617,498_13_13,AUSTRIA,15362,13,jason david detrick,24,3,7,42.9,2,4,50,1,3,33.3,1,2,50,2,2,4,1,1,1,0,0,8
439618,498_13_13,AUSTRIA,8392,20,romed vieider,0,0,0,0,0,0,0,0,0,0,0,0,0,0,0,0,0,0,0,0,0,0
439619,498_13_13,AUSTRIA,19730,23,kevin francis payton,6,0,0,0,0,0,0,0,0,0,0,0,0,0,0,0,1,0,2,0,0,0
439620,498_13_13,AUSTRIA,8396,24,rasid mahalbasic,34,7,9,77.8,7,7,100,0,2,0,1,1,100,1,6,7,2,3,4,1,0,15
439621,498_13_13,AUSTRIA,7853,31,benedikt danek,3,0,0,0,0,0,0,0,0,0,0,0,0,0,1,1,0,0,0,0,0,0
439622,498_13_13,AUSTRIA,2106,32,richard poiger,13,2,4,50,2,3,66.7,0,1,0,3,5,60,0,1,1,1,3,2,0,0,7
439623,498_13_13,AUSTRIA,6415,34,moritz lanegger,20,1,7,14.3,1,5,20,0,2,0,0,0,0,1,1,2,1,3,1,0,0,2
439624,498_13_13,AUSTRIA,11250,42,thomas klepeisz,19,1,2,50,0,1,0,1,1,100,0,0,0,0,2,2,1,3,1,1,0,3
439625,498_13_13,AUSTRIA,15717,43,anton maresch,20,2,5,40,1,2,50,1,3,33.3,2,2,100,0,1,1,0,2,1,1,0,7
439626,498_13_13,AUSTRIA,0,TOTALS,AUSTRIA,200,24,52,46.2,20,35,57.1,4,17,23.5,11,15,73.3,6,20,26,10,20,18,4,0,63
439627,498_13_14,HUNGARY,4535,4,balazs simon,36,3,12,25,2,9,22.2,1,3,33.3,2,3,66.7,2,3,5,2,3,0,1,0,9
439628,498_13_14,HUNGARY,6487,5,gergely toth,9,0,1,0,0,0,0,0,1,0,0,0,0,0,0,0,0,0,0,0,0,0
439629,498_13_14,HUNGARY,12503,6,akos keller,7,1,1,100,1,1,100,0,0,0,0,2,0,3,4,7,0,1,1,0,0,2
439630,498_13_14,HUNGARY,1125,7,krisztian wittmann,15,7,15,46.7,4,6,66.7,3,9,33.3,0,1,0,0,2,2,2,3,1,0,0,17
439631,498_13_14,HUNGARY,8415,9,david vojvoda,35,8,16,50,5,8,62.5,3,8,37.5,0,1,0,0,3,3,1,3,2,0,0,19
439632,498_13_14,HUNGARY,29518,10,peter kovacs,28,0,0,0,0,0,0,0,0,0,0,0,0,0,0,0,0,0,0,0,0,0
439633,498_13_14,HUNGARY,2751,13,adam toth,4,4,5,80,4,5,80,0,0,0,1,3,33.3,3,1,4,0,4,1,0,0,9
439634,498_13_14,HUNGARY,1941,14,zsolt andras szabo,5,0,2,0,0,0,0,0,2,0,0,0,0,3,2,5,3,1,1,1,0,0
439635,498_13_14,HUNGARY,1123,15,csaba ferencz,30,0,2,0,0,0,0,0,2,0,0,0,0,0,2,2,0,1,1,1,0,0
439636,498_13_14,HUNGARY,1942,21,norbert toth,32,1,5,20,0,2,0,1,3,33.3,2,2,100,6,1,7,0,1,0,0,0,5
439637,498_13_14,HUNGARY,12937,24,martin pongo,0,0,0,0,0,0,0,0,0,0,0,0,0,0,0,0,0,0,0,0,0,0
439638,498_13_14,HUNGARY,24341,32,rosco allen,0,0,0,0,0,0,0,0,0,0,0,0,0,0,0,0,0,0,0,0,0,0
439639,498_13_14,HUNGARY,0,TOTALS,HUNGARY,200,24,59,40.7,16,31,51.6,8,28,28.6,5,12,41.7,17,18,35,8,17,7,3,0,61
439640,498_13_14,BELARUS,4907,4,pavel ulyanko,29,3,6,50,2,3,66.7,1,3,33.3,2,2,100,2,0,2,2,0,1,0,0,9
439641,498_13_14,BELARUS,15346,5,siarhei charykau,13,0,3,0,0,1,0,0,2,0,0,0,0,2,1,3,3,2,2,1,0,0
439642,498_13_14,BELARUS,1653,6,maksim shustau,8,0,1,0,0,0,0,0,1,0,0,0,0,1,2,3,2,2,0,0,0,0
439643,498_13_14,BELARUS,5477,7,artsiom parakhouski,21,5,9,55.6,5,9,55.6,0,0,0,2,4,50,3,4,7,0,5,0,1,3,12
439644,498_13_14,BELARUS,2847,8,mikita meshcharakou,11,1,3,33.3,1,3,33.3,0,0,0,2,2,100,1,1,2,0,3,0,1,0,4
439645,498_13_14,BELARUS,991,9,dzmitry akulich,0,0,0,0,0,0,0,0,0,0,0,0,0,0,0,0,0,0,0,0,0,0
439646,498_13_14,BELARUS,13157,10,vitali liutych,29,7,11,63.6,5,8,62.5,2,3,66.7,5,5,100,0,4,4,0,0,1,0,0,21
439647,498_13_14,BELARUS,999,11,yury mishukou,21,2,4,50,2,3,66.7,0,1,0,0,1,0,0,1,1,0,0,0,0,0,4
439648,498_13_14,BELARUS,998,12,aliaksandr pustahvar,29,1,6,16.7,1,3,33.3,0,3,0,0,0,0,0,1,1,0,3,0,2,0,2
439649,498_13_14,BELARUS,11187,13,uladzimir krysevich,0,0,0,0,0,0,0,0,0,0,0,0,0,0,0,0,0,0,0,0,0,0
439650,498_13_14,BELARUS,4915,14,aliaksandr kudrautsau,36,4,11,36.4,3,7,42.9,1,4,25,2,2,100,0,2,2,1,4,5,2,0,11
439651,498_13_14,BELARUS,1645,15,aliaksei trastsinetski,4,0,2,0,0,1,0,0,1,0,0,0,0,1,1,2,0,1,1,0,0,0
439652,498_13_14,BELARUS,0,TOTALS,BELARUS,200,23,56,41.1,19,38,50,4,18,22.2,13,16,81.2,10,17,27,8,20,10,7,3,63
439653,498_13_15,LUXEMBOURG,5918,5,pitt koster,19,1,4,25,0,3,0,1,1,100,0,0,0,1,2,3,7,2,4,1,0,3
439654,498_13_15,LUXEMBOURG,2966,6,raul leandro birenbaum,21,2,6,33.3,0,1,0,2,5,40,0,0,0,1,1,2,2,3,2,0,0,6
439655,498_13_15,LUXEMBOURG,8344,8,christopher c. g. jones,26,2,9,22.2,2,6,33.3,0,3,0,6,8,75,0,3,3,5,4,3,0,1,10
439656,498_13_15,LUXEMBOURG,1283,9,jairo emanuel delgado ferreira,15,3,4,75,2,3,66.7,1,1,100,3,3,100,0,1,1,2,5,1,0,0,10
439657,498_13_15,LUXEMBOURG,1993,13,samy picard,31,8,15,53.3,8,12,66.7,0,3,0,6,6,100,1,6,7,0,3,2,1,1,22
439658,498_13_15,LUXEMBOURG,24209,15,pablo genevo,20,1,4,25,1,4,25,0,0,0,1,2,50,1,2,3,0,4,1,0,0,3
439659,498_13_15,LUXEMBOURG,19728,20,alexandre rodenbourg,23,2,5,40,2,3,66.7,0,2,0,0,0,0,3,3,6,1,2,2,3,0,4
439660,498_13_15,LUXEMBOURG,19729,22,laurent majerus,16,1,4,25,1,4,25,0,0,0,0,0,0,3,2,5,1,1,1,1,2,2
439661,498_13_15,LUXEMBOURG,19747,24,joe biever,12,1,5,20,1,3,33.3,0,2,0,0,0,0,1,1,2,0,4,1,0,0,2
439662,498_13_15,LUXEMBOURG,8340,30,jean nicolas c. kox,13,1,3,33.3,1,1,100,0,2,0,1,2,50,0,0,0,0,4,3,0,0,3
439663,498_13_15,LUXEMBOURG,29517,33,dominique benseghir,5,0,1,0,0,0,0,0,1,0,0,0,0,0,0,0,0,0,2,0,0,0
439664,498_13_15,LUXEMBOURG,0,TOTALS,LUXEMBOURG,200,22,60,36.7,18,40,45,4,20,20,17,21,81,11,24,35,18,32,23,6,4,65
439665,498_13_15,AUSTRIA,2103,5,thomas schreiner,25,5,8,62.5,1,1,100,4,7,57.1,6,6,100,0,5,5,4,0,4,4,0,20
439666,498_13_15,AUSTRIA,16191,6,jozo rados,3,0,0,0,0,0,0,0,0,0,2,2,100,0,1,1,0,0,1,0,0,2
439667,498_13_15,AUSTRIA,10194,7,davor lamesic,22,3,6,50,3,6,50,0,0,0,3,6,50,0,0,0,3,2,2,3,1,9
439668,498_13_15,AUSTRIA,15362,13,jason david detrick,25,5,9,55.6,4,6,66.7,1,3,33.3,0,0,0,0,3,3,2,2,1,0,0,11
439669,498_13_15,AUSTRIA,8392,20,romed vieider,9,1,3,33.3,1,2,50,0,1,0,0,0,0,0,1,1,0,0,1,0,0,2
439670,498_13_15,AUSTRIA,19730,23,kevin francis payton,0,0,0,0,0,0,0,0,0,0,0,0,0,0,0,0,0,0,0,0,0,0
439671,498_13_15,AUSTRIA,8396,24,rasid mahalbasic,25,5,7,71.4,5,7,71.4,0,0,0,6,6,100,1,6,7,4,3,2,1,0,16
439672,498_13_15,AUSTRIA,7853,31,benedikt danek,22,2,4,50,0,1,0,2,3,66.7,3,4,75,0,0,0,1,4,0,1,0,9
439673,498_13_15,AUSTRIA,2106,32,richard poiger,20,2,4,50,2,3,66.7,0,1,0,2,5,40,1,1,2,3,4,0,0,0,6
439674,498_13_15,AUSTRIA,13271,41,maximilian hopfgartner,10,0,1,0,0,1,0,0,0,0,3,4,75,0,2,2,0,0,1,0,0,3
439675,498_13_15,AUSTRIA,11250,42,thomas klepeisz,18,2,6,33.3,1,4,25,1,2,50,3,4,75,1,2,3,3,1,2,4,0,8
439676,498_13_15,AUSTRIA,15717,43,anton maresch,22,4,7,57.1,2,4,50,2,3,66.7,2,2,100,0,1,1,1,3,1,0,0,12
439677,498_13_15,AUSTRIA,0,TOTALS,AUSTRIA,200,29,55,52.7,19,35,54.3,10,20,50,30,39,76.9,5,24,29,21,19,15,13,1,98
439678,498_13_16,BULGARIA,1667,4,deyan ivanov,30,3,10,30,3,7,42.9,0,3,0,1,2,50,1,2,3,0,1,1,1,0,7
439679,498_13_16,BULGARIA,1667,5,kaloyan ivanov,27,4,14,28.6,4,10,40,0,4,0,2,4,50,5,5,10,1,3,1,1,1,10
439680,498_13_16,BULGARIA,2852,8,chavdar kostov,30,2,7,28.6,2,4,50,0,3,0,0,2,0,1,3,4,1,1,1,0,0,4
439681,498_13_16,BULGARIA,29516,9,branko mirkovic,38,8,13,61.5,4,5,80,4,8,50,6,8,75,2,2,4,5,2,3,0,0,26
439682,498_13_16,BULGARIA,8347,10,bozhidar avramov,12,1,2,50,1,1,100,0,1,0,0,0,0,0,0,0,0,2,0,0,0,2
439683,498_13_16,BULGARIA,2855,11,ivan lilov,30,6,12,50,4,7,57.1,2,5,40,4,5,80,2,2,4,1,4,2,3,1,18
439684,498_13_16,BULGARIA,8346,12,aleksandar georgiev,7,1,1,100,1,1,100,0,0,0,0,0,0,0,0,0,0,0,0,0,0,2
439685,498_13_16,BULGARIA,1675,13,asen velikov,0,0,0,0,0,0,0,0,0,0,0,0,0,0,0,0,0,0,0,0,0,0
439686,498_13_16,BULGARIA,2851,14,pavel ivanov,0,0,0,0,0,0,0,0,0,0,0,0,0,0,0,0,0,0,0,0,0,0
439687,498_13_16,BULGARIA,5588,21,nikolay varbanov,8,1,1,100,1,1,100,0,0,0,0,0,0,1,1,2,0,1,1,0,1,2
439688,498_13_16,BULGARIA,10177,24,veselin veselinov,15,1,5,20,1,2,50,0,3,0,1,2,50,3,4,7,0,3,0,1,0,3
439689,498_13_16,BULGARIA,8350,32,hristo zahariev,3,0,0,0,0,0,0,0,0,0,0,0,0,0,0,0,0,1,0,0,0,0
439690,498_13_16,BULGARIA,0,TOTALS,BULGARIA,200,27,65,41.5,21,38,55.3,6,27,22.2,14,23,60.9,15,19,34,8,18,10,6,3,74
439691,498_13_16,ROMANIA,2115,4,andrei mandache,27,8,10,80,3,5,60,5,5,100,2,4,50,0,1,1,1,2,0,1,0,23
439692,498_13_16,ROMANIA,5016,5,adrian tudor,32,0,4,0,0,1,0,0,3,0,0,0,0,0,0,0,11,5,5,1,0,0
439693,498_13_16,ROMANIA,5017,6,ionut florin dragusin,0,0,0,0,0,0,0,0,0,0,0,0,0,0,0,0,0,0,0,0,0,0
439694,498_13_16,ROMANIA,12540,7,daniel ionut popescu,5,0,1,0,0,1,0,0,0,0,0,0,0,0,0,0,1,0,1,0,0,0
439695,498_13_16,ROMANIA,10208,8,brice kabengele kalala,21,2,4,50,2,3,66.7,0,1,0,1,2,50,0,5,5,1,1,1,0,0,5
439696,498_13_16,ROMANIA,19741,9,adrian vasile stefan,0,0,0,0,0,0,0,0,0,0,0,0,0,0,0,0,0,0,0,0,0,0
439697,498_13_16,ROMANIA,10212,10,andrei daniel capusan,18,2,3,66.7,2,3,66.7,0,0,0,0,0,0,1,6,7,1,5,1,0,0,4
439698,498_13_16,ROMANIA,2915,11,catalin baciu,0,0,0,0,0,0,0,0,0,0,0,0,0,0,0,0,0,0,0,0,0,0
439699,498_13_16,ROMANIA,2125,14,titus nicoara,20,5,7,71.4,5,6,83.3,0,1,0,0,0,0,2,2,4,3,4,1,0,0,10
439700,498_13_16,ROMANIA,4965,15,mihai vlad silvasan,28,9,14,64.3,6,7,85.7,3,7,42.9,0,2,0,3,5,8,4,5,3,1,0,21
439701,498_13_16,ROMANIA,11102,21,bogdan tibirna,22,3,4,75,3,4,75,0,0,0,2,6,33.3,0,2,2,0,2,1,0,0,8
439702,498_13_16,ROMANIA,12712,22,adrian gutoaia,27,2,8,25,2,6,33.3,0,2,0,2,4,50,1,5,6,0,2,0,1,0,6
439703,498_13_16,ROMANIA,0,TOTALS,ROMANIA,200,31,55,56.4,23,36,63.9,8,19,42.1,7,18,38.9,10,27,37,22,26,15,4,0,77
439704,498_13_17,DENMARK,5021,4,adama kasper darbo,29,4,8,50,1,2,50,3,6,50,0,0,0,2,3,5,0,1,0,0,0,11
439705,498_13_17,DENMARK,10160,5,frederik nielsen,5,0,1,0,0,0,0,0,1,0,0,0,0,0,0,0,0,1,0,0,0,0
439706,498_13_17,DENMARK,15325,6,mikkel venneberg plannthin,30,5,9,55.6,5,7,71.4,0,2,0,3,4,75,0,2,2,3,3,0,3,0,13
439707,498_13_17,DENMARK,16162,7,esben reinholt,30,6,17,35.3,4,10,40,2,7,28.6,2,2,100,0,5,5,2,2,1,3,0,16
439708,498_13_17,DENMARK,29515,8,david erle harder,12,0,0,0,0,0,0,0,0,0,0,0,0,0,0,0,0,3,1,0,0,0
439709,498_13_17,DENMARK,17663,10,jacob enevold jensen,12,1,1,100,1,1,100,0,0,0,0,0,0,0,2,2,0,1,0,0,0,2
439710,498_13_17,DENMARK,10649,11,mathias seilund,11,1,6,16.7,0,1,0,1,5,20,0,0,0,1,0,1,2,2,0,2,0,3
439711,498_13_17,DENMARK,12662,12,alexander heidenheim bak,15,1,6,16.7,1,3,33.3,0,3,0,0,0,0,1,2,3,4,1,1,2,0,2
439712,498_13_17,DENMARK,4984,13,nicolai iversen,28,3,8,37.5,2,6,33.3,1,2,50,4,5,80,2,3,5,1,3,3,0,0,11
439713,498_13_17,DENMARK,10652,14,morten sahlertz,0,0,0,0,0,0,0,0,0,0,0,0,0,0,0,0,0,0,0,0,0,0
439714,498_13_17,DENMARK,20091,15,alexander birketoft,0,0,0,0,0,0,0,0,0,0,0,0,0,0,0,0,0,0,0,0,0,0
439715,498_13_17,DENMARK,12663,22,jonas zohore bergstedt,28,2,7,28.6,2,7,28.6,0,0,0,3,3,100,2,4,6,0,0,4,1,0,7
439716,498_13_17,DENMARK,0,TOTALS,DENMARK,200,23,63,36.5,16,37,43.2,7,26,26.9,12,14,85.7,9,26,35,12,17,12,11,0,65
439717,498_13_17,SWITZERLAND,12691,4,jonathan malu kazadi-muyombu,31,5,11,45.5,4,9,44.4,1,2,50,1,2,50,3,3,6,3,4,3,1,0,12
439718,498_13_17,SWITZERLAND,7804,6,dusan mladjan,35,10,17,58.8,4,8,50,6,9,66.7,0,0,0,0,9,9,0,2,1,0,0,26
439719,498_13_17,SWITZERLAND,12693,7,stefan petkovic,24,0,3,0,0,0,0,0,3,0,0,0,0,0,1,1,4,0,3,0,0,0
439720,498_13_17,SWITZERLAND,1260,8,cedric lionel mafuta,8,0,1,0,0,1,0,0,0,0,0,0,0,0,1,1,0,2,1,1,0,0
439721,498_13_17,SWITZERLAND,15690,9,jeremy jaunin,4,0,0,0,0,0,0,0,0,0,0,0,0,0,0,0,1,1,1,0,0,0
439722,498_13_17,SWITZERLAND,19748,10,roberto kovac,16,0,4,0,0,3,0,0,1,0,0,0,0,0,0,0,0,1,0,0,0,0
439723,498_13_17,SWITZERLAND,15691,11,jonathan eric dubas,23,2,5,40,2,4,50,0,1,0,3,4,75,1,5,6,3,2,2,0,0,7
439724,498_13_17,SWITZERLAND,16102,13,clint capela,25,3,10,30,3,10,30,0,0,0,0,0,0,6,5,11,0,0,3,1,3,6
439725,498_13_17,SWITZERLAND,4860,15,oliver matthias vogt,25,6,10,60,6,9,66.7,0,1,0,1,2,50,2,1,3,0,2,1,1,1,13
439726,498_13_17,SWITZERLAND,17392,21,evrard adam atcho,0,0,0,0,0,0,0,0,0,0,0,0,0,0,0,0,0,0,0,0,0,0
439727,498_13_17,SWITZERLAND,16096,25,marko mladjan,10,1,6,16.7,1,2,50,0,4,0,0,0,0,0,3,3,2,5,1,1,0,2
439728,498_13_17,SWITZERLAND,0,TOTALS,SWITZERLAND,200,27,67,40.3,20,46,43.5,7,21,33.3,5,8,62.5,13,33,46,13,19,16,5,4,66
439729,498_13_18,ESTONIA,11295,4,rain veideman,25,6,9,66.7,4,5,80,2,4,50,1,1,100,0,2,2,1,0,0,0,0,15
439730,498_13_18,ESTONIA,1218,5,tanel sokk,24,3,9,33.3,2,6,33.3,1,3,33.3,6,6,100,1,1,2,3,1,2,1,0,13
439731,498_13_18,ESTONIA,1219,6,gert dorbek,20,2,4,50,1,2,50,1,2,50,3,3,100,1,0,1,0,3,1,1,0,8
439732,498_13_18,ESTONIA,1220,7,kristo saage,0,0,0,0,0,0,0,0,0,0,0,0,0,0,0,0,0,0,0,0,0,0
439733,498_13_18,ESTONIA,4625,8,janar talts,30,4,11,36.4,4,9,44.4,0,2,0,3,4,75,3,4,7,2,4,2,0,1,11
439734,498_13_18,ESTONIA,4622,9,gregor arbet,33,3,8,37.5,2,5,40,1,3,33.3,1,1,100,0,1,1,0,4,0,1,1,8
439735,498_13_18,ESTONIA,2721,10,sten sokk,18,0,4,0,0,1,0,0,3,0,0,0,0,1,1,2,4,3,2,1,0,0
439736,498_13_18,ESTONIA,4771,14,kristjan kangur,31,1,8,12.5,0,1,0,1,7,14.3,2,2,100,2,12,14,1,4,4,2,0,5
439737,498_13_18,ESTONIA,1229,15,reinar hallik,18,1,4,25,0,1,0,1,3,33.3,1,2,50,0,1,1,0,5,0,0,1,4
439738,498_13_18,ESTONIA,11290,21,martin dorbek,0,0,0,0,0,0,0,0,0,0,0,0,0,0,0,0,0,0,0,0,0,0
439739,498_13_18,ESTONIA,8048,22,timo eichfuss,0,0,0,0,0,0,0,0,0,0,0,0,0,0,0,0,0,0,0,0,0,0
439740,498_13_18,ESTONIA,8373,24,kristjan kitsing,0,0,0,0,0,0,0,0,0,0,0,0,0,0,0,0,0,0,0,0,0,0
439741,498_13_18,ESTONIA,0,TOTALS,ESTONIA,200,20,57,35.1,13,30,43.3,7,27,25.9,17,19,89.5,9,23,32,11,24,11,6,3,64
439742,498_13_18,NETHERLANDS,15661,5,leon williams,18,3,5,60,3,4,75,0,1,0,0,0,0,0,0,0,0,3,3,3,0,6
439743,498_13_18,NETHERLANDS,24213,6,worthy de jong,38,6,15,40,5,14,35.7,1,1,100,3,4,75,3,9,12,1,2,3,3,0,16
439744,498_13_18,NETHERLANDS,24214,7,sean cunningham,28,2,3,66.7,1,2,50,1,1,100,1,2,50,1,2,3,2,3,2,2,0,6
439745,498_13_18,NETHERLANDS,12657,10,stefan mladenovic,6,0,0,0,0,0,0,0,0,0,0,0,0,0,0,0,0,1,0,0,0,0
439746,498_13_18,NETHERLANDS,5809,11,robin johannes smeulders,30,4,8,50,4,8,50,0,0,0,2,6,33.3,3,4,7,0,4,2,0,0,10
439747,498_13_18,NETHERLANDS,4636,12,johannes martinus m. akerboom,30,2,10,20,1,3,33.3,1,7,14.3,5,5,100,1,3,4,0,1,2,0,0,10
439748,498_13_18,NETHERLANDS,10672,15,hieronymus b. van der list,14,1,3,33.3,1,3,33.3,0,0,0,0,0,0,1,3,4,1,1,1,0,1,2
439749,498_13_18,NETHERLANDS,12501,20,ralf de pagter,3,0,0,0,0,0,0,0,0,0,0,0,0,0,0,0,0,0,0,0,0,0
439750,498_13_18,NETHERLANDS,29519,21,joshua frederick duinker,27,4,6,66.7,4,6,66.7,0,0,0,4,11,36.4,1,2,3,1,4,1,0,0,12
439751,498_13_18,NETHERLANDS,15524,22,craig osaikhwuwuomwan,6,0,0,0,0,0,0,0,0,0,1,2,50,1,0,1,0,0,0,0,0,1
439752,498_13_18,NETHERLANDS,0,TOTALS,NETHERLANDS,200,22,50,44,19,40,47.5,3,10,30,16,30,53.3,12,28,40,5,19,14,8,1,63
439753,498_13_19,SLOVAK REPUBLIC,8446,4,richard korner,16,1,2,50,0,1,0,1,1,100,2,2,100,3,0,3,0,4,2,0,0,5
439754,498_13_19,SLOVAK REPUBLIC,8022,5,maros rendla,5,0,2,0,0,1,0,0,1,0,0,0,0,0,0,0,0,0,0,1,0,0
439755,498_13_19,SLOVAK REPUBLIC,8444,6,marek jass,20,3,3,100,2,2,100,1,1,100,2,2,100,1,5,6,0,5,2,1,0,9
439756,498_13_19,SLOVAK REPUBLIC,17785,7,oliver tot,2,0,0,0,0,0,0,0,0,0,0,0,0,0,0,0,0,0,0,0,0,0
439757,498_13_19,SLOVAK REPUBLIC,10469,8,milan ziak,27,5,10,50,4,7,57.1,1,3,33.3,0,1,0,1,6,7,4,1,3,0,0,11
439758,498_13_19,SLOVAK REPUBLIC,5862,9,martin bilik,18,0,4,0,0,0,0,0,4,0,2,2,100,2,3,5,0,1,1,0,0,2
439759,498_13_19,SLOVAK REPUBLIC,13095,10,maurizio galata,0,0,0,0,0,0,0,0,0,0,0,0,0,0,0,0,0,0,0,0,0,0
439760,498_13_19,SLOVAK REPUBLIC,6339,11,peter dorazil,34,7,7,100,7,7,100,0,0,0,1,4,25,3,5,8,0,3,1,2,1,15
439761,498_13_19,SLOVAK REPUBLIC,5861,12,michal batka,34,6,13,46.2,2,6,33.3,4,7,57.1,3,4,75,1,4,5,0,3,2,0,0,19
439762,498_13_19,SLOVAK REPUBLIC,15367,13,marek kozlik,24,3,7,42.9,2,4,50,1,3,33.3,0,0,0,1,0,1,5,2,2,3,0,7
439763,498_13_19,SLOVAK REPUBLIC,17784,14,jakub petras,3,0,0,0,0,0,0,0,0,0,0,0,0,0,0,0,0,1,0,0,0,0
439764,498_13_19,SLOVAK REPUBLIC,8441,15,richard grznar,18,4,10,40,2,7,28.6,2,3,66.7,1,2,50,0,2,2,5,5,1,1,0,11
439765,498_13_19,SLOVAK REPUBLIC,0,TOTALS,SLOVAK REPUBLIC,200,29,58,50,19,35,54.3,10,23,43.5,11,17,64.7,13,26,39,14,25,14,8,1,79
439766,498_13_19,HUNGARY,4535,4,balazs simon,29,3,9,33.3,1,4,25,2,5,40,3,3,100,1,3,4,2,3,4,0,0,11
439767,498_13_19,HUNGARY,6487,5,gergely toth,10,0,0,0,0,0,0,0,0,0,0,0,0,0,2,2,0,3,0,0,1,0
439768,498_13_19,HUNGARY,12503,6,akos keller,21,3,6,50,3,6,50,0,0,0,4,7,57.1,2,1,3,0,2,0,0,1,10
439769,498_13_19,HUNGARY,1125,7,krisztian wittmann,31,4,10,40,2,5,40,2,5,40,1,2,50,2,0,2,3,2,1,3,0,11
439770,498_13_19,HUNGARY,8415,9,david vojvoda,30,3,10,30,2,5,40,1,5,20,1,4,25,0,2,2,2,2,3,0,0,8
439771,498_13_19,HUNGARY,29518,10,peter kovacs,3,1,1,100,0,0,0,1,1,100,0,0,0,0,0,0,0,2,0,0,0,3
439772,498_13_19,HUNGARY,2751,13,adam toth,19,5,6,83.3,5,6,83.3,0,0,0,2,3,66.7,2,2,4,0,1,1,0,0,12
439773,498_13_19,HUNGARY,1941,14,zsolt andras szabo,27,0,4,0,0,4,0,0,0,0,1,2,50,0,5,5,3,2,0,2,1,1
439774,498_13_19,HUNGARY,1123,15,csaba ferencz,30,4,9,44.4,2,2,100,2,7,28.6,1,2,50,0,0,0,2,3,2,1,0,11
439775,498_13_19,HUNGARY,1942,21,norbert toth,2,0,0,0,0,0,0,0,0,0,0,0,0,0,0,0,0,1,1,0,0,0
439776,498_13_19,HUNGARY,17412,22,mate meszaros,0,0,0,0,0,0,0,0,0,0,0,0,0,0,0,0,0,0,0,0,0,0
439777,498_13_19,HUNGARY,12937,24,martin pongo,0,0,0,0,0,0,0,0,0,0,0,0,0,0,0,0,0,0,0,0,0,0
439778,498_13_19,HUNGARY,0,TOTALS,HUNGARY,200,23,55,41.8,15,32,46.9,8,23,34.8,13,23,56.5,8,17,25,12,21,12,6,3,67
439779,498_13_20,ICELAND,2061,4,brynjar bjornsson,1,0,0,0,0,0,0,0,0,0,0,0,0,0,0,0,0,0,0,0,0,0
439780,498_13_20,ICELAND,13211,5,haukur palsson,28,2,6,33.3,2,3,66.7,0,3,0,0,0,0,0,1,1,1,5,0,2,2,4
439781,498_13_20,ICELAND,4834,6,jakob sigurdarson,34,4,13,30.8,2,6,33.3,2,7,28.6,2,2,100,0,3,3,5,0,1,2,0,12
439782,498_13_20,ICELAND,22003,7,stefan karel torfason,0,0,0,0,0,0,0,0,0,0,0,0,0,0,0,0,0,0,0,0,0,0
439783,498_13_20,ICELAND,4841,8,hlynur baeringsson,26,1,3,33.3,1,1,100,0,2,0,0,0,0,2,5,7,2,5,5,3,1,2
439784,498_13_20,ICELAND,4837,9,jon arnor stefansson,35,13,21,61.9,8,15,53.3,5,6,83.3,1,2,50,3,4,7,1,2,3,4,1,32
439785,498_13_20,ICELAND,19926,10,martin hermannsson,1,0,0,0,0,0,0,0,0,0,0,0,0,0,0,0,0,0,0,0,0,0
439786,498_13_20,ICELAND,24208,11,axel karason,0,0,0,0,0,0,0,0,0,0,0,0,0,0,0,0,0,0,0,0,0,0
439787,498_13_20,ICELAND,15700,12,ragnar agust nathanaelsson,5,0,0,0,0,0,0,0,0,0,0,0,0,1,0,1,0,1,1,0,0,0
439788,498_13_20,ICELAND,2764,13,hordur vilhjalmsson,21,3,8,37.5,1,2,50,2,6,33.3,0,0,0,1,1,2,3,5,3,2,0,8
439789,498_13_20,ICELAND,4980,14,logi gunnarsson,17,2,7,28.6,0,4,0,2,3,66.7,0,0,0,2,1,3,2,1,3,0,0,6
439790,498_13_20,ICELAND,2071,15,pavel ermolinskij,32,6,12,50,5,7,71.4,1,5,20,2,4,50,0,4,4,5,4,0,2,0,15
439791,498_13_20,ICELAND,0,TOTALS,ICELAND,200,31,70,44.3,19,38,50,12,32,37.5,5,8,62.5,9,20,29,19,23,16,15,4,79
439792,498_13_20,BULGARIA,1667,4,deyan ivanov,34,8,15,53.3,7,12,58.3,1,3,33.3,2,4,50,4,4,8,3,4,3,1,1,19
439793,498_13_20,BULGARIA,1667,5,kaloyan ivanov,31,4,12,33.3,3,8,37.5,1,4,25,5,5,100,2,12,14,1,3,5,0,0,14
439794,498_13_20,BULGARIA,29516,9,branko mirkovic,37,6,11,54.5,5,8,62.5,1,3,33.3,2,4,50,3,4,7,6,2,4,3,0,15
439795,498_13_20,BULGARIA,8347,10,bozhidar avramov,26,3,6,50,1,1,100,2,5,40,1,2,50,0,3,3,1,3,3,1,0,9
439796,498_13_20,BULGARIA,2855,11,ivan lilov,37,1,5,20,1,1,100,0,4,0,4,6,66.7,2,5,7,5,1,2,4,0,6
439797,498_13_20,BULGARIA,8346,12,aleksandar georgiev,3,0,1,0,0,1,0,0,0,0,3,4,75,1,0,1,0,0,1,2,0,3
439798,498_13_20,BULGARIA,1675,13,asen velikov,3,0,0,0,0,0,0,0,0,0,0,0,0,1,1,2,0,0,1,0,0,0
439799,498_13_20,BULGARIA,2851,14,pavel ivanov,17,4,7,57.1,3,5,60,1,2,50,0,0,0,1,0,1,0,3,1,1,0,9
439800,498_13_20,BULGARIA,5588,21,nikolay varbanov,5,1,2,50,1,2,50,0,0,0,0,0,0,1,0,1,0,1,1,0,0,2
439801,498_13_20,BULGARIA,10177,24,veselin veselinov,6,2,4,50,2,3,66.7,0,1,0,0,0,0,2,0,2,0,2,0,0,0,4
439802,498_13_20,BULGARIA,8350,32,hristo zahariev,0,0,0,0,0,0,0,0,0,0,0,0,0,0,0,0,0,0,0,0,0,0
439803,498_13_20,BULGARIA,10445,34,martin durchev,0,0,0,0,0,0,0,0,0,0,0,0,0,0,0,0,0,0,0,0,0,0
439804,498_13_20,BULGARIA,0,TOTALS,BULGARIA,200,29,63,46,23,41,56.1,6,22,27.3,17,25,68,18,31,49,16,19,23,12,1,81
439805,498_13_21,PORTUGAL,2730,4,jose silva,16,2,10,20,2,9,22.2,0,1,0,0,0,0,0,2,2,1,1,0,5,0,4
439806,498_13_21,PORTUGAL,2918,5,claudio fonseca,29,8,10,80,8,10,80,0,0,0,1,5,20,1,1,2,1,0,2,0,1,17
439807,498_13_21,PORTUGAL,8195,6,jose barbosa,4,0,1,0,0,0,0,0,1,0,0,0,0,0,0,0,0,0,0,1,0,0
439808,498_13_21,PORTUGAL,5596,7,joao gomes,31,3,9,33.3,2,6,33.3,1,3,33.3,4,6,66.7,2,0,2,2,2,1,0,0,11
439809,498_13_21,PORTUGAL,10266,8,mario fernandes,32,3,12,25,2,6,33.3,1,6,16.7,2,2,100,0,4,4,7,3,1,1,0,9
439810,498_13_21,PORTUGAL,4778,10,carlos andrade,30,2,7,28.6,2,4,50,0,3,0,5,6,83.3,0,3,3,5,4,1,1,0,9
439811,498_13_21,PORTUGAL,10956,11,miguel queiroz,0,0,0,0,0,0,0,0,0,0,0,0,0,0,0,0,0,0,0,0,0,0
439812,498_13_21,PORTUGAL,1168,12,marco goncalves,6,1,2,50,1,2,50,0,0,0,0,0,0,0,0,0,0,0,0,0,0,2
439813,498_13_21,PORTUGAL,7851,13,joao balseiro,3,0,0,0,0,0,0,0,0,0,0,0,0,1,0,1,0,1,1,0,0,0
439814,498_13_21,PORTUGAL,4779,14,miguel a. saraiva miranda,18,1,2,50,1,1,100,0,1,0,1,2,50,1,3,4,1,3,0,0,0,3
439815,498_13_21,PORTUGAL,4735,15,joao santos,27,3,5,60,1,3,33.3,2,2,100,1,2,50,0,3,3,0,1,0,0,0,9
439816,498_13_21,PORTUGAL,17260,21,tomas barroso,4,0,0,0,0,0,0,0,0,0,0,0,0,0,0,0,1,2,1,0,0,0
439817,498_13_21,PORTUGAL,0,TOTALS,PORTUGAL,200,23,58,39.7,19,41,46.3,4,17,23.5,14,23,60.9,5,16,21,18,17,7,8,1,64
439818,498_13_21,ESTONIA,11295,4,rain veideman,24,6,10,60,2,4,50,4,6,66.7,2,2,100,1,2,3,3,4,3,0,1,18
439819,498_13_21,ESTONIA,1218,5,tanel sokk,21,3,4,75,3,3,100,0,1,0,2,2,100,1,0,1,1,3,1,0,0,8
439820,498_13_21,ESTONIA,1219,6,gert dorbek,25,3,7,42.9,1,2,50,2,5,40,0,0,0,0,3,3,3,4,0,0,0,8
439821,498_13_21,ESTONIA,1220,7,kristo saage,0,0,0,0,0,0,0,0,0,0,0,0,0,0,0,0,0,0,0,0,0,0
439822,498_13_21,ESTONIA,4625,8,janar talts,34,8,13,61.5,8,12,66.7,0,1,0,0,0,0,0,11,11,4,2,6,1,1,16
439823,498_13_21,ESTONIA,4622,9,gregor arbet,32,5,7,71.4,2,3,66.7,3,4,75,2,2,100,2,3,5,3,2,1,0,0,15
439824,498_13_21,ESTONIA,2721,10,sten sokk,20,1,3,33.3,0,1,0,1,2,50,7,8,87.5,0,0,0,5,5,2,1,0,10
439825,498_13_21,ESTONIA,4771,14,kristjan kangur,18,1,2,50,0,0,0,1,2,50,0,0,0,0,2,2,0,4,1,0,0,3
439826,498_13_21,ESTONIA,1229,15,reinar hallik,25,3,7,42.9,2,3,66.7,1,4,25,0,0,0,0,3,3,2,4,1,1,0,7
439827,498_13_21,ESTONIA,11290,21,martin dorbek,0,0,0,0,0,0,0,0,0,0,0,0,0,0,0,0,0,0,0,0,0,0
439828,498_13_21,ESTONIA,8048,22,timo eichfuss,1,0,0,0,0,0,0,0,0,0,0,0,0,0,0,0,0,0,0,0,0,0
439829,498_13_21,ESTONIA,8373,24,kristjan kitsing,0,0,0,0,0,0,0,0,0,0,0,0,0,0,0,0,0,0,0,0,0,0
439830,498_13_21,ESTONIA,0,TOTALS,ESTONIA,200,30,53,56.6,18,28,64.3,12,25,48,13,14,92.9,4,24,28,21,28,15,3,2,85
439831,498_13_22,SWITZERLAND,12691,4,jonathan malu kazadi-muyombu,33,6,12,50,3,5,60,3,7,42.9,2,2,100,1,4,5,3,3,4,0,0,17
439832,498_13_22,SWITZERLAND,7804,6,dusan mladjan,0,0,0,0,0,0,0,0,0,0,0,0,0,0,0,0,0,0,0,0,0,0
439833,498_13_22,SWITZERLAND,12693,7,stefan petkovic,24,1,2,50,0,0,0,1,2,50,0,2,0,0,2,2,1,1,1,0,0,3
439834,498_13_22,SWITZERLAND,1260,8,cedric lionel mafuta,22,1,3,33.3,1,1,100,0,2,0,4,8,50,1,3,4,3,0,3,1,0,6
439835,498_13_22,SWITZERLAND,15690,9,jeremy jaunin,19,2,3,66.7,1,1,100,1,2,50,4,4,100,0,2,2,2,1,3,1,0,9
439836,498_13_22,SWITZERLAND,19748,10,roberto kovac,21,3,5,60,1,1,100,2,4,50,3,3,100,2,3,5,1,4,1,0,0,11
439837,498_13_22,SWITZERLAND,15691,11,jonathan eric dubas,26,1,7,14.3,1,6,16.7,0,1,0,3,6,50,2,7,9,2,3,2,0,1,5
439838,498_13_22,SWITZERLAND,16102,13,clint capela,27,6,8,75,6,8,75,0,0,0,2,9,22.2,2,6,8,0,0,2,0,1,14
439839,498_13_22,SWITZERLAND,4860,15,oliver matthias vogt,10,1,1,100,1,1,100,0,0,0,2,2,100,0,0,0,1,1,1,0,0,4
439840,498_13_22,SWITZERLAND,17392,21,evrard adam atcho,6,0,0,0,0,0,0,0,0,0,2,2,100,2,1,3,0,1,0,0,0,2
439841,498_13_22,SWITZERLAND,16096,25,marko mladjan,12,2,5,40,0,2,0,2,3,66.7,0,0,0,1,2,3,1,5,2,1,1,6
439842,498_13_22,SWITZERLAND,0,TOTALS,SWITZERLAND,200,23,46,50,14,25,56,9,21,42.9,22,38,57.9,11,30,41,14,20,19,3,3,77
439843,498_13_22,LUXEMBOURG,5918,5,pitt koster,24,3,5,60,3,4,75,0,1,0,0,0,0,0,2,2,3,2,1,1,0,6
439844,498_13_22,LUXEMBOURG,2966,6,raul leandro birenbaum,27,2,4,50,1,1,100,1,3,33.3,1,2,50,0,4,4,0,2,3,1,0,6
439845,498_13_22,LUXEMBOURG,8344,8,christopher c. g. jones,14,1,4,25,1,2,50,0,2,0,5,8,62.5,1,0,1,2,3,0,2,0,7
439846,498_13_22,LUXEMBOURG,1283,9,jairo emanuel delgado ferreira,35,3,12,25,1,5,20,2,7,28.6,0,0,0,1,4,5,3,4,2,1,0,8
439847,498_13_22,LUXEMBOURG,1993,13,samy picard,29,6,17,35.3,5,14,35.7,1,3,33.3,7,8,87.5,1,2,3,1,5,2,1,0,20
439848,498_13_22,LUXEMBOURG,24209,15,pablo genevo,18,1,4,25,1,4,25,0,0,0,0,0,0,1,3,4,0,4,0,0,0,2
439849,498_13_22,LUXEMBOURG,19728,20,alexandre rodenbourg,18,1,4,25,0,1,0,1,3,33.3,0,2,0,0,3,3,1,3,1,0,1,3
439850,498_13_22,LUXEMBOURG,19729,22,laurent majerus,4,1,1,100,1,1,100,0,0,0,0,2,0,0,0,0,0,2,0,0,0,2
439851,498_13_22,LUXEMBOURG,19747,24,joe biever,8,0,2,0,0,2,0,0,0,0,0,0,0,0,0,0,0,1,0,0,0,0
439852,498_13_22,LUXEMBOURG,8340,30,jean nicolas c. kox,20,1,2,50,1,1,100,0,1,0,0,0,0,0,0,0,0,5,1,0,0,2
439853,498_13_22,LUXEMBOURG,29517,33,dominique benseghir,2,1,1,100,0,0,0,1,1,100,0,0,0,0,0,0,0,1,0,0,0,3
439854,498_13_22,LUXEMBOURG,0,TOTALS,LUXEMBOURG,200,20,56,35.7,14,35,40,6,21,28.6,13,22,59.1,4,18,22,10,32,12,6,1,59
439855,498_13_23,AUSTRIA,2103,5,thomas schreiner,27,2,7,28.6,2,3,66.7,0,4,0,2,3,66.7,1,5,6,4,1,2,5,1,6
439856,498_13_23,AUSTRIA,16191,6,jozo rados,3,0,1,0,0,1,0,0,0,0,0,0,0,1,1,2,0,0,1,0,0,0
439857,498_13_23,AUSTRIA,10194,7,davor lamesic,27,5,8,62.5,5,7,71.4,0,1,0,2,2,100,1,1,2,2,1,0,1,0,12
439858,498_13_23,AUSTRIA,15362,13,jason david detrick,23,1,8,12.5,0,3,0,1,5,20,0,0,0,1,3,4,1,0,0,0,2,3
439859,498_13_23,AUSTRIA,8392,20,romed vieider,0,0,0,0,0,0,0,0,0,0,0,0,0,0,0,0,0,0,0,0,0,0
439860,498_13_23,AUSTRIA,19730,23,kevin francis payton,13,2,5,40,2,3,66.7,0,2,0,0,0,0,0,0,0,0,3,1,0,1,4
439861,498_13_23,AUSTRIA,8396,24,rasid mahalbasic,33,13,20,65,11,18,61.1,2,2,100,6,6,100,2,4,6,6,2,2,1,0,34
439862,498_13_23,AUSTRIA,7853,31,benedikt danek,15,0,3,0,0,2,0,0,1,0,0,2,0,2,0,2,0,1,1,1,0,0
439863,498_13_23,AUSTRIA,2106,32,richard poiger,13,0,1,0,0,1,0,0,0,0,3,4,75,3,4,7,0,3,1,1,0,3
439864,498_13_23,AUSTRIA,13271,41,maximilian hopfgartner,4,1,3,33.3,0,1,0,1,2,50,0,0,0,0,0,0,0,0,0,0,0,3
439865,498_13_23,AUSTRIA,11250,42,thomas klepeisz,20,1,3,33.3,1,2,50,0,1,0,2,4,50,0,0,0,3,2,2,1,1,4
439866,498_13_23,AUSTRIA,15717,43,anton maresch,21,6,9,66.7,1,2,50,5,7,71.4,0,0,0,2,2,4,3,2,2,2,0,17
439867,498_13_23,AUSTRIA,0,TOTALS,AUSTRIA,200,31,68,45.6,22,43,51.2,9,25,36,15,21,71.4,13,22,35,19,15,12,12,5,86
439868,498_13_23,DENMARK,5021,4,adama kasper darbo,33,4,11,36.4,3,6,50,1,5,20,0,0,0,0,4,4,1,2,1,0,0,9
439869,498_13_23,DENMARK,10160,5,frederik nielsen,5,0,0,0,0,0,0,0,0,0,0,0,0,0,0,0,0,1,1,0,0,0
439870,498_13_23,DENMARK,15325,6,mikkel venneberg plannthin,23,2,3,66.7,1,1,100,1,2,50,0,1,0,0,2,2,1,3,11,2,0,5
439871,498_13_23,DENMARK,16162,7,esben reinholt,30,4,11,36.4,2,6,33.3,2,5,40,3,5,60,4,5,9,1,1,3,1,0,13
439872,498_13_23,DENMARK,29515,8,david erle harder,9,0,2,0,0,1,0,0,1,0,0,0,0,0,1,1,1,1,0,0,0,0
439873,498_13_23,DENMARK,17663,10,jacob enevold jensen,12,0,1,0,0,1,0,0,0,0,0,0,0,1,2,3,1,1,1,1,0,0
439874,498_13_23,DENMARK,10649,11,mathias seilund,13,3,5,60,3,5,60,0,0,0,3,3,100,1,0,1,0,2,1,0,0,9
439875,498_13_23,DENMARK,12662,12,alexander heidenheim bak,23,7,13,53.8,6,8,75,1,5,20,0,0,0,1,2,3,0,3,3,0,0,15
439876,498_13_23,DENMARK,4984,13,nicolai iversen,25,2,5,40,1,4,25,1,1,100,0,0,0,1,5,6,1,5,0,0,1,5
439877,498_13_23,DENMARK,20091,15,alexander birketoft,2,0,0,0,0,0,0,0,0,0,0,0,0,0,0,0,0,0,0,0,0,0
439878,498_13_23,DENMARK,12663,22,jonas zohore bergstedt,25,5,9,55.6,5,9,55.6,0,0,0,0,0,0,2,5,7,1,2,1,0,0,10
439879,498_13_23,DENMARK,0,TOTALS,DENMARK,200,27,60,45,21,41,51.2,6,19,31.6,6,9,66.7,11,28,39,7,21,22,4,1,66
439880,498_13_24,AUSTRIA,2103,5,thomas schreiner,21,7,9,77.8,0,1,0,7,8,87.5,1,2,50,0,2,2,1,5,0,0,0,22
439881,498_13_24,AUSTRIA,16191,6,jozo rados,3,0,0,0,0,0,0,0,0,0,0,0,0,0,1,1,0,0,0,0,0,0
439882,498_13_24,AUSTRIA,10194,7,davor lamesic,38,7,11,63.6,7,10,70,0,1,0,1,2,50,4,5,9,2,3,2,2,0,15
439883,498_13_24,AUSTRIA,15362,13,jason david detrick,29,5,7,71.4,2,3,66.7,3,4,75,2,4,50,0,3,3,1,5,1,0,3,15
439884,498_13_24,AUSTRIA,8392,20,romed vieider,4,0,2,0,0,1,0,0,1,0,0,0,0,0,0,0,0,1,1,0,0,0
439885,498_13_24,AUSTRIA,19730,23,kevin francis payton,5,0,1,0,0,0,0,0,1,0,0,0,0,0,0,0,1,2,0,0,0,0
439886,498_13_24,AUSTRIA,8396,24,rasid mahalbasic,33,6,14,42.9,6,12,50,0,2,0,2,5,40,2,5,7,1,3,2,0,2,14
439887,498_13_24,AUSTRIA,7853,31,benedikt danek,13,1,1,100,1,1,100,0,0,0,0,2,0,1,1,2,1,3,1,0,0,2
439888,498_13_24,AUSTRIA,2106,32,richard poiger,17,1,7,14.3,1,5,20,0,2,0,1,4,25,0,3,3,1,1,0,1,0,3
439889,498_13_24,AUSTRIA,13271,41,maximilian hopfgartner,0,0,0,0,0,0,0,0,0,0,0,0,0,0,0,0,0,0,0,0,0,0
439890,498_13_24,AUSTRIA,11250,42,thomas klepeisz,34,4,10,40,0,3,0,4,7,57.1,9,11,81.8,2,2,4,4,4,1,2,0,21
439891,498_13_24,AUSTRIA,15717,43,anton maresch,29,2,7,28.6,1,4,25,1,3,33.3,0,0,0,0,2,2,3,2,2,0,0,5
439892,498_13_24,AUSTRIA,0,TOTALS,AUSTRIA,225,33,69,47.8,18,40,45,15,29,51.7,16,30,53.3,10,28,38,15,29,10,5,5,97
439893,498_13_24,SWITZERLAND,12691,4,jonathan malu kazadi-muyombu,31,5,7,71.4,3,4,75,2,3,66.7,0,0,0,3,2,5,4,5,2,1,0,12
439894,498_13_24,SWITZERLAND,7804,6,dusan mladjan,36,9,22,40.9,3,10,30,6,12,50,7,8,87.5,0,8,8,0,4,0,1,0,31
439895,498_13_24,SWITZERLAND,12693,7,stefan petkovic,18,3,6,50,2,3,66.7,1,3,33.3,2,2,100,1,2,3,1,1,2,0,0,9
439896,498_13_24,SWITZERLAND,1260,8,cedric lionel mafuta,16,1,2,50,1,2,50,0,0,0,2,2,100,1,0,1,2,0,0,0,0,4
439897,498_13_24,SWITZERLAND,15690,9,jeremy jaunin,1,0,1,0,0,1,0,0,0,0,0,0,0,0,0,0,0,0,0,0,0,0
439898,498_13_24,SWITZERLAND,19748,10,roberto kovac,25,1,5,20,0,0,0,1,5,20,6,8,75,1,1,2,0,3,1,0,0,9
439899,498_13_24,SWITZERLAND,15691,11,jonathan eric dubas,34,2,6,33.3,2,5,40,0,1,0,1,2,50,2,4,6,2,4,1,1,0,5
439900,498_13_24,SWITZERLAND,16102,13,clint capela,26,5,13,38.5,5,13,38.5,0,0,0,1,4,25,2,4,6,1,3,1,2,1,11
439901,498_13_24,SWITZERLAND,4860,15,oliver matthias vogt,17,2,3,66.7,2,3,66.7,0,0,0,2,2,100,0,2,2,0,5,3,0,0,6
439902,498_13_24,SWITZERLAND,17392,21,evrard adam atcho,0,0,0,0,0,0,0,0,0,0,0,0,0,0,0,0,0,0,0,0,0,0
439903,498_13_24,SWITZERLAND,16096,25,marko mladjan,19,3,5,60,3,3,100,0,2,0,3,4,75,0,3,3,1,2,0,1,0,9
439904,498_13_24,SWITZERLAND,0,TOTALS,SWITZERLAND,225,31,70,44.3,21,44,47.7,10,26,38.5,24,32,75,13,31,44,11,27,12,6,1,96
439905,498_13_25,BELARUS,4907,4,pavel ulyanko,12,2,3,66.7,2,3,66.7,0,0,0,5,6,83.3,1,4,5,2,2,2,2,0,9
439906,498_13_25,BELARUS,15346,5,siarhei charykau,17,3,3,100,2,2,100,1,1,100,3,6,50,0,1,1,4,0,0,1,0,10
439907,498_13_25,BELARUS,1653,6,maksim shustau,19,0,4,0,0,1,0,0,3,0,2,2,100,1,3,4,4,4,2,0,0,2
439908,498_13_25,BELARUS,5477,7,artsiom parakhouski,15,1,2,50,1,2,50,0,0,0,1,2,50,1,5,6,2,1,2,0,4,3
439909,498_13_25,BELARUS,2847,8,mikita meshcharakou,24,3,9,33.3,3,8,37.5,0,1,0,2,4,50,3,5,8,2,3,2,1,1,8
439910,498_13_25,BELARUS,991,9,dzmitry akulich,15,1,5,20,0,3,0,1,2,50,0,2,0,1,3,4,1,1,2,1,1,3
439911,498_13_25,BELARUS,13157,10,vitali liutych,15,4,9,44.4,1,5,20,3,4,75,3,4,75,3,1,4,1,2,3,1,0,14
439912,498_13_25,BELARUS,999,11,yury mishukou,13,5,9,55.6,4,7,57.1,1,2,50,0,0,0,1,3,4,1,2,0,1,0,11
439913,498_13_25,BELARUS,998,12,aliaksandr pustahvar,15,7,14,50,3,3,100,4,11,36.4,0,0,0,2,4,6,0,3,0,1,0,18
439914,498_13_25,BELARUS,11187,13,uladzimir krysevich,16,2,5,40,2,5,40,0,0,0,0,0,0,4,4,8,0,3,2,2,0,4
439915,498_13_25,BELARUS,4915,14,aliaksandr kudrautsau,17,4,5,80,3,4,75,1,1,100,2,2,100,0,2,2,5,3,1,3,0,11
439916,498_13_25,BELARUS,1645,15,aliaksei trastsinetski,24,6,13,46.2,2,7,28.6,4,6,66.7,5,6,83.3,1,5,6,6,2,1,2,0,21
439917,498_13_25,BELARUS,0,TOTALS,BELARUS,200,38,81,46.9,23,50,46,15,31,48.4,23,34,67.6,18,41,59,28,26,17,15,6,114
439918,498_13_25,SLOVAK REPUBLIC,8446,4,richard korner,25,4,10,40,4,7,57.1,0,3,0,1,3,33.3,0,4,4,1,1,3,0,1,9
439919,498_13_25,SLOVAK REPUBLIC,8022,5,maros rendla,12,1,6,16.7,1,4,25,0,2,0,2,2,100,2,1,3,1,3,0,0,0,4
439920,498_13_25,SLOVAK REPUBLIC,8444,6,marek jass,13,1,2,50,1,1,100,0,1,0,0,0,0,0,2,2,0,5,0,1,0,2
439921,498_13_25,SLOVAK REPUBLIC,17785,7,oliver tot,18,3,7,42.9,3,6,50,0,1,0,1,2,50,0,4,4,3,1,2,1,0,7
439922,498_13_25,SLOVAK REPUBLIC,10469,8,milan ziak,30,2,15,13.3,2,8,25,0,7,0,1,4,25,4,0,4,3,3,7,3,0,5
439923,498_13_25,SLOVAK REPUBLIC,5862,9,martin bilik,22,4,12,33.3,0,3,0,4,9,44.4,5,6,83.3,3,0,3,0,1,3,0,0,17
439924,498_13_25,SLOVAK REPUBLIC,13095,10,maurizio galata,11,2,3,66.7,2,2,100,0,1,0,2,4,50,1,1,2,0,0,0,2,1,6
439925,498_13_25,SLOVAK REPUBLIC,6339,11,peter dorazil,24,3,9,33.3,3,9,33.3,0,0,0,6,11,54.5,5,5,10,0,5,2,1,2,12
439926,498_13_25,SLOVAK REPUBLIC,5861,12,michal batka,27,1,5,20,0,2,0,1,3,33.3,2,2,100,2,3,5,2,4,3,1,2,5
439927,498_13_25,SLOVAK REPUBLIC,17784,14,jakub petras,11,2,4,50,2,4,50,0,0,0,0,1,0,1,2,3,0,1,0,0,2,4
439928,498_13_25,SLOVAK REPUBLIC,8441,15,richard grznar,7,1,4,25,1,3,33.3,0,1,0,0,0,0,1,0,1,0,3,2,0,0,2
439929,498_13_25,SLOVAK REPUBLIC,0,TOTALS,SLOVAK REPUBLIC,200,24,77,31.2,19,49,38.8,5,28,17.9,20,35,57.1,20,28,48,10,27,22,9,8,73
439930,498_13_26,DENMARK,5021,4,adama kasper darbo,26,3,7,42.9,3,4,75,0,3,0,5,6,83.3,1,7,8,5,1,3,1,0,11
439931,498_13_26,DENMARK,10160,5,frederik nielsen,15,1,3,33.3,0,1,0,1,2,50,0,0,0,0,1,1,2,0,0,0,0,3
439932,498_13_26,DENMARK,15325,6,mikkel venneberg plannthin,22,4,8,50,3,6,50,1,2,50,0,0,0,0,1,1,2,2,0,1,0,9
439933,498_13_26,DENMARK,16162,7,esben reinholt,8,2,3,66.7,1,1,100,1,2,50,1,2,50,0,5,5,0,0,0,0,0,6
439934,498_13_26,DENMARK,29515,8,david erle harder,13,0,2,0,0,2,0,0,0,0,1,2,50,1,1,2,1,4,2,0,0,1
439935,498_13_26,DENMARK,17663,10,jacob enevold jensen,8,2,4,50,2,4,50,0,0,0,0,1,0,3,1,4,0,5,1,0,0,4
439936,498_13_26,DENMARK,10649,11,mathias seilund,20,5,7,71.4,4,6,66.7,1,1,100,0,3,0,2,1,3,1,3,2,2,0,11
439937,498_13_26,DENMARK,12662,12,alexander heidenheim bak,26,2,10,20,0,3,0,2,7,28.6,4,4,100,0,5,5,6,1,4,1,0,10
439938,498_13_26,DENMARK,4984,13,nicolai iversen,22,6,11,54.5,5,10,50,1,1,100,4,4,100,4,3,7,2,2,0,0,0,17
439939,498_13_26,DENMARK,20091,15,alexander birketoft,11,0,2,0,0,1,0,0,1,0,0,0,0,0,2,2,0,1,1,1,0,0
439940,498_13_26,DENMARK,12663,22,jonas zohore bergstedt,23,6,8,75,6,8,75,0,0,0,1,1,100,1,3,4,1,4,5,1,0,13
439941,498_13_26,DENMARK,21908,23,gabriel lundberg,6,1,2,50,1,1,100,0,1,0,0,0,0,0,0,0,0,0,0,1,0,2
439942,498_13_26,DENMARK,0,TOTALS,DENMARK,200,32,67,47.8,25,47,53.2,7,20,35,16,23,69.6,14,31,45,20,23,18,8,0,87
439943,498_13_26,LUXEMBOURG,5918,5,pitt koster,27,4,10,40,3,7,42.9,1,3,33.3,1,2,50,1,1,2,4,4,5,0,0,10
439944,498_13_26,LUXEMBOURG,2966,6,raul leandro birenbaum,18,1,7,14.3,1,1,100,0,6,0,0,2,0,0,3,3,2,2,2,0,0,2
439945,498_13_26,LUXEMBOURG,8344,8,christopher c. g. jones,20,3,9,33.3,3,7,42.9,0,2,0,1,1,100,1,0,1,0,2,3,2,0,7
439946,498_13_26,LUXEMBOURG,1283,9,jairo emanuel delgado ferreira,17,1,3,33.3,0,1,0,1,2,50,2,2,100,1,2,3,0,3,2,0,0,5
439947,498_13_26,LUXEMBOURG,1993,13,samy picard,30,6,11,54.5,5,8,62.5,1,3,33.3,2,2,100,1,4,5,1,3,0,1,0,15
439948,498_13_26,LUXEMBOURG,24209,15,pablo genevo,16,2,8,25,2,8,25,0,0,0,2,2,100,2,2,4,0,3,0,0,0,6
439949,498_13_26,LUXEMBOURG,19728,20,alexandre rodenbourg,10,1,1,100,1,1,100,0,0,0,0,0,0,1,2,3,0,0,2,0,1,2
439950,498_13_26,LUXEMBOURG,19729,22,laurent majerus,18,3,5,60,3,5,60,0,0,0,3,4,75,2,3,5,0,2,1,1,0,9
439951,498_13_26,LUXEMBOURG,19747,24,joe biever,17,0,5,0,0,3,0,0,2,0,2,2,100,0,2,2,1,2,1,0,0,2
439952,498_13_26,LUXEMBOURG,8340,30,jean nicolas c. kox,21,0,5,0,0,3,0,0,2,0,0,0,0,0,1,1,0,4,2,1,0,0
439953,498_13_26,LUXEMBOURG,29517,33,dominique benseghir,6,0,1,0,0,0,0,0,1,0,0,1,0,0,1,1,1,1,0,0,0,0
439954,498_13_26,LUXEMBOURG,0,TOTALS,LUXEMBOURG,200,21,65,32.3,18,44,40.9,3,21,14.3,13,18,72.2,11,24,35,9,26,18,5,1,58
439955,498_13_27,ICELAND,2061,4,brynjar bjornsson,3,0,2,0,0,0,0,0,2,0,0,0,0,1,0,1,1,0,0,0,0,0
439956,498_13_27,ICELAND,13211,5,haukur palsson,33,5,8,62.5,5,6,83.3,0,2,0,4,4,100,2,3,5,5,3,6,2,0,14
439957,498_13_27,ICELAND,4834,6,jakob sigurdarson,34,5,11,45.5,4,7,57.1,1,4,25,12,13,92.3,0,2,2,2,1,1,2,0,23
439958,498_13_27,ICELAND,22003,7,stefan karel torfason,2,0,0,0,0,0,0,0,0,0,0,0,0,0,0,0,0,1,0,0,0,0
439959,498_13_27,ICELAND,4841,8,hlynur baeringsson,33,2,5,40,2,4,50,0,1,0,3,3,100,4,9,13,3,4,5,1,3,7
439960,498_13_27,ICELAND,4837,9,jon arnor stefansson,22,3,8,37.5,3,5,60,0,3,0,5,6,83.3,0,1,1,4,3,1,0,0,11
439961,498_13_27,ICELAND,19926,10,martin hermannsson,5,2,4,50,2,4,50,0,0,0,0,0,0,0,1,1,0,1,0,0,0,4
439962,498_13_27,ICELAND,24208,11,axel karason,2,0,0,0,0,0,0,0,0,0,0,0,0,0,1,1,0,0,1,0,0,0
439963,498_13_27,ICELAND,15700,12,ragnar agust nathanaelsson,5,1,1,100,1,1,100,0,0,0,0,0,0,0,1,1,0,1,0,0,0,2
439964,498_13_27,ICELAND,2764,13,hordur vilhjalmsson,19,1,6,16.7,1,2,50,0,4,0,0,0,0,0,1,1,2,4,1,1,1,2
439965,498_13_27,ICELAND,4980,14,logi gunnarsson,15,2,5,40,1,2,50,1,3,33.3,0,0,0,0,1,1,0,3,2,1,0,5
439966,498_13_27,ICELAND,2071,15,pavel ermolinskij,28,2,6,33.3,1,4,25,1,2,50,4,6,66.7,0,9,9,3,1,4,1,1,9
439967,498_13_27,ICELAND,0,TOTALS,ICELAND,200,23,56,41.1,20,35,57.1,3,21,14.3,28,32,87.5,8,32,40,20,22,21,8,5,77
439968,498_13_27,ROMANIA,2115,4,andrei mandache,28,4,11,36.4,2,7,28.6,2,4,50,0,1,0,1,2,3,1,4,3,3,1,10
439969,498_13_27,ROMANIA,5016,5,adrian tudor,36,4,8,50,3,6,50,1,2,50,4,6,66.7,1,2,3,6,4,5,1,1,13
439970,498_13_27,ROMANIA,12540,7,daniel ionut popescu,4,0,2,0,0,1,0,0,1,0,0,0,0,0,0,0,1,1,1,1,0,0
439971,498_13_27,ROMANIA,10208,8,brice kabengele kalala,15,1,6,16.7,1,5,20,0,1,0,2,2,100,1,2,3,0,3,3,1,1,4
439972,498_13_27,ROMANIA,19741,9,adrian vasile stefan,5,0,2,0,0,2,0,0,0,0,0,0,0,0,0,0,0,2,1,0,0,0
439973,498_13_27,ROMANIA,10212,10,andrei daniel capusan,13,1,3,33.3,1,3,33.3,0,0,0,1,2,50,0,0,0,2,4,2,0,0,3
439974,498_13_27,ROMANIA,2915,11,catalin baciu,0,0,0,0,0,0,0,0,0,0,0,0,0,0,0,0,0,0,0,0,0,0
439975,498_13_27,ROMANIA,5836,12,laszlo emil lazar,0,0,0,0,0,0,0,0,0,0,0,0,0,0,0,0,0,0,0,0,0,0
439976,498_13_27,ROMANIA,2125,14,titus nicoara,32,7,13,53.8,7,13,53.8,0,0,0,2,6,33.3,5,6,11,1,5,2,1,0,16
439977,498_13_27,ROMANIA,4965,15,mihai vlad silvasan,26,1,7,14.3,1,4,25,0,3,0,0,0,0,1,6,7,3,4,1,1,0,2
439978,498_13_27,ROMANIA,11102,21,bogdan tibirna,9,2,2,100,2,2,100,0,0,0,0,2,0,1,2,3,1,0,0,0,1,4
439979,498_13_27,ROMANIA,12712,22,adrian gutoaia,32,9,14,64.3,8,11,72.7,1,3,33.3,0,1,0,5,4,9,0,2,2,1,1,19
439980,498_13_27,ROMANIA,0,TOTALS,ROMANIA,200,29,68,42.6,25,54,46.3,4,14,28.6,9,20,45,15,26,41,15,29,21,9,5,71
439981,498_13_28,NETHERLANDS,15661,5,leon williams,21,2,5,40,2,4,50,0,1,0,0,0,0,2,3,5,2,2,4,1,0,4
439982,498_13_28,NETHERLANDS,24213,6,worthy de jong,35,6,14,42.9,5,10,50,1,4,25,4,5,80,1,5,6,4,2,6,6,1,17
439983,498_13_28,NETHERLANDS,24214,7,sean cunningham,25,2,5,40,2,5,40,0,0,0,1,4,25,1,4,5,4,4,0,2,0,5
439984,498_13_28,NETHERLANDS,12657,10,stefan mladenovic,6,0,0,0,0,0,0,0,0,0,0,0,0,0,1,1,0,0,1,0,0,0
439985,498_13_28,NETHERLANDS,5809,11,robin johannes smeulders,20,4,8,50,4,8,50,0,0,0,4,5,80,2,5,7,1,4,5,1,0,12
439986,498_13_28,NETHERLANDS,4636,12,johannes martinus m. akerboom,33,4,6,66.7,2,2,100,2,4,50,0,0,0,1,1,2,0,2,1,0,0,10
439987,498_13_28,NETHERLANDS,10672,15,hieronymus b. van der list,4,0,0,0,0,0,0,0,0,0,1,2,50,1,1,2,0,0,2,0,1,1
439988,498_13_28,NETHERLANDS,12501,20,ralf de pagter,2,0,1,0,0,1,0,0,0,0,0,0,0,0,0,0,1,0,0,0,0,0
439989,498_13_28,NETHERLANDS,29519,21,joshua frederick duinker,31,6,10,60,5,7,71.4,1,3,33.3,0,1,0,1,8,9,1,2,2,2,0,13
439990,498_13_28,NETHERLANDS,15524,22,craig osaikhwuwuomwan,23,4,6,66.7,4,6,66.7,0,0,0,1,1,100,4,6,10,0,1,1,0,1,9
439991,498_13_28,NETHERLANDS,0,TOTALS,NETHERLANDS,200,28,55,50.9,24,43,55.8,4,12,33.3,11,18,61.1,13,35,48,13,17,22,12,3,71
439992,498_13_28,PORTUGAL,2730,4,jose silva,20,1,7,14.3,1,4,25,0,3,0,0,0,0,0,0,0,0,3,1,3,1,2
439993,498_13_28,PORTUGAL,2918,5,claudio fonseca,30,1,3,33.3,0,2,0,1,1,100,4,6,66.7,1,4,5,1,2,3,2,0,7
439994,498_13_28,PORTUGAL,8195,6,jose barbosa,12,3,5,60,3,4,75,0,1,0,0,0,0,1,0,1,1,0,1,3,0,6
439995,498_13_28,PORTUGAL,5596,7,joao gomes,21,4,10,40,2,5,40,2,5,40,0,0,0,1,3,4,0,3,1,1,0,10
439996,498_13_28,PORTUGAL,10266,8,mario fernandes,23,1,5,20,1,1,100,0,4,0,2,2,100,0,2,2,3,1,2,0,0,4
439997,498_13_28,PORTUGAL,4778,10,carlos andrade,20,2,4,50,2,4,50,0,0,0,2,2,100,2,4,6,1,3,4,1,0,6
439998,498_13_28,PORTUGAL,10956,11,miguel queiroz,5,0,2,0,0,1,0,0,1,0,0,0,0,1,2,3,0,0,0,0,0,0
439999,498_13_28,PORTUGAL,1168,12,marco goncalves,10,0,1,0,0,0,0,0,1,0,0,0,0,1,0,1,0,1,0,0,0,0
440000,498_13_28,PORTUGAL,7851,13,joao balseiro,14,2,10,20,0,6,0,2,4,50,0,0,0,2,3,5,1,2,1,0,0,6
440001,498_13_28,PORTUGAL,4779,14,miguel a. saraiva miranda,19,3,7,42.9,1,1,100,2,6,33.3,1,2,50,1,0,1,1,2,2,1,0,9
440002,498_13_28,PORTUGAL,4735,15,joao santos,21,1,6,16.7,0,1,0,1,5,20,0,0,0,0,1,1,0,2,0,0,0,3
440003,498_13_28,PORTUGAL,17260,21,tomas barroso,5,0,2,0,0,0,0,0,2,0,0,0,0,0,0,0,0,0,1,1,0,0
440004,498_13_28,PORTUGAL,0,TOTALS,PORTUGAL,200,18,62,29,10,29,34.5,8,33,24.2,9,12,75,12,19,31,8,19,17,12,1,53
440005,498_13_29,BELARUS,4907,4,pavel ulyanko,21,2,5,40,0,2,0,2,3,66.7,3,4,75,1,3,4,2,2,1,0,1,9
440006,498_13_29,BELARUS,15346,5,siarhei charykau,29,3,5,60,2,4,50,1,1,100,2,2,100,0,2,2,2,3,1,2,0,9
440007,498_13_29,BELARUS,1653,6,maksim shustau,6,0,1,0,0,1,0,0,0,0,0,0,0,0,1,1,0,0,0,0,0,0
440008,498_13_29,BELARUS,5477,7,artsiom parakhouski,29,6,9,66.7,6,9,66.7,0,0,0,1,2,50,7,1,8,1,1,2,1,1,13
440009,498_13_29,BELARUS,2847,8,mikita meshcharakou,23,6,12,50,6,12,50,0,0,0,3,3,100,2,4,6,0,2,0,0,0,15
440010,498_13_29,BELARUS,991,9,dzmitry akulich,5,0,3,0,0,1,0,0,2,0,0,0,0,0,0,0,0,1,1,1,0,0
440011,498_13_29,BELARUS,13157,10,vitali liutych,16,1,5,20,1,3,33.3,0,2,0,0,0,0,0,1,1,0,1,1,0,0,2
440012,498_13_29,BELARUS,999,11,yury mishukou,3,0,0,0,0,0,0,0,0,0,0,0,0,0,0,0,0,0,0,0,0,0
440013,498_13_29,BELARUS,998,12,aliaksandr pustahvar,16,1,5,20,0,3,0,1,2,50,0,0,0,0,0,0,1,0,1,0,0,3
440014,498_13_29,BELARUS,11187,13,uladzimir krysevich,4,0,0,0,0,0,0,0,0,0,0,0,0,0,0,0,0,2,0,0,0,0
440015,498_13_29,BELARUS,4915,14,aliaksandr kudrautsau,28,7,15,46.7,4,9,44.4,3,6,50,4,5,80,2,6,8,2,3,1,1,0,21
440016,498_13_29,BELARUS,1645,15,aliaksei trastsinetski,20,2,5,40,2,3,66.7,0,2,0,0,0,0,3,2,5,1,0,1,1,0,4
440017,498_13_29,BELARUS,0,TOTALS,BELARUS,200,28,65,43.1,21,47,44.7,7,18,38.9,13,16,81.2,15,24,39,9,15,10,6,2,76
440018,498_13_29,ESTONIA,11295,4,rain veideman,25,5,9,55.6,3,6,50,2,3,66.7,0,2,0,0,3,3,0,5,1,0,1,12
440019,498_13_29,ESTONIA,1218,5,tanel sokk,19,4,8,50,4,6,66.7,0,2,0,0,0,0,2,1,3,3,2,0,1,1,8
440020,498_13_29,ESTONIA,1219,6,gert dorbek,22,2,5,40,2,4,50,0,1,0,0,0,0,0,1,1,1,1,1,0,0,4
440021,498_13_29,ESTONIA,1220,7,kristo saage,0,0,0,0,0,0,0,0,0,0,0,0,0,0,0,0,0,0,0,0,0,0
440022,498_13_29,ESTONIA,4625,8,janar talts,29,3,13,23.1,3,11,27.3,0,2,0,1,2,50,4,6,10,1,3,3,1,2,7
440023,498_13_29,ESTONIA,4622,9,gregor arbet,33,2,7,28.6,2,5,40,0,2,0,4,4,100,0,5,5,1,2,1,0,0,8
440024,498_13_29,ESTONIA,2721,10,sten sokk,22,2,5,40,1,3,33.3,1,2,50,0,0,0,0,1,1,1,5,1,3,0,5
440025,498_13_29,ESTONIA,6377,11,siim-sander vene,9,0,0,0,0,0,0,0,0,0,2,2,100,1,0,1,0,2,1,0,0,2
440026,498_13_29,ESTONIA,4771,14,kristjan kangur,21,1,8,12.5,0,4,0,1,4,25,0,0,0,3,3,6,2,1,2,1,0,3
440027,498_13_29,ESTONIA,1229,15,reinar hallik,21,8,10,80,5,6,83.3,3,4,75,2,2,100,2,1,3,0,3,1,0,2,21
440028,498_13_29,ESTONIA,11290,21,martin dorbek,0,0,0,0,0,0,0,0,0,0,0,0,0,0,0,0,0,0,0,0,0,0
440029,498_13_29,ESTONIA,8048,22,timo eichfuss,0,0,0,0,0,0,0,0,0,0,0,0,0,0,0,0,0,0,0,0,0,0
440030,498_13_29,ESTONIA,0,TOTALS,ESTONIA,200,27,65,41.5,20,45,44.4,7,20,35,9,12,75,15,21,36,9,24,11,6,6,70
440031,498_13_30,BULGARIA,1667,4,deyan ivanov,19,2,7,28.6,1,5,20,1,2,50,3,4,75,4,4,8,1,2,1,1,1,8
440032,498_13_30,BULGARIA,1667,5,kaloyan ivanov,23,4,11,36.4,2,5,40,2,6,33.3,2,6,33.3,1,5,6,3,1,2,1,0,12
440033,498_13_30,BULGARIA,2852,8,chavdar kostov,22,2,6,33.3,1,2,50,1,4,25,2,2,100,0,0,0,1,2,0,1,0,7
440034,498_13_30,BULGARIA,29516,9,branko mirkovic,30,4,7,57.1,1,3,33.3,3,4,75,0,0,0,0,3,3,9,1,2,2,0,11
440035,498_13_30,BULGARIA,8347,10,bozhidar avramov,10,1,1,100,1,1,100,0,0,0,0,0,0,0,0,0,2,0,1,0,0,2
440036,498_13_30,BULGARIA,2855,11,ivan lilov,22,3,6,50,0,1,0,3,5,60,0,0,0,0,0,0,4,4,2,1,0,9
440037,498_13_30,BULGARIA,8346,12,aleksandar georgiev,12,5,8,62.5,2,3,66.7,3,5,60,0,0,0,2,2,4,3,1,1,0,0,13
440038,498_13_30,BULGARIA,1675,13,asen velikov,10,1,1,100,1,1,100,0,0,0,2,2,100,0,4,4,3,1,1,0,0,4
440039,498_13_30,BULGARIA,2851,14,pavel ivanov,14,1,3,33.3,1,2,50,0,1,0,0,0,0,0,0,0,0,3,0,1,0,2
440040,498_13_30,BULGARIA,5588,21,nikolay varbanov,20,6,7,85.7,6,7,85.7,0,0,0,0,0,0,1,4,5,0,3,1,0,3,12
440041,498_13_30,BULGARIA,10177,24,veselin veselinov,19,3,4,75,1,1,100,2,3,66.7,4,4,100,1,3,4,0,3,0,0,1,12
440042,498_13_30,BULGARIA,8350,32,hristo zahariev,0,0,0,0,0,0,0,0,0,0,0,0,0,0,0,0,0,0,0,0,0,0
440043,498_13_30,BULGARIA,0,TOTALS,BULGARIA,200,32,61,52.5,17,31,54.8,15,30,50,13,18,72.2,9,27,36,26,21,12,7,5,92
440044,498_13_30,SWITZERLAND,12691,4,jonathan malu kazadi-muyombu,27,2,7,28.6,2,7,28.6,0,0,0,0,0,0,2,4,6,2,1,1,1,0,4
440045,498_13_30,SWITZERLAND,7804,6,dusan mladjan,28,7,15,46.7,4,5,80,3,10,30,1,1,100,1,3,4,1,4,1,0,0,18
440046,498_13_30,SWITZERLAND,12693,7,stefan petkovic,24,2,6,33.3,0,2,0,2,4,50,0,0,0,1,1,2,4,2,1,2,0,6
440047,498_13_30,SWITZERLAND,1260,8,cedric lionel mafuta,19,1,3,33.3,1,3,33.3,0,0,0,0,0,0,1,2,3,5,3,0,1,0,2
440048,498_13_30,SWITZERLAND,15690,9,jeremy jaunin,3,0,1,0,0,0,0,0,1,0,0,0,0,0,0,0,1,0,0,0,0,0
440049,498_13_30,SWITZERLAND,19748,10,roberto kovac,13,0,1,0,0,0,0,0,1,0,0,0,0,0,1,1,0,2,0,0,0,0
440050,498_13_30,SWITZERLAND,15691,11,jonathan eric dubas,29,3,10,30,3,9,33.3,0,1,0,4,7,57.1,3,3,6,1,4,5,1,1,10
440051,498_13_30,SWITZERLAND,16102,13,clint capela,22,9,14,64.3,9,14,64.3,0,0,0,0,2,0,3,2,5,0,3,2,3,1,18
440052,498_13_30,SWITZERLAND,4860,15,oliver matthias vogt,20,2,6,33.3,2,5,40,0,1,0,1,2,50,0,1,1,0,1,0,0,1,5
440053,498_13_30,SWITZERLAND,17392,21,evrard adam atcho,0,0,0,0,0,0,0,0,0,0,0,0,0,0,0,0,0,0,0,0,0,0
440054,498_13_30,SWITZERLAND,16096,25,marko mladjan,16,3,6,50,1,2,50,2,4,50,0,0,0,2,2,4,0,1,2,1,0,8
440055,498_13_30,SWITZERLAND,0,TOTALS,SWITZERLAND,200,29,69,42,22,47,46.8,7,22,31.8,6,12,50,13,20,33,14,21,13,9,3,71
440056,498_13_31,SWITZERLAND,12691,4,jonathan malu kazadi-muyombu,23,4,13,30.8,4,12,33.3,0,1,0,1,2,50,2,2,4,1,3,1,2,0,9
440057,498_13_31,SWITZERLAND,7804,6,dusan mladjan,28,2,8,25,1,4,25,1,4,25,4,5,80,0,2,2,3,4,1,1,0,9
440058,498_13_31,SWITZERLAND,12693,7,stefan petkovic,19,2,4,50,2,2,100,0,2,0,4,4,100,2,0,2,3,2,2,1,0,8
440059,498_13_31,SWITZERLAND,1260,8,cedric lionel mafuta,9,0,1,0,0,1,0,0,0,0,0,0,0,0,0,0,1,0,2,0,0,0
440060,498_13_31,SWITZERLAND,15690,9,jeremy jaunin,9,0,1,0,0,1,0,0,0,0,0,0,0,0,0,0,0,1,0,2,0,0
440061,498_13_31,SWITZERLAND,19748,10,roberto kovac,20,1,7,14.3,0,2,0,1,5,20,0,0,0,1,0,1,0,1,1,0,0,3
440062,498_13_31,SWITZERLAND,15691,11,jonathan eric dubas,19,1,3,33.3,1,3,33.3,0,0,0,0,0,0,0,3,3,1,5,3,1,0,2
440063,498_13_31,SWITZERLAND,16102,13,clint capela,34,9,11,81.8,9,11,81.8,0,0,0,1,2,50,2,4,6,0,2,3,7,0,19
440064,498_13_31,SWITZERLAND,4860,15,oliver matthias vogt,15,0,5,0,0,2,0,0,3,0,0,0,0,2,2,4,1,2,1,0,0,0
440065,498_13_31,SWITZERLAND,17392,21,evrard adam atcho,2,0,0,0,0,0,0,0,0,0,0,0,0,0,0,0,0,1,1,0,0,0
440066,498_13_31,SWITZERLAND,16096,25,marko mladjan,22,8,15,53.3,7,10,70,1,5,20,0,0,0,2,3,5,0,5,0,0,2,17
440067,498_13_31,SWITZERLAND,0,TOTALS,SWITZERLAND,200,27,68,39.7,24,48,50,3,20,15,10,13,76.9,11,16,27,10,26,16,14,2,67
440068,498_13_31,BULGARIA,1667,4,deyan ivanov,26,5,12,41.7,5,11,45.5,0,1,0,0,0,0,1,3,4,3,3,3,0,0,10
440069,498_13_31,BULGARIA,1667,5,kaloyan ivanov,15,4,9,44.4,3,4,75,1,5,20,8,10,80,1,4,5,0,1,0,2,0,17
440070,498_13_31,BULGARIA,2852,8,chavdar kostov,20,2,4,50,1,2,50,1,2,50,0,0,0,1,5,6,0,2,1,0,0,5
440071,498_13_31,BULGARIA,29516,9,branko mirkovic,18,1,2,50,1,1,100,0,1,0,0,0,0,0,2,2,2,2,4,1,0,2
440072,498_13_31,BULGARIA,8347,10,bozhidar avramov,14,0,1,0,0,1,0,0,0,0,4,4,100,0,1,1,3,2,4,2,0,4
440073,498_13_31,BULGARIA,2855,11,ivan lilov,18,3,5,60,1,1,100,2,4,50,1,2,50,0,2,2,1,1,2,2,0,9
440074,498_13_31,BULGARIA,8346,12,aleksandar georgiev,20,3,3,100,1,1,100,2,2,100,2,4,50,2,2,4,1,1,3,0,0,10
440075,498_13_31,BULGARIA,1675,13,asen velikov,8,0,0,0,0,0,0,0,0,0,2,2,100,0,0,0,0,1,2,2,0,2
440076,498_13_31,BULGARIA,2851,14,pavel ivanov,14,4,5,80,3,4,75,1,1,100,1,1,100,1,1,2,3,4,0,0,0,10
440077,498_13_31,BULGARIA,5588,21,nikolay varbanov,19,1,1,100,1,1,100,0,0,0,0,0,0,0,5,5,0,0,0,0,0,2
440078,498_13_31,BULGARIA,10177,24,veselin veselinov,20,4,6,66.7,2,4,50,2,2,100,1,2,50,0,2,2,1,2,0,2,0,11
440079,498_13_31,BULGARIA,8350,32,hristo zahariev,7,2,3,66.7,1,2,50,1,1,100,0,0,0,0,0,0,0,0,1,0,0,5
440080,498_13_31,BULGARIA,0,TOTALS,BULGARIA,200,29,51,56.9,19,32,59.4,10,19,52.6,19,25,76,6,27,33,14,19,20,11,0,87
440081,498_13_32,ESTONIA,11295,4,rain veideman,24,4,8,50,3,5,60,1,3,33.3,0,0,0,0,0,0,3,2,0,0,0,9
440082,498_13_32,ESTONIA,1218,5,tanel sokk,12,2,3,66.7,1,2,50,1,1,100,0,0,0,0,2,2,2,4,1,0,0,5
440083,498_13_32,ESTONIA,1219,6,gert dorbek,32,3,6,50,3,4,75,0,2,0,2,2,100,1,4,5,2,4,2,1,0,8
440084,498_13_32,ESTONIA,1220,7,kristo saage,0,0,0,0,0,0,0,0,0,0,0,0,0,0,0,0,0,0,0,0,0,0
440085,498_13_32,ESTONIA,4625,8,janar talts,27,3,9,33.3,3,7,42.9,0,2,0,1,2,50,2,7,9,4,3,0,0,0,7
440086,498_13_32,ESTONIA,4622,9,gregor arbet,24,3,5,60,1,1,100,2,4,50,0,0,0,2,2,4,0,2,1,1,0,8
440087,498_13_32,ESTONIA,2721,10,sten sokk,28,4,10,40,2,5,40,2,5,40,1,2,50,1,3,4,3,5,3,2,0,11
440088,498_13_32,ESTONIA,6377,11,siim-sander vene,18,4,8,50,4,7,57.1,0,1,0,0,0,0,3,0,3,3,2,0,1,2,8
440089,498_13_32,ESTONIA,4771,14,kristjan kangur,28,7,13,53.8,7,11,63.6,0,2,0,6,7,85.7,1,9,10,1,3,1,3,0,20
440090,498_13_32,ESTONIA,1229,15,reinar hallik,7,1,4,25,0,0,0,1,4,25,0,0,0,0,0,0,0,2,0,0,0,3
440091,498_13_32,ESTONIA,11290,21,martin dorbek,0,0,0,0,0,0,0,0,0,0,0,0,0,0,0,0,0,0,0,0,0,0
440092,498_13_32,ESTONIA,8048,22,timo eichfuss,0,0,0,0,0,0,0,0,0,0,0,0,0,0,0,0,0,0,0,0,0,0
440093,498_13_32,ESTONIA,0,TOTALS,ESTONIA,200,31,66,47,24,42,57.1,7,24,29.2,10,13,76.9,10,29,39,18,27,8,8,2,79
440094,498_13_32,BELARUS,4907,4,pavel ulyanko,21,2,6,33.3,2,5,40,0,1,0,7,8,87.5,0,5,5,1,4,3,0,2,11
440095,498_13_32,BELARUS,15346,5,siarhei charykau,25,1,5,20,0,3,0,1,2,50,1,2,50,0,1,1,1,3,1,0,1,4
440096,498_13_32,BELARUS,1653,6,maksim shustau,13,0,3,0,0,0,0,0,3,0,0,0,0,0,1,1,0,1,0,0,0,0
440097,498_13_32,BELARUS,5477,7,artsiom parakhouski,29,3,7,42.9,3,7,42.9,0,0,0,3,5,60,1,7,8,0,2,4,0,3,9
440098,498_13_32,BELARUS,2847,8,mikita meshcharakou,15,1,3,33.3,1,2,50,0,1,0,0,4,0,2,1,3,1,2,0,0,0,2
440099,498_13_32,BELARUS,991,9,dzmitry akulich,0,0,0,0,0,0,0,0,0,0,0,0,0,0,0,0,0,0,0,0,0,0
440100,498_13_32,BELARUS,13157,10,vitali liutych,26,4,8,50,4,6,66.7,0,2,0,3,4,75,1,2,3,0,0,1,2,1,11
440101,498_13_32,BELARUS,999,11,yury mishukou,0,0,0,0,0,0,0,0,0,0,0,0,0,0,0,0,0,0,0,0,0,0
440102,498_13_32,BELARUS,998,12,aliaksandr pustahvar,18,0,3,0,0,1,0,0,2,0,0,0,0,1,3,4,1,3,0,1,0,0
440103,498_13_32,BELARUS,11187,13,uladzimir krysevich,3,0,0,0,0,0,0,0,0,0,0,0,0,0,0,0,0,1,0,0,0,0
440104,498_13_32,BELARUS,4915,14,aliaksandr kudrautsau,34,9,14,64.3,8,11,72.7,1,3,33.3,3,4,75,2,3,5,1,4,6,1,0,22
440105,498_13_32,BELARUS,1645,15,aliaksei trastsinetski,17,0,2,0,0,1,0,0,1,0,2,4,50,1,2,3,0,0,1,0,0,2
440106,498_13_32,BELARUS,0,TOTALS,BELARUS,200,20,51,39.2,18,36,50,2,15,13.3,19,31,61.3,10,26,36,5,20,16,4,7,61
440107,498_13_33,BULGARIA,1667,4,deyan ivanov,24,3,9,33.3,3,8,37.5,0,1,0,6,6,100,2,1,3,5,4,3,1,0,12
440108,498_13_33,BULGARIA,1667,5,kaloyan ivanov,31,6,12,50,6,9,66.7,0,3,0,3,4,75,5,6,11,1,2,3,0,0,15
440109,498_13_33,BULGARIA,2852,8,chavdar kostov,25,2,6,33.3,0,3,0,2,3,66.7,0,0,0,0,5,5,1,0,0,0,0,6
440110,498_13_33,BULGARIA,29516,9,branko mirkovic,27,2,8,25,0,3,0,2,5,40,1,2,50,0,6,6,0,3,2,2,0,7
440111,498_13_33,BULGARIA,8347,10,bozhidar avramov,25,1,5,20,0,2,0,1,3,33.3,1,2,50,1,5,6,2,2,0,2,0,4
440112,498_13_33,BULGARIA,2855,11,ivan lilov,24,2,6,33.3,1,1,100,1,5,20,1,2,50,1,4,5,1,0,2,0,0,6
440113,498_13_33,BULGARIA,8346,12,aleksandar georgiev,10,0,3,0,0,2,0,0,1,0,1,2,50,1,1,2,0,0,1,0,0,1
440114,498_13_33,BULGARIA,1675,13,asen velikov,5,0,0,0,0,0,0,0,0,0,0,0,0,0,1,1,0,1,0,0,0,0
440115,498_13_33,BULGARIA,2851,14,pavel ivanov,5,1,1,100,1,1,100,0,0,0,2,2,100,0,1,1,0,1,0,0,0,4
440116,498_13_33,BULGARIA,5588,21,nikolay varbanov,11,0,2,0,0,2,0,0,0,0,3,4,75,2,1,3,0,1,1,0,0,3
440117,498_13_33,BULGARIA,10177,24,veselin veselinov,14,0,3,0,0,2,0,0,1,0,0,0,0,0,2,2,0,2,1,1,0,0
440118,498_13_33,BULGARIA,8350,32,hristo zahariev,0,0,0,0,0,0,0,0,0,0,0,0,0,0,0,0,0,0,0,0,0,0
440119,498_13_33,BULGARIA,0,TOTALS,BULGARIA,200,17,55,30.9,11,33,33.3,6,22,27.3,18,24,75,12,33,45,10,17,15,6,0,58
440120,498_13_33,ESTONIA,11295,4,rain veideman,19,5,8,62.5,4,6,66.7,1,2,50,0,2,0,0,1,1,1,2,3,2,0,11
440121,498_13_33,ESTONIA,1218,5,tanel sokk,23,3,4,75,3,4,75,0,0,0,0,0,0,0,3,3,2,2,2,0,0,6
440122,498_13_33,ESTONIA,1219,6,gert dorbek,29,2,6,33.3,1,2,50,1,4,25,1,1,100,0,3,3,0,3,1,0,0,6
440123,498_13_33,ESTONIA,1220,7,kristo saage,0,0,0,0,0,0,0,0,0,0,0,0,0,0,0,0,0,0,0,0,0,0
440124,498_13_33,ESTONIA,4625,8,janar talts,20,1,5,20,1,3,33.3,0,2,0,0,0,0,0,5,5,2,3,1,1,1,2
440125,498_13_33,ESTONIA,4622,9,gregor arbet,32,2,5,40,1,1,100,1,4,25,0,0,0,0,6,6,3,3,1,0,0,5
440126,498_13_33,ESTONIA,2721,10,sten sokk,17,2,4,50,1,2,50,1,2,50,1,2,50,0,2,2,2,4,2,0,0,6
440127,498_13_33,ESTONIA,6377,11,siim-sander vene,24,3,12,25,2,10,20,1,2,50,1,2,50,0,3,3,1,1,0,2,1,8
440128,498_13_33,ESTONIA,4771,14,kristjan kangur,22,1,7,14.3,1,4,25,0,3,0,1,2,50,2,3,5,0,3,2,0,0,3
440129,498_13_33,ESTONIA,1229,15,reinar hallik,14,3,7,42.9,2,2,100,1,5,20,1,1,100,0,0,0,0,2,1,0,0,8
440130,498_13_33,ESTONIA,11290,21,martin dorbek,0,0,0,0,0,0,0,0,0,0,0,0,0,0,0,0,0,0,0,0,0,0
440131,498_13_33,ESTONIA,8048,22,timo eichfuss,0,0,0,0,0,0,0,0,0,0,0,0,0,0,0,0,0,0,0,0,0,0
440132,498_13_33,ESTONIA,0,TOTALS,ESTONIA,200,22,58,37.9,16,34,47.1,6,24,25,5,10,50,3,28,31,11,23,13,5,2,55
440133,498_13_34,ESTONIA,11295,4,rain veideman,24,4,9,44.4,4,7,57.1,0,2,0,2,4,50,1,3,4,1,4,1,2,0,10
440134,498_13_34,ESTONIA,1218,5,tanel sokk,25,2,8,25,1,6,16.7,1,2,50,4,6,66.7,1,3,4,2,2,0,0,0,9
440135,498_13_34,ESTONIA,1219,6,gert dorbek,21,3,4,75,0,0,0,3,4,75,1,2,50,1,2,3,1,1,1,1,0,10
440136,498_13_34,ESTONIA,1220,7,kristo saage,0,0,0,0,0,0,0,0,0,0,0,0,0,0,0,0,0,0,0,0,0,0
440137,498_13_34,ESTONIA,4625,8,janar talts,6,1,2,50,1,2,50,0,0,0,0,0,0,2,2,4,2,1,1,0,1,2
440138,498_13_34,ESTONIA,4622,9,gregor arbet,35,2,6,33.3,1,3,33.3,1,3,33.3,2,3,66.7,1,3,4,1,4,0,1,0,7
440139,498_13_34,ESTONIA,2721,10,sten sokk,15,1,3,33.3,0,1,0,1,2,50,0,0,0,0,1,1,2,4,3,2,0,3
440140,498_13_34,ESTONIA,6377,11,siim-sander vene,34,2,11,18.2,1,7,14.3,1,4,25,2,2,100,1,5,6,2,3,0,1,3,7
440141,498_13_34,ESTONIA,4771,14,kristjan kangur,32,4,9,44.4,4,7,57.1,0,2,0,0,0,0,1,5,6,2,3,0,4,0,8
440142,498_13_34,ESTONIA,1229,15,reinar hallik,8,2,6,33.3,1,2,50,1,4,25,0,0,0,1,1,2,0,1,0,1,0,5
440143,498_13_34,ESTONIA,11290,21,martin dorbek,0,0,0,0,0,0,0,0,0,0,0,0,0,0,0,0,0,0,0,0,0,0
440144,498_13_34,ESTONIA,8048,22,timo eichfuss,0,0,0,0,0,0,0,0,0,0,0,0,0,0,0,0,0,0,0,0,0,0
440145,498_13_34,ESTONIA,0,TOTALS,ESTONIA,200,21,58,36.2,13,35,37.1,8,23,34.8,11,17,64.7,10,25,35,13,23,6,12,4,61
440146,498_13_34,BULGARIA,1667,4,deyan ivanov,30,2,8,25,1,6,16.7,1,2,50,2,2,100,5,4,9,3,3,2,0,1,7
440147,498_13_34,BULGARIA,1667,5,kaloyan ivanov,34,5,12,41.7,4,9,44.4,1,3,33.3,2,2,100,3,4,7,1,1,0,2,2,13
440148,498_13_34,BULGARIA,2852,8,chavdar kostov,29,2,9,22.2,1,3,33.3,1,6,16.7,0,0,0,0,2,2,0,4,1,2,0,5
440149,498_13_34,BULGARIA,29516,9,branko mirkovic,29,1,6,16.7,0,1,0,1,5,20,2,2,100,2,5,7,1,1,6,1,0,5
440150,498_13_34,BULGARIA,8347,10,bozhidar avramov,21,4,6,66.7,3,4,75,1,2,50,1,1,100,1,1,2,2,4,2,0,0,10
440151,498_13_34,BULGARIA,2855,11,ivan lilov,17,0,5,0,0,1,0,0,4,0,2,2,100,1,2,3,1,4,2,0,0,2
440152,498_13_34,BULGARIA,8346,12,aleksandar georgiev,15,2,4,50,2,3,66.7,0,1,0,2,6,33.3,2,3,5,0,0,1,0,0,6
440153,498_13_34,BULGARIA,1675,13,asen velikov,1,0,0,0,0,0,0,0,0,0,0,0,0,0,0,0,0,0,0,0,0,0
440154,498_13_34,BULGARIA,2851,14,pavel ivanov,6,0,0,0,0,0,0,0,0,0,0,0,0,1,0,1,0,1,1,0,0,0
440155,498_13_34,BULGARIA,5588,21,nikolay varbanov,4,0,2,0,0,2,0,0,0,0,0,0,0,1,0,1,0,0,0,0,0,0
440156,498_13_34,BULGARIA,10177,24,veselin veselinov,12,0,2,0,0,1,0,0,1,0,1,2,50,0,2,2,0,1,2,0,0,1
440157,498_13_34,BULGARIA,8350,32,hristo zahariev,2,0,0,0,0,0,0,0,0,0,0,0,0,0,0,0,0,0,0,0,0,0
440158,498_13_34,BULGARIA,0,TOTALS,BULGARIA,200,16,54,29.6,11,30,36.7,5,24,20.8,12,17,70.6,16,29,45,8,19,18,5,3,49
440159,499_14_01,SWITZERLAND,12691,4,jonathan malu kazadi-muyombu,17,1,2,50,0,1,0,1,1,100,0,0,0,1,1,2,1,4,0,0,0,3
440160,499_14_01,SWITZERLAND,7804,6,dusan mladjan,30,7,15,46.7,2,6,33.3,5,9,55.6,5,5,100,0,3,3,2,4,2,1,0,24
440161,499_14_01,SWITZERLAND,16096,7,marko mladjan,16,1,4,25,0,1,0,1,3,33.3,0,0,0,0,0,0,0,3,3,2,0,3
440162,499_14_01,SWITZERLAND,1260,8,cedric lionel mafuta,12,0,1,0,0,1,0,0,0,0,0,0,0,0,2,2,0,3,2,0,0,0
440163,499_14_01,SWITZERLAND,19748,9,roberto kovac,7,0,0,0,0,0,0,0,0,0,0,0,0,0,0,0,1,2,1,1,0,0
440164,499_14_01,SWITZERLAND,10497,12,nicolas dos santos,3,0,1,0,0,0,0,0,1,0,0,0,0,0,0,0,0,3,0,0,0,0
440165,499_14_01,SWITZERLAND,16102,13,clint capela,34,4,9,44.4,4,9,44.4,0,0,0,3,6,50,1,6,7,0,2,1,5,1,11
440166,499_14_01,SWITZERLAND,19724,14,greg thomas brunner,30,3,7,42.9,1,4,25,2,3,66.7,7,10,70,1,2,3,3,4,2,0,0,15
440167,499_14_01,SWITZERLAND,17888,15,arnaud amedee cotture,22,3,5,60,2,4,50,1,1,100,5,6,83.3,1,0,1,4,4,1,0,0,12
440168,499_14_01,SWITZERLAND,12695,20,brian savoy,16,3,3,100,2,2,100,1,1,100,2,4,50,1,4,5,2,0,4,0,0,9
440169,499_14_01,SWITZERLAND,4860,21,oliver matthias vogt,13,0,0,0,0,0,0,0,0,0,2,2,100,2,1,3,0,2,1,0,0,2
440170,499_14_01,SWITZERLAND,17392,22,evrard adam atcho,0,0,0,0,0,0,0,0,0,0,0,0,0,0,0,0,0,0,0,0,0,0
440171,499_14_01,SWITZERLAND,0,TOTALS,SWITZERLAND,200,22,47,46.8,11,28,39.3,11,19,57.9,24,33,72.7,8,22,30,13,31,17,9,1,79
440172,499_14_01,RUSSIA,1809,5,nikita kurbanov,28,3,9,33.3,3,7,42.9,0,2,0,7,8,87.5,1,3,4,2,4,2,0,0,13
440173,499_14_01,RUSSIA,12959,7,dmitrii kulagin,7,1,2,50,1,2,50,0,0,0,0,0,0,0,1,1,1,0,1,0,0,2
440174,499_14_01,RUSSIA,29520,8,pavel korobkov,14,1,2,50,1,1,100,0,1,0,0,0,0,1,0,1,1,4,0,0,0,2
440175,499_14_01,RUSSIA,1083,9,egor vyaltsev,16,2,5,40,1,2,50,1,3,33.3,5,6,83.3,0,1,1,0,2,1,1,0,10
440176,499_14_01,RUSSIA,1079,10,dmitry sokolov,17,1,1,100,1,1,100,0,0,0,2,3,66.7,1,4,5,0,0,0,0,1,4
440177,499_14_01,RUSSIA,1814,11,valerii likhodei,4,1,3,33.3,0,1,0,1,2,50,0,0,0,1,0,1,0,1,2,0,1,3
440178,499_14_01,RUSSIA,2554,13,dmitry khvostov,18,0,3,0,0,0,0,0,3,0,2,2,100,0,2,2,2,3,1,3,0,2
440179,499_14_01,RUSSIA,1808,14,anton ponkrashov,29,2,5,40,1,4,25,1,1,100,3,4,75,1,3,4,3,1,1,2,0,8
440180,499_14_01,RUSSIA,15377,15,timofey mozgov,18,2,3,66.7,2,3,66.7,0,0,0,5,7,71.4,4,3,7,0,2,3,4,0,9
440181,499_14_01,RUSSIA,15956,22,sergey karasev,7,1,4,25,0,2,0,1,2,50,0,0,0,0,1,1,1,2,0,0,0,3
440182,499_14_01,RUSSIA,10610,23,semen antonov,22,4,6,66.7,0,0,0,4,6,66.7,0,0,0,0,0,0,4,5,3,0,0,12
440183,499_14_01,RUSSIA,1810,24,evgeny voronov,20,3,8,37.5,2,3,66.7,1,5,20,2,2,100,0,1,1,1,4,3,2,0,9
440184,499_14_01,RUSSIA,0,TOTALS,RUSSIA,200,21,51,41.2,12,26,46.2,9,25,36,26,32,81.2,10,21,31,15,28,17,12,2,77
440185,499_14_02,BELARUS,1646,4,kanstantsin yafremau,17,3,5,60,3,4,75,0,1,0,0,0,0,0,1,1,1,2,0,1,0,6
440186,499_14_02,BELARUS,15346,5,siarhei charykau,22,1,6,16.7,1,4,25,0,2,0,2,2,100,0,2,2,7,3,4,1,0,4
440187,499_14_02,BELARUS,16119,6,aliaksandr semianiuk,12,2,2,100,2,2,100,0,0,0,3,5,60,0,1,1,0,3,0,0,1,7
440188,499_14_02,BELARUS,29521,7,kiryl sitnik,23,3,8,37.5,3,6,50,0,2,0,3,4,75,2,4,6,6,1,3,3,0,9
440189,499_14_02,BELARUS,2847,8,mikita meshcharakou,12,1,3,33.3,1,3,33.3,0,0,0,0,0,0,1,2,3,0,2,1,1,1,2
440190,499_14_02,BELARUS,4916,9,mikalai aliakseyeu,5,1,1,100,1,1,100,0,0,0,2,2,100,0,3,3,0,1,0,0,0,4
440191,499_14_02,BELARUS,13157,10,vitali liutych,21,6,11,54.5,5,8,62.5,1,3,33.3,0,0,0,1,4,5,1,2,1,2,0,13
440192,499_14_02,BELARUS,997,11,dzmitry paliashchuk,20,3,7,42.9,3,6,50,0,1,0,2,4,50,5,6,11,0,2,0,1,0,8
440193,499_14_02,BELARUS,998,12,aliaksandr pustahvar,22,8,10,80,3,3,100,5,7,71.4,3,6,50,3,8,11,2,1,1,1,0,24
440194,499_14_02,BELARUS,5476,13,valery gandlin,0,0,0,0,0,0,0,0,0,0,0,0,0,0,0,0,0,0,0,0,0,0
440195,499_14_02,BELARUS,4915,14,aliaksandr kudrautsau,20,2,5,40,1,3,33.3,1,2,50,5,5,100,0,4,4,4,3,4,2,0,10
440196,499_14_02,BELARUS,1645,15,aliaksei trastsinetski,26,5,13,38.5,5,9,55.6,0,4,0,0,2,0,3,5,8,2,2,3,3,0,10
440197,499_14_02,BELARUS,0,TOTALS,BELARUS,200,35,71,49.3,28,49,57.1,7,22,31.8,20,30,66.7,16,41,57,23,22,18,15,2,97
440198,499_14_02,DENMARK,29522,4,darko jukic,28,4,12,33.3,3,9,33.3,1,3,33.3,1,6,16.7,1,10,11,3,2,0,2,0,10
440199,499_14_02,DENMARK,16165,5,frederik rungby,11,0,2,0,0,1,0,0,1,0,1,2,50,2,1,3,0,2,1,0,0,1
440200,499_14_02,DENMARK,24492,6,tobias reinholt,10,0,2,0,0,2,0,0,0,0,0,0,0,0,0,0,0,2,0,1,0,0
440201,499_14_02,DENMARK,16162,7,esben reinholt,24,6,13,46.2,6,11,54.5,0,2,0,2,2,100,3,1,4,1,3,1,2,0,14
440202,499_14_02,DENMARK,21908,8,gabriel lundberg,18,1,3,33.3,0,0,0,1,3,33.3,0,0,0,0,0,0,2,2,1,1,0,3
440203,499_14_02,DENMARK,12662,9,alexander heidenheim bak,16,4,8,50,3,3,100,1,5,20,1,2,50,0,2,2,1,4,3,0,0,10
440204,499_14_02,DENMARK,10649,10,mathias seilund,21,2,7,28.6,0,2,0,2,5,40,3,3,100,0,2,2,1,5,2,1,0,9
440205,499_14_02,DENMARK,15650,11,thomas sebastian laerke,22,2,11,18.2,1,6,16.7,1,5,20,2,2,100,0,3,3,2,2,4,0,0,7
440206,499_14_02,DENMARK,17655,12,peter moeller,14,0,2,0,0,1,0,0,1,0,0,0,0,1,0,1,3,0,0,0,0,0
440207,499_14_02,DENMARK,29523,13,asger hjorth,5,0,0,0,0,0,0,0,0,0,0,0,0,0,0,0,0,1,0,0,0,0
440208,499_14_02,DENMARK,13180,14,anders kristoffer haas,11,4,7,57.1,2,2,100,2,5,40,0,0,0,0,0,0,1,2,2,1,0,10
440209,499_14_02,DENMARK,12663,15,jonas zohore bergstedt,20,2,8,25,2,8,25,0,0,0,4,4,100,2,4,6,2,0,3,0,1,8
440210,499_14_02,DENMARK,0,TOTALS,DENMARK,200,25,75,33.3,17,45,37.8,8,30,26.7,14,21,66.7,11,25,36,16,25,17,8,1,72
440211,499_14_03,SLOVAK REPUBLIC,15367,4,marek kozlik,0,0,0,0,0,0,0,0,0,0,0,0,0,0,0,0,0,0,0,0,0,0
440212,499_14_03,SLOVAK REPUBLIC,6339,5,peter dorazil,20,3,4,75,3,4,75,0,0,0,1,1,100,2,3,5,0,5,1,0,0,7
440213,499_14_03,SLOVAK REPUBLIC,1154,6,peter sedmak,29,3,10,30,2,7,28.6,1,3,33.3,1,2,50,2,3,5,3,4,2,0,0,8
440214,499_14_03,SLOVAK REPUBLIC,11264,7,tomas mrvis,20,2,5,40,0,1,0,2,4,50,0,0,0,1,1,2,3,2,2,0,0,6
440215,499_14_03,SLOVAK REPUBLIC,10469,8,milan ziak,17,0,2,0,0,1,0,0,1,0,0,2,0,1,1,2,2,2,2,0,0,0
440216,499_14_03,SLOVAK REPUBLIC,5862,9,martin bilik,30,5,10,50,5,6,83.3,0,4,0,0,0,0,2,1,3,0,0,4,1,0,10
440217,499_14_03,SLOVAK REPUBLIC,29524,10,nenad milosevic,31,5,16,31.2,1,4,25,4,12,33.3,6,9,66.7,0,1,1,7,3,3,0,0,20
440218,499_14_03,SLOVAK REPUBLIC,17785,11,oliver tot,0,0,0,0,0,0,0,0,0,0,0,0,0,0,0,0,0,0,0,0,0,0
440219,499_14_03,SLOVAK REPUBLIC,8025,12,peter simek,11,2,3,66.7,2,3,66.7,0,0,0,0,0,0,1,3,4,0,0,1,0,0,4
440220,499_14_03,SLOVAK REPUBLIC,12668,13,andrej kuffa,20,4,7,57.1,2,3,66.7,2,4,50,0,0,0,2,3,5,0,4,0,0,1,10
440221,499_14_03,SLOVAK REPUBLIC,8444,15,marek jass,22,1,6,16.7,1,3,33.3,0,3,0,2,2,100,2,8,10,2,5,1,2,0,4
440222,499_14_03,SLOVAK REPUBLIC,0,TOTALS,SLOVAK REPUBLIC,200,25,63,39.7,16,32,50,9,31,29,10,16,62.5,13,24,37,17,25,17,3,1,69
440223,499_14_03,ROMANIA,2115,4,andrei mandache,21,1,6,16.7,1,3,33.3,0,3,0,2,4,50,0,3,3,0,3,2,0,0,4
440224,499_14_03,ROMANIA,10239,5,mihail-octavian paul,25,2,4,50,2,3,66.7,0,1,0,7,8,87.5,0,4,4,1,2,2,1,0,11
440225,499_14_03,ROMANIA,5015,6,levente szijarto,23,1,3,33.3,1,2,50,0,1,0,0,0,0,0,1,1,0,2,1,1,0,2
440226,499_14_03,ROMANIA,2900,9,vlad moldoveanu,33,6,11,54.5,4,7,57.1,2,4,50,4,4,100,2,7,9,3,1,2,2,0,18
440227,499_14_03,ROMANIA,2915,10,catalin baciu,0,0,0,0,0,0,0,0,0,0,0,0,0,0,0,0,0,0,0,0,0,0
440228,499_14_03,ROMANIA,15354,11,octavian calota-popa,10,0,1,0,0,0,0,0,1,0,1,3,33.3,1,1,2,4,1,1,0,0,1
440229,499_14_03,ROMANIA,11102,12,bogdan tibirna,4,0,1,0,0,1,0,0,0,0,0,0,0,0,0,0,0,0,0,0,0,0
440230,499_14_03,ROMANIA,15358,13,teodor gabriel jucan,11,1,2,50,1,1,100,0,1,0,0,0,0,0,0,0,0,2,0,0,0,2
440231,499_14_03,ROMANIA,2125,14,titus nicoara,23,8,10,80,8,10,80,0,0,0,4,5,80,3,5,8,1,4,0,0,0,20
440232,499_14_03,ROMANIA,4965,15,mihai vlad silvasan,21,4,9,44.4,2,3,66.7,2,6,33.3,0,0,0,1,3,4,2,1,2,0,0,10
440233,499_14_03,ROMANIA,5016,21,adrian tudor,5,0,1,0,0,1,0,0,0,0,0,0,0,0,0,0,0,1,1,0,0,0
440234,499_14_03,ROMANIA,12712,44,adrian gutoaia,25,5,11,45.5,5,8,62.5,0,3,0,3,4,75,1,3,4,2,2,2,4,0,13
440235,499_14_03,ROMANIA,0,TOTALS,ROMANIA,200,28,59,47.5,24,39,61.5,4,20,20,21,28,75,9,28,37,13,19,13,8,0,81
440236,499_14_04,SWEDEN,20455,4,ludvig hakanson,14,2,5,40,1,2,50,1,3,33.3,0,0,0,0,2,2,1,3,2,1,0,5
440237,499_14_04,SWEDEN,16053,5,tobias borg,24,3,7,42.9,3,7,42.9,0,0,0,5,6,83.3,1,1,2,0,1,1,1,0,11
440238,499_14_04,SWEDEN,4748,6,joakim kjellbom,24,3,8,37.5,3,8,37.5,0,0,0,0,0,0,1,4,5,2,3,2,2,0,6
440239,499_14_04,SWEDEN,10481,7,dino pita,15,0,2,0,0,1,0,0,1,0,0,0,0,0,2,2,0,2,0,0,0,0
440240,499_14_04,SWEDEN,10740,8,john gaddefors,9,0,2,0,0,1,0,0,1,0,0,0,0,0,1,1,0,3,0,0,1,0
440241,499_14_04,SWEDEN,1176,9,thomas massamba,26,3,8,37.5,3,7,42.9,0,1,0,2,4,50,1,3,4,2,3,3,0,0,8
440242,499_14_04,SWEDEN,1972,10,martin pahlmblad,22,1,2,50,1,2,50,0,0,0,1,2,50,1,1,2,1,2,0,1,0,3
440243,499_14_04,SWEDEN,2702,12,brice massamba,18,1,4,25,1,4,25,0,0,0,1,2,50,1,3,4,1,2,1,0,0,3
440244,499_14_04,SWEDEN,10168,13,christian maraker,11,1,4,25,1,4,25,0,0,0,0,0,0,2,1,3,0,0,0,0,0,2
440245,499_14_04,SWEDEN,11099,14,alexander lindqvist,13,2,4,50,2,3,66.7,0,1,0,2,2,100,0,1,1,0,5,0,0,0,6
440246,499_14_04,SWEDEN,13061,15,jonathan person,9,3,5,60,3,4,75,0,1,0,0,2,0,0,1,1,0,0,1,1,0,6
440247,499_14_04,SWEDEN,15688,40,carl engstrom,14,0,1,0,0,1,0,0,0,0,0,0,0,0,4,4,1,1,1,0,0,0
440248,499_14_04,SWEDEN,0,TOTALS,SWEDEN,200,19,52,36.5,18,44,40.9,1,8,12.5,11,18,61.1,7,27,34,8,25,14,6,1,50
440249,499_14_04,LATVIA,19755,5,mareks mejeris,1,0,0,0,0,0,0,0,0,0,0,0,0,0,0,0,0,0,0,0,0,0
440250,499_14_04,LATVIA,2539,6,rolands freimanis,18,1,6,16.7,0,2,0,1,4,25,0,0,0,0,1,1,0,1,1,1,1,3
440251,499_14_04,LATVIA,5029,7,janis blums,28,4,7,57.1,1,2,50,3,5,60,2,2,100,0,2,2,1,3,0,0,0,13
440252,499_14_04,LATVIA,6271,9,dairis bertans,20,3,4,75,1,2,50,2,2,100,5,7,71.4,1,1,2,0,5,3,0,0,13
440253,499_14_04,LATVIA,12927,10,janis timma,20,0,3,0,0,2,0,0,1,0,2,2,100,2,6,8,3,2,1,1,1,2
440254,499_14_04,LATVIA,20350,11,rolands smits,1,0,1,0,0,0,0,0,1,0,0,0,0,0,0,0,0,0,1,0,0,0
440255,499_14_04,LATVIA,4604,12,kristaps janicenoks,31,1,6,16.7,0,2,0,1,4,25,1,4,25,0,3,3,1,2,4,1,0,4
440256,499_14_04,LATVIA,10585,13,janis strelnieks,32,1,6,16.7,0,2,0,1,4,25,2,2,100,0,6,6,3,0,3,1,0,5
440257,499_14_04,LATVIA,1002,14,kaspars berzins,31,5,13,38.5,3,9,33.3,2,4,50,2,2,100,3,6,9,0,3,0,1,0,14
440258,499_14_04,LATVIA,29525,21,aigars skele,1,0,0,0,0,0,0,0,0,0,0,0,0,0,0,0,0,1,0,0,0,0
440259,499_14_04,LATVIA,5721,30,ronalds zakis,10,3,5,60,3,5,60,0,0,0,2,4,50,1,2,3,0,2,0,0,1,8
440260,499_14_04,LATVIA,15602,33,martins meiers,9,0,0,0,0,0,0,0,0,0,0,0,0,0,2,2,1,3,0,0,0,0
440261,499_14_04,LATVIA,0,TOTALS,LATVIA,200,18,51,35.3,8,26,30.8,10,25,40,16,23,69.6,8,30,38,9,22,14,5,3,62
440262,499_14_05,ICELAND,24208,4,axel karason,1,0,0,0,0,0,0,0,0,0,0,0,0,0,0,0,0,0,0,0,0,0
440263,499_14_05,ICELAND,13211,5,haukur palsson,37,9,14,64.3,7,10,70,2,4,50,4,4,100,5,4,9,4,3,1,3,1,24
440264,499_14_05,ICELAND,21997,6,elvar mar fridriksson,1,0,0,0,0,0,0,0,0,0,0,0,0,0,0,0,0,0,0,0,0,0
440265,499_14_05,ICELAND,2760,7,sigurdur gunnar thorsteinsson,0,0,0,0,0,0,0,0,0,0,0,0,0,0,0,0,0,0,0,0,0,0
440266,499_14_05,ICELAND,4841,8,hlynur baeringsson,39,5,12,41.7,4,6,66.7,1,6,16.7,3,5,60,3,12,15,0,4,1,0,1,14
440267,499_14_05,ICELAND,19926,9,martin hermannsson,29,10,14,71.4,10,13,76.9,0,1,0,2,2,100,1,1,2,1,4,1,0,1,22
440268,499_14_05,ICELAND,4840,10,helgi mar magnusson,3,0,0,0,0,0,0,0,0,0,0,0,0,0,0,0,0,0,0,0,0,0
440269,499_14_05,ICELAND,4839,11,sigurdur thorvaldsson,1,0,0,0,0,0,0,0,0,0,0,0,0,0,0,0,0,0,0,0,0,0
440270,499_14_05,ICELAND,15700,12,ragnar agust nathanaelsson,1,0,0,0,0,0,0,0,0,0,0,0,0,0,0,0,0,0,0,0,0,0
440271,499_14_05,ICELAND,2764,13,hordur vilhjalmsson,33,3,12,25,3,9,33.3,0,3,0,0,0,0,0,2,2,2,5,3,0,0,6
440272,499_14_05,ICELAND,4980,14,logi gunnarsson,19,4,7,57.1,2,3,66.7,2,4,50,0,0,0,0,0,0,2,4,0,0,0,10
440273,499_14_05,ICELAND,2071,15,pavel ermolinskij,38,3,13,23.1,2,8,25,1,5,20,0,0,0,0,3,3,14,3,3,2,1,7
440274,499_14_05,ICELAND,0,TOTALS,ICELAND,200,34,72,47.2,28,49,57.1,6,23,26.1,9,11,81.8,11,24,35,23,23,9,5,4,83
440275,499_14_05,GREAT BRITAIN,805,4,kieron achara,21,4,7,57.1,4,7,57.1,0,0,0,8,8,100,2,1,3,0,2,2,0,0,16
440276,499_14_05,GREAT BRITAIN,5821,5,ashley hamilton,4,0,1,0,0,1,0,0,0,0,0,0,0,0,0,0,0,1,0,0,0,0
440277,499_14_05,GREAT BRITAIN,6383,6,devan bailey,18,0,1,0,0,1,0,0,0,0,0,0,0,0,1,1,2,1,1,0,0,0
440278,499_14_05,GREAT BRITAIN,13115,7,devon van oostrum,29,5,14,35.7,4,12,33.3,1,2,50,2,6,33.3,0,6,6,4,1,2,1,0,13
440279,499_14_05,GREAT BRITAIN,10185,8,andrew sullivan,31,2,2,100,1,1,100,1,1,100,0,0,0,3,6,9,3,2,0,0,2,5
440280,499_14_05,GREAT BRITAIN,12429,9,gareth murray,21,2,3,66.7,0,1,0,2,2,100,0,0,0,0,2,2,1,1,0,2,1,6
440281,499_14_05,GREAT BRITAIN,1984,10,dan clark,27,9,17,52.9,7,11,63.6,2,6,33.3,0,0,0,2,6,8,1,3,6,1,3,20
440282,499_14_05,GREAT BRITAIN,15538,12,myles edward sinclair hesson,24,2,7,28.6,2,5,40,0,2,0,2,5,40,1,3,4,2,3,2,1,0,6
440283,499_14_05,GREAT BRITAIN,2833,13,matt bryan-amaning,0,0,0,0,0,0,0,0,0,0,0,0,0,0,0,0,0,0,0,0,0,0
440284,499_14_05,GREAT BRITAIN,10192,14,eric boateng,3,0,0,0,0,0,0,0,0,0,0,0,0,1,0,1,0,2,1,0,0,0
440285,499_14_05,GREAT BRITAIN,19759,15,kyle johnson,23,0,5,0,0,4,0,0,1,0,4,4,100,1,3,4,1,2,1,0,0,4
440286,499_14_05,GREAT BRITAIN,12534,24,ben mockford,0,0,0,0,0,0,0,0,0,0,0,0,0,0,0,0,0,0,0,0,0,0
440287,499_14_05,GREAT BRITAIN,0,TOTALS,GREAT BRITAIN,200,24,57,42.1,18,43,41.9,6,14,42.9,16,23,69.6,11,28,39,14,18,15,5,6,70
440288,499_14_06,ISRAEL,1680,4,nitzan yehuda hanochi,0,0,0,0,0,0,0,0,0,0,0,0,0,0,0,0,0,0,0,0,0,0
440289,499_14_06,ISRAEL,4794,5,afik nissim,0,0,0,0,0,0,0,0,0,0,0,0,0,0,0,0,0,0,0,0,0,0
440290,499_14_06,ISRAEL,1022,6,raviv guy limonad,27,4,11,36.4,3,9,33.3,1,2,50,2,2,100,4,1,5,4,2,3,0,0,11
440291,499_14_06,ISRAEL,2522,7,gal mekel,26,7,10,70,7,9,77.8,0,1,0,5,6,83.3,1,2,3,6,5,3,1,0,19
440292,499_14_06,ISRAEL,1023,8,lior eliyahu,16,3,6,50,3,6,50,0,0,0,0,0,0,0,2,2,0,3,0,0,0,6
440293,499_14_06,ISRAEL,1933,9,omri casspi,42,9,16,56.2,7,13,53.8,2,3,66.7,8,11,72.7,0,10,10,5,4,3,2,0,28
440294,499_14_06,ISRAEL,10164,10,guy pnini,35,3,10,30,2,5,40,1,5,20,3,6,50,1,0,1,5,3,0,3,0,10
440295,499_14_06,ISRAEL,1019,12,yotam halperin,37,4,7,57.1,3,4,75,1,3,33.3,4,4,100,0,4,4,1,3,1,2,1,13
440296,499_14_06,ISRAEL,5780,13,elishay kadir,1,0,0,0,0,0,0,0,0,0,0,0,0,0,0,0,0,0,0,0,0,0
440297,499_14_06,ISRAEL,4620,14,yaniv green,9,1,2,50,1,2,50,0,0,0,0,0,0,0,0,0,0,1,0,0,1,2
440298,499_14_06,ISRAEL,29526,15,dor anthony naheem fischer,33,4,6,66.7,4,6,66.7,0,0,0,0,0,0,1,3,4,1,3,0,2,3,8
440299,499_14_06,ISRAEL,24229,21,dagan yivzori,0,0,0,0,0,0,0,0,0,0,0,0,0,0,0,0,0,0,0,0,0,0
440300,499_14_06,ISRAEL,0,TOTALS,ISRAEL,225,35,68,51.5,30,54,55.6,5,14,35.7,22,29,75.9,7,24,31,22,24,10,10,5,97
440301,499_14_06,MONTENEGRO,12640,5,vladimir mihailovic,25,3,4,75,1,1,100,2,3,66.7,1,2,50,0,1,1,2,5,2,0,1,9
440302,499_14_06,MONTENEGRO,10453,6,suad sehovic,22,2,2,100,0,0,0,2,2,100,0,0,0,0,3,3,0,5,0,0,0,6
440303,499_14_06,MONTENEGRO,19707,7,vladimir dragicevic,29,8,15,53.3,8,15,53.3,0,0,0,0,0,0,2,4,6,0,2,0,0,0,16
440304,499_14_06,MONTENEGRO,10457,8,sead sehovic,25,4,10,40,2,6,33.3,2,4,50,5,6,83.3,2,4,6,3,2,2,3,0,15
440305,499_14_06,MONTENEGRO,1863,9,vladimir golubovic,16,4,7,57.1,4,7,57.1,0,0,0,2,3,66.7,2,2,4,0,2,1,0,0,10
440306,499_14_06,MONTENEGRO,24211,10,taylor campbell rochestie,31,6,9,66.7,5,6,83.3,1,3,33.3,4,4,100,0,0,0,9,4,6,0,0,17
440307,499_14_06,MONTENEGRO,19706,11,milko bjelica,22,5,8,62.5,5,7,71.4,0,1,0,0,0,0,1,4,5,1,4,3,0,0,10
440308,499_14_06,MONTENEGRO,11120,12,nemanja radovic,23,3,7,42.9,2,4,50,1,3,33.3,1,3,33.3,1,3,4,1,4,1,2,0,8
440309,499_14_06,MONTENEGRO,1723,14,ivan maras,0,0,0,0,0,0,0,0,0,0,0,0,0,0,0,0,0,0,0,0,0,0
440310,499_14_06,MONTENEGRO,10455,15,aleksa popovic,18,0,2,0,0,2,0,0,0,0,0,0,0,0,3,3,1,0,2,0,0,0
440311,499_14_06,MONTENEGRO,15868,20,nikola ivanovic,14,2,3,66.7,1,1,100,1,2,50,4,4,100,0,0,0,0,1,0,0,0,9
440312,499_14_06,MONTENEGRO,15355,22,milos borisov,0,0,0,0,0,0,0,0,0,0,0,0,0,0,0,0,0,0,0,0,0,0
440313,499_14_06,MONTENEGRO,0,TOTALS,MONTENEGRO,225,37,67,55.2,28,49,57.1,9,18,50,17,22,77.3,9,26,35,17,29,17,5,1,100
440314,499_14_07,GEORGIA,8378,4,nika metreveli,5,0,1,0,0,1,0,0,0,0,0,0,0,2,1,3,0,2,1,0,0,0
440315,499_14_07,GEORGIA,4919,7,zaza pachulia,29,7,14,50,7,14,50,0,0,0,5,7,71.4,5,3,8,2,4,1,2,2,19
440316,499_14_07,GEORGIA,1690,8,george tsintsadze,37,4,11,36.4,3,6,50,1,5,20,1,2,50,0,2,2,10,1,1,4,0,10
440317,499_14_07,GEORGIA,15684,10,duda sanadze,19,3,5,60,1,3,33.3,2,2,100,2,3,66.7,0,1,1,3,3,0,2,0,10
440318,499_14_07,GEORGIA,12467,12,levan patsatsia,26,3,5,60,2,2,100,1,3,33.3,0,0,0,0,3,3,2,4,1,1,0,7
440319,499_14_07,GEORGIA,1699,13,viktor sanikidze,31,2,8,25,2,6,33.3,0,2,0,4,6,66.7,2,10,12,0,1,3,0,0,8
440320,499_14_07,GEORGIA,16022,15,beka burjanadze,24,2,6,33.3,2,4,50,0,2,0,2,2,100,3,0,3,0,1,1,1,0,6
440321,499_14_07,GEORGIA,8382,22,george sharabidze,0,0,0,0,0,0,0,0,0,0,0,0,0,0,0,0,0,0,0,0,0,0
440322,499_14_07,GEORGIA,11036,23,tornike shengelia,21,4,11,36.4,4,11,36.4,0,0,0,2,2,100,3,2,5,1,2,2,1,0,10
440323,499_14_07,GEORGIA,1693,25,besik lezhava,6,1,1,100,0,0,0,1,1,100,0,0,0,0,3,3,0,0,1,0,0,3
440324,499_14_07,GEORGIA,2604,31,beka tsivtsivadze,3,0,0,0,0,0,0,0,0,0,0,0,0,0,0,0,0,1,0,0,0,0
440325,499_14_07,GEORGIA,7837,33,mikhail chochua,0,0,0,0,0,0,0,0,0,0,0,0,0,0,0,0,0,0,0,0,0,0
440326,499_14_07,GEORGIA,0,TOTALS,GEORGIA,200,26,62,41.9,21,47,44.7,5,15,33.3,16,22,72.7,16,25,41,18,19,12,11,2,73
440327,499_14_07,CZECH REPUBLIC,29502,4,patrik auda,27,7,11,63.6,7,11,63.6,0,0,0,4,5,80,1,2,3,1,1,4,1,0,18
440328,499_14_07,CZECH REPUBLIC,12522,5,tomas pomikalek,0,0,0,0,0,0,0,0,0,0,0,0,0,0,0,0,0,0,0,0,0,0
440329,499_14_07,CZECH REPUBLIC,5478,6,pavel pumprla,16,1,3,33.3,1,1,100,0,2,0,0,0,0,2,0,2,2,3,4,0,0,2
440330,499_14_07,CZECH REPUBLIC,10700,7,vojtech hruban,22,3,6,50,2,3,66.7,1,3,33.3,1,1,100,0,3,3,1,2,0,0,2,8
440331,499_14_07,CZECH REPUBLIC,8325,8,tomas satoransky,38,1,6,16.7,1,3,33.3,0,3,0,0,0,0,2,3,5,8,2,3,1,0,2
440332,499_14_07,CZECH REPUBLIC,4774,9,jiri welsch,24,2,10,20,2,8,25,0,2,0,1,1,100,1,1,2,3,2,1,1,0,5
440333,499_14_07,CZECH REPUBLIC,10702,10,lukas palyza,9,0,5,0,0,1,0,0,4,0,0,0,0,1,1,2,0,1,0,1,0,0
440334,499_14_07,CZECH REPUBLIC,4775,11,lubos barton,26,6,15,40,2,5,40,4,10,40,0,0,0,1,4,5,0,2,1,1,1,16
440335,499_14_07,CZECH REPUBLIC,12850,12,ondrej balvin,22,4,6,66.7,4,6,66.7,0,0,0,1,1,100,3,4,7,0,3,1,0,1,9
440336,499_14_07,CZECH REPUBLIC,10484,13,jakub sirina,5,0,0,0,0,0,0,0,0,0,0,0,0,0,0,0,2,0,0,0,0,0
440337,499_14_07,CZECH REPUBLIC,7823,14,kamil svrdlik,11,0,1,0,0,1,0,0,0,0,2,2,100,0,1,1,0,4,0,1,0,2
440338,499_14_07,CZECH REPUBLIC,19726,21,ales chan,1,0,0,0,0,0,0,0,0,0,0,0,0,0,0,0,0,0,0,0,0,0
440339,499_14_07,CZECH REPUBLIC,0,TOTALS,CZECH REPUBLIC,200,24,63,38.1,19,39,48.7,5,24,20.8,9,10,90,12,21,33,17,20,14,6,4,62
440340,499_14_08,PORTUGAL,2730,4,jose silva,23,0,6,0,0,3,0,0,3,0,0,0,0,0,2,2,0,4,2,0,0,0
440341,499_14_08,PORTUGAL,8199,5,joao soares,14,2,3,66.7,2,2,100,0,1,0,0,1,0,2,1,3,1,0,1,1,1,4
440342,499_14_08,PORTUGAL,8195,6,jose barbosa,0,0,0,0,0,0,0,0,0,0,0,0,0,0,0,0,0,0,0,0,0,0
440343,499_14_08,PORTUGAL,15697,7,carlos diogo serra ferreirinho,0,0,0,0,0,0,0,0,0,0,0,0,0,0,0,0,0,0,0,0,0,0
440344,499_14_08,PORTUGAL,10266,8,mario fernandes,26,1,8,12.5,1,3,33.3,0,5,0,0,2,0,0,5,5,3,0,5,1,0,2
440345,499_14_08,PORTUGAL,2736,10,fabio lima,24,4,7,57.1,0,1,0,4,6,66.7,0,0,0,0,1,1,0,1,0,0,0,12
440346,499_14_08,PORTUGAL,10956,11,miguel queiroz,10,0,2,0,0,1,0,0,1,0,0,0,0,0,0,0,0,1,1,0,0,0
440347,499_14_08,PORTUGAL,8200,12,joao guerreiro,7,0,3,0,0,3,0,0,0,0,0,0,0,1,0,1,0,2,1,0,0,0
440348,499_14_08,PORTUGAL,7851,13,joao balseiro,24,0,5,0,0,3,0,0,2,0,4,4,100,1,1,2,0,3,0,1,0,4
440349,499_14_08,PORTUGAL,2732,14,pedro pinto,14,2,3,66.7,2,3,66.7,0,0,0,0,0,0,0,0,0,2,2,1,0,0,4
440350,499_14_08,PORTUGAL,2918,21,claudio fonseca,28,2,7,28.6,2,7,28.6,0,0,0,0,0,0,0,2,2,0,3,2,0,2,4
440351,499_14_08,PORTUGAL,29527,22,arnette hallman,31,4,8,50,4,5,80,0,3,0,0,0,0,2,7,9,0,2,2,2,0,8
440352,499_14_08,PORTUGAL,0,TOTALS,PORTUGAL,200,15,52,28.8,11,31,35.5,4,21,19,4,7,57.1,6,19,25,6,18,15,5,3,38
440353,499_14_08,HUNGARY,4537,5,gabor denes,16,1,4,25,0,2,0,1,2,50,0,0,0,1,1,2,0,2,1,0,0,3
440354,499_14_08,HUNGARY,12503,6,akos keller,26,7,9,77.8,7,9,77.8,0,0,0,1,2,50,6,7,13,1,4,3,0,2,15
440355,499_14_08,HUNGARY,1125,7,krisztian wittmann,32,1,10,10,0,4,0,1,6,16.7,4,4,100,0,3,3,1,2,1,1,0,7
440356,499_14_08,HUNGARY,8415,9,david vojvoda,32,6,17,35.3,3,9,33.3,3,8,37.5,5,5,100,1,8,9,0,2,4,3,0,20
440357,499_14_08,HUNGARY,2743,10,zoltan supola,0,0,0,0,0,0,0,0,0,0,0,0,0,0,0,0,0,0,0,0,0,0
440358,499_14_08,HUNGARY,1942,11,norbert toth,24,2,4,50,2,4,50,0,0,0,0,0,0,2,2,4,1,2,0,0,0,4
440359,499_14_08,HUNGARY,2750,12,milan csorvasi,1,0,0,0,0,0,0,0,0,0,0,0,0,0,0,0,0,0,0,0,0,0
440360,499_14_08,HUNGARY,2751,13,adam toth,13,1,3,33.3,1,3,33.3,0,0,0,0,0,0,1,0,1,0,4,2,1,0,2
440361,499_14_08,HUNGARY,29528,14,jermaine dontay thomas,27,1,5,20,1,2,50,0,3,0,0,0,0,0,5,5,5,3,1,0,0,2
440362,499_14_08,HUNGARY,1123,15,csaba ferencz,19,1,3,33.3,0,1,0,1,2,50,0,0,0,0,1,1,0,1,1,0,0,3
440363,499_14_08,HUNGARY,8051,21,andras rujak,10,1,2,50,1,2,50,0,0,0,0,0,0,0,0,0,0,2,1,1,0,2
440364,499_14_08,HUNGARY,11148,22,janos eilingsfeld,0,0,0,0,0,0,0,0,0,0,0,0,0,0,0,0,0,0,0,0,0,0
440365,499_14_08,HUNGARY,0,TOTALS,HUNGARY,200,21,57,36.8,15,36,41.7,6,21,28.6,10,11,90.9,11,27,38,8,22,14,6,2,58
440366,499_14_09,POLAND,5694,5,aaron cel,28,4,9,44.4,2,2,100,2,7,28.6,0,0,0,5,5,10,2,2,1,0,0,10
440367,499_14_09,POLAND,4799,6,robert jozef skibniewski,24,3,6,50,2,3,66.7,1,3,33.3,0,0,0,0,1,1,5,3,1,0,0,7
440368,499_14_09,POLAND,7833,7,damian kulig,8,1,4,25,1,2,50,0,2,0,1,2,50,0,1,1,1,1,1,0,1,3
440369,499_14_09,POLAND,24194,8,przemyslaw zamojski,34,2,8,25,1,2,50,1,6,16.7,0,0,0,0,2,2,1,2,2,1,0,5
440370,499_14_09,POLAND,15981,9,mateusz ponitka,25,5,8,62.5,5,5,100,0,3,0,6,8,75,1,4,5,2,2,2,2,2,16
440371,499_14_09,POLAND,4804,10,szymon pawel szewczyk,10,0,2,0,0,1,0,0,1,0,0,0,0,0,2,2,0,1,0,0,0,0
440372,499_14_09,POLAND,12920,11,przemyslaw karnowski,20,4,7,57.1,4,7,57.1,0,0,0,0,1,0,2,4,6,1,3,0,0,1,8
440373,499_14_09,POLAND,8034,12,adam waczynski,32,6,10,60,2,5,40,4,5,80,3,3,100,0,4,4,2,3,4,0,0,19
440374,499_14_09,POLAND,19694,14,adam hrycaniuk,14,0,3,0,0,3,0,0,0,0,0,0,0,1,0,1,1,4,1,0,0,0
440375,499_14_09,POLAND,6190,15,kamil jacek laczynski,1,0,1,0,0,0,0,0,1,0,0,0,0,0,0,0,0,0,0,0,0,0
440376,499_14_09,POLAND,15983,21,tomasz gielo,3,0,2,0,0,1,0,0,1,0,0,0,0,0,0,0,0,2,0,0,0,0
440377,499_14_09,POLAND,15977,23,michal michalak,0,0,0,0,0,0,0,0,0,0,0,0,0,0,0,0,0,0,0,0,0,0
440378,499_14_09,POLAND,0,TOTALS,POLAND,200,25,60,41.7,17,31,54.8,8,29,27.6,10,14,71.4,10,24,34,15,23,12,3,4,68
440379,499_14_09,GERMANY,8244,7,akeem vargas,10,1,3,33.3,1,3,33.3,0,0,0,0,0,0,0,2,2,0,1,0,0,0,2
440380,499_14_09,GERMANY,15385,8,heiko schaffartzik,24,4,7,57.1,1,3,33.3,3,4,75,5,5,100,1,2,3,1,2,3,1,0,16
440381,499_14_09,GERMANY,10446,9,karsten tadda,21,1,2,50,1,2,50,0,0,0,0,0,0,0,3,3,2,0,0,0,0,2
440382,499_14_09,GERMANY,5747,10,lucca staiger,20,0,2,0,0,1,0,0,1,0,0,0,0,0,2,2,0,2,0,0,0,0
440383,499_14_09,GERMANY,6326,12,robin benzing,17,4,9,44.4,4,7,57.1,0,2,0,0,1,0,1,2,3,0,4,2,2,0,8
440384,499_14_09,GERMANY,15492,13,bastian doreth,0,0,0,0,0,0,0,0,0,0,0,0,0,0,0,0,0,0,0,0,0,0
440385,499_14_09,GERMANY,15493,14,andreas seiferth,10,0,0,0,0,0,0,0,0,0,0,0,0,0,0,0,1,2,1,0,0,0
440386,499_14_09,GERMANY,6324,20,elias harris,20,2,7,28.6,2,5,40,0,2,0,5,6,83.3,0,1,1,0,3,1,0,0,9
440387,499_14_09,GERMANY,19866,21,daniel theis,4,1,1,100,1,1,100,0,0,0,0,2,0,0,0,0,0,0,0,0,0,2
440388,499_14_09,GERMANY,19990,22,dennis schroder,29,6,14,42.9,4,9,44.4,2,5,40,2,2,100,0,3,3,5,2,5,0,0,16
440389,499_14_09,GERMANY,29529,24,maximilian kleber,20,2,4,50,2,3,66.7,0,1,0,2,3,66.7,3,5,8,1,1,1,1,2,6
440390,499_14_09,GERMANY,12608,33,maik hendrik zirbes,26,3,8,37.5,3,8,37.5,0,0,0,0,0,0,4,5,9,0,3,0,0,0,6
440391,499_14_09,GERMANY,0,TOTALS,GERMANY,200,24,57,42.1,19,42,45.2,5,15,33.3,14,19,73.7,12,27,39,10,20,13,4,2,67
440392,499_14_10,AUSTRIA,2103,5,thomas schreiner,28,6,8,75,2,2,100,4,6,66.7,0,0,0,1,2,3,1,3,2,2,1,16
440393,499_14_10,AUSTRIA,29530,8,enis murati,22,5,9,55.6,4,7,57.1,1,2,50,1,1,100,1,3,4,0,1,3,1,0,12
440394,499_14_10,AUSTRIA,16191,14,jozo rados,10,2,2,100,2,2,100,0,0,0,1,3,33.3,0,2,2,0,2,3,0,1,5
440395,499_14_10,AUSTRIA,8395,15,david hasenburger,5,0,0,0,0,0,0,0,0,0,2,2,100,1,0,1,1,0,0,0,0,2
440396,499_14_10,AUSTRIA,8392,20,romed vieider,22,3,7,42.9,0,0,0,3,7,42.9,0,0,0,0,1,1,1,0,0,1,0,9
440397,499_14_10,AUSTRIA,8396,24,rasid mahalbasic,27,7,7,100,7,7,100,0,0,0,0,0,0,3,7,10,2,2,2,2,0,14
440398,499_14_10,AUSTRIA,8386,25,jesse nii l. seilern und aspang,3,0,1,0,0,0,0,0,1,0,0,0,0,0,0,0,0,0,0,1,0,0
440399,499_14_10,AUSTRIA,6415,34,moritz lanegger,22,0,3,0,0,0,0,0,3,0,1,2,50,1,2,3,4,2,2,2,0,1
440400,499_14_10,AUSTRIA,12529,35,sebastian koch,11,0,4,0,0,2,0,0,2,0,2,2,100,0,3,3,0,1,0,1,0,2
440401,499_14_10,AUSTRIA,13271,41,maximilian hopfgartner,3,0,1,0,0,1,0,0,0,0,0,0,0,0,0,0,0,0,0,0,0,0
440402,499_14_10,AUSTRIA,11250,42,thomas klepeisz,25,4,11,36.4,2,4,50,2,7,28.6,1,2,50,0,2,2,5,3,1,4,0,11
440403,499_14_10,AUSTRIA,15717,43,anton maresch,22,5,7,71.4,4,6,66.7,1,1,100,1,2,50,1,2,3,2,2,2,2,0,12
440404,499_14_10,AUSTRIA,0,TOTALS,AUSTRIA,200,32,60,53.3,21,31,67.7,11,29,37.9,9,14,64.3,9,24,33,16,16,17,16,2,84
440405,499_14_10,LUXEMBOURG,5011,4,tom schumacher,23,6,8,75,1,2,50,5,6,83.3,2,3,66.7,0,2,2,2,4,4,0,0,19
440406,499_14_10,LUXEMBOURG,5918,5,pitt koster,16,0,1,0,0,0,0,0,1,0,0,0,0,2,0,2,1,1,2,0,0,0
440407,499_14_10,LUXEMBOURG,2966,6,raul leandro birenbaum,19,1,4,25,0,2,0,1,2,50,0,0,0,0,4,4,4,1,0,0,0,3
440408,499_14_10,LUXEMBOURG,8344,8,christopher c. g. jones,18,2,4,50,1,1,100,1,3,33.3,3,4,75,1,1,2,0,2,2,0,0,8
440409,499_14_10,LUXEMBOURG,19727,10,patrick arbaut,23,1,3,33.3,0,1,0,1,2,50,0,0,0,1,3,4,1,3,3,0,0,3
440410,499_14_10,LUXEMBOURG,13285,11,bob melcher,13,2,6,33.3,1,3,33.3,1,3,33.3,0,0,0,0,0,0,0,0,0,0,0,5
440411,499_14_10,LUXEMBOURG,19728,12,alexandre rodenbourg,27,3,6,50,3,4,75,0,2,0,0,0,0,0,3,3,0,2,3,1,0,6
440412,499_14_10,LUXEMBOURG,8340,22,jean nicolas c. kox,19,2,3,66.7,1,1,100,1,2,50,0,0,0,0,0,0,0,2,1,1,0,5
440413,499_14_10,LUXEMBOURG,1283,23,jairo emanuel delgado ferreira,29,7,16,43.8,6,10,60,1,6,16.7,2,2,100,0,3,3,3,1,4,4,0,17
440414,499_14_10,LUXEMBOURG,17901,24,thomas grun,0,0,0,0,0,0,0,0,0,0,0,0,0,0,0,0,0,0,0,0,0,0
440415,499_14_10,LUXEMBOURG,29517,30,dominique benseghir,0,0,0,0,0,0,0,0,0,0,0,0,0,0,0,0,0,0,0,0,0,0
440416,499_14_10,LUXEMBOURG,13176,31,alex laurent,13,3,5,60,1,3,33.3,2,2,100,2,4,50,1,1,2,1,2,0,0,0,10
440417,499_14_10,LUXEMBOURG,0,TOTALS,LUXEMBOURG,200,27,56,48.2,14,27,51.9,13,29,44.8,9,13,69.2,7,20,27,12,18,21,6,0,76
440418,499_14_11,BULGARIA,8350,7,hristo zahariev,11,1,4,25,0,2,0,1,2,50,0,0,0,0,0,0,1,0,1,0,0,3
440419,499_14_11,BULGARIA,5591,8,hristo nikolov,19,0,2,0,0,0,0,0,2,0,0,0,0,2,4,6,1,2,2,2,0,0
440420,499_14_11,BULGARIA,8347,10,bozhidar avramov,26,5,14,35.7,1,5,20,4,9,44.4,3,5,60,0,3,3,2,4,0,2,1,17
440421,499_14_11,BULGARIA,8346,12,aleksandar georgiev,10,1,3,33.3,0,0,0,1,3,33.3,0,0,0,0,2,2,0,1,0,1,0,3
440422,499_14_11,BULGARIA,1675,13,asen velikov,2,0,0,0,0,0,0,0,0,0,0,0,0,0,0,0,0,0,0,0,0,0
440423,499_14_11,BULGARIA,2852,14,chavdar kostov,23,3,5,60,1,1,100,2,4,50,0,0,0,1,2,3,0,1,5,0,0,8
440424,499_14_11,BULGARIA,10589,15,stanislav vaklinov,6,0,0,0,0,0,0,0,0,0,0,0,0,0,0,0,0,1,0,0,0,0
440425,499_14_11,BULGARIA,5588,21,nikolay varbanov,24,1,3,33.3,1,3,33.3,0,0,0,3,6,50,2,3,5,0,2,1,1,0,5
440426,499_14_11,BULGARIA,13084,22,pavlin ivanov,10,1,2,50,0,1,0,1,1,100,0,0,0,0,1,1,1,2,1,0,0,3
440427,499_14_11,BULGARIA,15604,23,stanimir marinov,29,2,12,16.7,2,7,28.6,0,5,0,1,2,50,0,4,4,3,1,2,1,1,5
440428,499_14_11,BULGARIA,17555,41,aleksandar vezenkov,31,4,11,36.4,3,5,60,1,6,16.7,0,0,0,3,2,5,3,2,3,0,0,9
440429,499_14_11,BULGARIA,13088,50,dimitar dimitrov,9,0,1,0,0,1,0,0,0,0,0,0,0,0,1,1,1,2,0,0,0,0
440430,499_14_11,BULGARIA,0,TOTALS,BULGARIA,200,18,57,31.6,8,25,32,10,32,31.2,7,13,53.8,8,24,32,12,18,15,7,2,53
440431,499_14_11,NETHERLANDS,10202,4,arvin slagter,26,5,10,50,2,4,50,3,6,50,5,7,71.4,0,1,1,3,2,2,0,0,18
440432,499_14_11,NETHERLANDS,15661,5,leon williams,24,0,2,0,0,2,0,0,0,0,0,0,0,1,0,1,1,1,2,0,0,0
440433,499_14_11,NETHERLANDS,24213,6,worthy de jong,26,3,8,37.5,3,7,42.9,0,1,0,2,5,40,2,6,8,3,3,6,3,0,8
440434,499_14_11,NETHERLANDS,22012,7,julius clay van sauers,0,0,0,0,0,0,0,0,0,0,0,0,0,0,0,0,0,0,0,0,0,0
440435,499_14_11,NETHERLANDS,13250,8,dexter cornelis hope,16,0,2,0,0,0,0,0,2,0,0,0,0,1,4,5,1,2,0,1,0,0
440436,499_14_11,NETHERLANDS,10671,9,mohamed kherrazi,20,3,5,60,3,4,75,0,1,0,0,0,0,1,3,4,1,5,1,1,1,6
440437,499_14_11,NETHERLANDS,12501,10,ralf de pagter,23,2,4,50,2,4,50,0,0,0,2,2,100,2,4,6,1,1,1,1,0,6
440438,499_14_11,NETHERLANDS,6397,11,thomas koenis,17,2,8,25,2,8,25,0,0,0,0,0,0,2,2,4,0,1,1,0,0,4
440439,499_14_11,NETHERLANDS,16075,12,shane gerrit hammink,2,0,0,0,0,0,0,0,0,0,0,0,0,0,0,0,0,0,1,0,0,0
440440,499_14_11,NETHERLANDS,20078,13,kevin bleeker,8,0,2,0,0,0,0,0,2,0,0,0,0,1,2,3,1,1,0,0,0,0
440441,499_14_11,NETHERLANDS,5812,14,nick oudendag,19,6,9,66.7,6,9,66.7,0,0,0,1,2,50,3,6,9,0,2,2,1,0,13
440442,499_14_11,NETHERLANDS,2871,21,roeland schaftenaar,19,3,9,33.3,2,8,25,1,1,100,0,0,0,1,5,6,3,1,0,0,0,7
440443,499_14_11,NETHERLANDS,0,TOTALS,NETHERLANDS,200,24,59,40.7,20,46,43.5,4,13,30.8,10,16,62.5,14,33,47,14,19,17,7,1,62
440444,499_14_12,MKD,6304,4,ivica dimchevski,4,0,0,0,0,0,0,0,0,0,0,0,0,0,1,1,0,1,0,0,0,0
440445,499_14_12,MKD,22445,5,andrej magdevski,7,0,0,0,0,0,0,0,0,0,0,0,0,0,1,1,1,1,1,0,0,0
440446,499_14_12,MKD,7810,6,darko sokolov,27,3,5,60,0,2,0,3,3,100,0,2,0,0,1,1,1,2,2,0,0,9
440447,499_14_12,MKD,2709,7,aleksandar kostoski,27,6,9,66.7,4,4,100,2,5,40,0,0,0,0,7,7,4,1,3,1,0,14
440448,499_14_12,MKD,5892,8,vojdan stojanovski,30,4,12,33.3,3,6,50,1,6,16.7,7,10,70,1,1,2,2,4,1,0,0,16
440449,499_14_12,MKD,5892,9,damjan stojanovski,7,0,2,0,0,0,0,0,2,0,0,0,0,2,1,3,0,1,1,0,0,0
440450,499_14_12,MKD,6300,10,marko simonovski,34,3,6,50,0,1,0,3,5,60,0,0,0,2,1,3,1,2,2,0,0,9
440451,499_14_12,MKD,6306,11,vladimir brckov,0,0,0,0,0,0,0,0,0,0,0,0,0,0,0,0,0,0,0,0,0,0
440452,499_14_12,MKD,2714,12,bojan trajkovski,31,6,15,40,4,8,50,2,7,28.6,2,2,100,1,2,3,3,4,2,3,2,16
440453,499_14_12,MKD,11275,13,stojan gjuroski,24,2,4,50,2,2,100,0,2,0,0,0,0,2,0,2,1,1,1,0,1,4
440454,499_14_12,MKD,2715,14,marjan janeski,6,0,1,0,0,1,0,0,0,0,0,0,0,0,0,0,0,1,2,0,0,0
440455,499_14_12,MKD,29507,15,venard richard hendriks,29,4,7,57.1,4,7,57.1,0,0,0,0,0,0,2,9,11,0,3,0,0,5,8
440456,499_14_12,MKD,0,TOTALS,MKD,225,28,61,45.9,17,31,54.8,11,30,36.7,9,14,64.3,12,27,39,13,21,15,4,8,76
440457,499_14_12,BELGIUM,10156,4,lionel georges m bosco,24,4,9,44.4,3,5,60,1,4,25,2,2,100,2,1,3,1,2,1,1,0,11
440458,499_14_12,BELGIUM,12601,5,alexandre libert,0,0,0,0,0,0,0,0,0,0,0,0,0,0,0,0,0,0,0,0,0,0
440459,499_14_12,BELGIUM,19894,6,kevin tumba,6,0,1,0,0,1,0,0,0,0,0,0,0,1,2,3,0,1,1,0,0,0
440460,499_14_12,BELGIUM,4548,7,axel hervelle,35,7,11,63.6,6,10,60,1,1,100,2,3,66.7,0,4,4,5,3,2,2,1,17
440461,499_14_12,BELGIUM,6157,8,jean-marc mwema,22,2,6,33.3,1,3,33.3,1,3,33.3,0,0,0,0,2,2,0,2,0,0,0,5
440462,499_14_12,BELGIUM,10706,9,olivier troisfontaines,0,0,0,0,0,0,0,0,0,0,0,0,0,0,0,0,0,0,0,0,0,0
440463,499_14_12,BELGIUM,13030,10,loic robin b. schwartz,0,0,0,0,0,0,0,0,0,0,0,0,0,0,0,0,0,0,0,0,0,0
440464,499_14_12,BELGIUM,19709,11,guy muya,32,3,10,30,2,6,33.3,1,4,25,2,2,100,0,4,4,4,1,1,2,0,9
440465,499_14_12,BELGIUM,24196,12,wen-boss mukubu,27,0,6,0,0,3,0,0,3,0,3,4,75,2,1,3,1,3,1,2,0,3
440466,499_14_12,BELGIUM,11181,13,pierre-antoine gillet,25,4,9,44.4,2,4,50,2,5,40,0,0,0,1,3,4,0,2,0,0,0,10
440467,499_14_12,BELGIUM,10498,14,maxime de zeeuw,24,3,10,30,2,4,50,1,6,16.7,4,4,100,2,1,3,1,4,0,0,1,11
440468,499_14_12,BELGIUM,29508,24,matt lojeski,31,2,5,40,2,2,100,0,3,0,3,3,100,1,2,3,3,3,2,1,0,7
440469,499_14_12,BELGIUM,0,TOTALS,BELGIUM,225,25,67,37.3,18,38,47.4,7,29,24.1,16,18,88.9,14,22,36,15,21,10,8,2,73
440470,499_14_13,CZECH REPUBLIC,29502,4,patrik auda,8,2,3,66.7,2,3,66.7,0,0,0,0,2,0,2,2,4,1,0,0,1,0,4
440471,499_14_13,CZECH REPUBLIC,12522,5,tomas pomikalek,16,2,7,28.6,2,6,33.3,0,1,0,1,2,50,2,5,7,1,1,1,1,0,5
440472,499_14_13,CZECH REPUBLIC,5478,6,pavel pumprla,18,3,5,60,3,4,75,0,1,0,3,3,100,1,8,9,2,0,0,0,1,9
440473,499_14_13,CZECH REPUBLIC,10700,7,vojtech hruban,22,3,8,37.5,2,4,50,1,4,25,2,2,100,0,2,2,1,2,1,0,0,9
440474,499_14_13,CZECH REPUBLIC,8325,8,tomas satoransky,26,7,11,63.6,5,9,55.6,2,2,100,2,3,66.7,2,4,6,5,0,2,1,0,18
440475,499_14_13,CZECH REPUBLIC,4774,9,jiri welsch,16,2,4,50,2,4,50,0,0,0,2,2,100,1,3,4,4,2,2,0,0,6
440476,499_14_13,CZECH REPUBLIC,10702,10,lukas palyza,20,3,5,60,0,0,0,3,5,60,0,0,0,1,3,4,0,4,1,1,0,9
440477,499_14_13,CZECH REPUBLIC,4775,11,lubos barton,17,4,8,50,2,3,66.7,2,5,40,1,2,50,0,4,4,1,0,2,2,1,11
440478,499_14_13,CZECH REPUBLIC,12850,12,ondrej balvin,18,4,4,100,4,4,100,0,0,0,2,2,100,1,3,4,0,2,2,1,4,10
440479,499_14_13,CZECH REPUBLIC,10484,13,jakub sirina,20,1,2,50,1,2,50,0,0,0,3,4,75,0,2,2,1,2,4,1,0,5
440480,499_14_13,CZECH REPUBLIC,7823,14,kamil svrdlik,11,1,4,25,1,4,25,0,0,0,0,0,0,4,0,4,1,5,3,0,1,2
440481,499_14_13,CZECH REPUBLIC,19726,21,ales chan,8,0,1,0,0,1,0,0,0,0,1,2,50,1,0,1,0,1,0,0,0,1
440482,499_14_13,CZECH REPUBLIC,0,TOTALS,CZECH REPUBLIC,200,32,62,51.6,24,44,54.5,8,18,44.4,17,24,70.8,15,37,52,17,19,18,8,7,89
440483,499_14_13,PORTUGAL,2730,4,jose silva,22,3,4,75,1,1,100,2,3,66.7,3,3,100,0,0,0,2,2,1,0,1,11
440484,499_14_13,PORTUGAL,8199,5,joao soares,17,0,3,0,0,1,0,0,2,0,0,0,0,0,2,2,0,1,1,0,0,0
440485,499_14_13,PORTUGAL,8195,6,jose barbosa,10,0,2,0,0,1,0,0,1,0,0,0,0,0,1,1,0,0,1,1,0,0
440486,499_14_13,PORTUGAL,15697,7,carlos diogo serra ferreirinho,15,1,4,25,1,2,50,0,2,0,0,0,0,0,1,1,0,4,1,0,0,2
440487,499_14_13,PORTUGAL,10266,8,mario fernandes,14,3,8,37.5,2,3,66.7,1,5,20,1,2,50,0,1,1,4,3,1,0,0,8
440488,499_14_13,PORTUGAL,2736,10,fabio lima,10,1,3,33.3,1,2,50,0,1,0,0,0,0,0,0,0,0,1,1,0,0,2
440489,499_14_13,PORTUGAL,10956,11,miguel queiroz,16,0,1,0,0,0,0,0,1,0,1,2,50,0,3,3,2,4,1,1,1,1
440490,499_14_13,PORTUGAL,8200,12,joao guerreiro,16,2,5,40,2,4,50,0,1,0,1,1,100,2,3,5,0,2,1,1,0,5
440491,499_14_13,PORTUGAL,7851,13,joao balseiro,15,2,7,28.6,0,5,0,2,2,100,0,0,0,1,0,1,0,1,1,1,0,6
440492,499_14_13,PORTUGAL,2732,14,pedro pinto,16,3,10,30,1,7,14.3,2,3,66.7,1,2,50,2,0,2,0,2,1,1,0,9
440493,499_14_13,PORTUGAL,2918,21,claudio fonseca,24,4,11,36.4,4,11,36.4,0,0,0,0,0,0,0,3,3,0,1,0,0,2,8
440494,499_14_13,PORTUGAL,29527,22,arnette hallman,24,0,5,0,0,4,0,0,1,0,1,2,50,1,3,4,3,2,3,1,0,1
440495,499_14_13,PORTUGAL,0,TOTALS,PORTUGAL,200,19,63,30.2,12,41,29.3,7,22,31.8,8,12,66.7,9,18,27,11,23,14,6,4,53
440496,499_14_14,HUNGARY,4537,5,gabor denes,15,0,1,0,0,1,0,0,0,0,1,2,50,0,0,0,0,3,0,0,0,1
440497,499_14_14,HUNGARY,12503,6,akos keller,21,0,1,0,0,1,0,0,0,0,0,0,0,2,3,5,0,4,3,0,1,0
440498,499_14_14,HUNGARY,1125,7,krisztian wittmann,28,5,9,55.6,2,3,66.7,3,6,50,2,2,100,0,2,2,0,2,2,5,0,15
440499,499_14_14,HUNGARY,8415,9,david vojvoda,33,9,15,60,8,10,80,1,5,20,1,3,33.3,0,5,5,2,2,2,1,0,20
440500,499_14_14,HUNGARY,2743,10,zoltan supola,0,0,0,0,0,0,0,0,0,0,0,0,0,0,0,0,0,0,0,0,0,0
440501,499_14_14,HUNGARY,1942,11,norbert toth,25,4,5,80,0,1,0,4,4,100,0,0,0,0,2,2,3,5,4,1,0,12
440502,499_14_14,HUNGARY,2750,12,milan csorvasi,4,0,0,0,0,0,0,0,0,0,0,0,0,0,0,0,0,2,0,0,0,0
440503,499_14_14,HUNGARY,2751,13,adam toth,14,1,2,50,1,2,50,0,0,0,1,2,50,2,0,2,0,4,2,1,0,3
440504,499_14_14,HUNGARY,29528,14,jermaine dontay thomas,33,6,13,46.2,6,6,100,0,7,0,2,2,100,0,3,3,6,2,1,0,0,14
440505,499_14_14,HUNGARY,1123,15,csaba ferencz,22,3,6,50,0,2,0,3,4,75,0,0,0,0,1,1,0,4,1,1,0,9
440506,499_14_14,HUNGARY,8051,21,andras rujak,4,0,0,0,0,0,0,0,0,0,0,0,0,0,0,0,0,0,0,1,0,0
440507,499_14_14,HUNGARY,11148,22,janos eilingsfeld,0,0,0,0,0,0,0,0,0,0,0,0,0,0,0,0,0,0,0,0,0,0
440508,499_14_14,HUNGARY,0,TOTALS,HUNGARY,200,28,52,53.8,17,26,65.4,11,26,42.3,7,11,63.6,4,17,21,11,29,15,10,1,74
440509,499_14_14,GEORGIA,8378,4,nika metreveli,0,0,0,0,0,0,0,0,0,0,0,0,0,0,0,0,0,0,0,0,0,0
440510,499_14_14,GEORGIA,16023,5,otar pkhakadze,2,0,0,0,0,0,0,0,0,0,0,0,0,1,0,1,0,2,0,0,0,0
440511,499_14_14,GEORGIA,4919,7,zaza pachulia,34,6,12,50,6,11,54.5,0,1,0,7,11,63.6,2,4,6,2,4,5,1,0,19
440512,499_14_14,GEORGIA,1690,8,george tsintsadze,38,3,7,42.9,3,5,60,0,2,0,0,0,0,0,2,2,4,1,1,0,0,6
440513,499_14_14,GEORGIA,15684,10,duda sanadze,15,2,2,100,1,1,100,1,1,100,0,0,0,1,2,3,1,4,1,0,0,5
440514,499_14_14,GEORGIA,12467,12,levan patsatsia,21,1,3,33.3,1,1,100,0,2,0,0,0,0,0,1,1,1,4,0,1,0,2
440515,499_14_14,GEORGIA,1699,13,viktor sanikidze,33,5,9,55.6,4,7,57.1,1,2,50,1,2,50,1,1,2,0,2,1,1,0,12
440516,499_14_14,GEORGIA,16022,15,beka burjanadze,12,3,5,60,0,1,0,3,4,75,0,0,0,0,3,3,0,2,1,0,0,9
440517,499_14_14,GEORGIA,8382,22,george sharabidze,0,0,0,0,0,0,0,0,0,0,0,0,0,0,0,0,0,0,0,0,0,0
440518,499_14_14,GEORGIA,11036,23,tornike shengelia,33,7,10,70,6,8,75,1,2,50,3,8,37.5,2,3,5,4,1,4,2,1,18
440519,499_14_14,GEORGIA,1693,25,besik lezhava,11,0,1,0,0,1,0,0,0,0,2,2,100,0,0,0,1,1,1,0,0,2
440520,499_14_14,GEORGIA,2604,31,beka tsivtsivadze,0,0,0,0,0,0,0,0,0,0,0,0,0,0,0,0,0,0,0,0,0,0
440521,499_14_14,GEORGIA,0,TOTALS,GEORGIA,200,27,49,55.1,21,35,60,6,14,42.9,13,23,56.5,8,18,26,13,21,14,5,1,73
440522,499_14_15,ROMANIA,2115,4,andrei mandache,34,6,9,66.7,3,4,75,3,5,60,1,2,50,1,1,2,2,2,2,3,0,16
440523,499_14_15,ROMANIA,10239,5,mihail-octavian paul,20,0,3,0,0,2,0,0,1,0,2,2,100,1,1,2,3,4,1,1,0,2
440524,499_14_15,ROMANIA,5015,6,levente szijarto,15,0,0,0,0,0,0,0,0,0,1,2,50,1,2,3,0,4,2,0,0,1
440525,499_14_15,ROMANIA,2900,9,vlad moldoveanu,30,2,9,22.2,2,3,66.7,0,6,0,1,4,25,1,8,9,3,2,3,1,1,5
440526,499_14_15,ROMANIA,2915,10,catalin baciu,20,8,11,72.7,8,11,72.7,0,0,0,2,4,50,2,3,5,0,2,0,0,1,18
440527,499_14_15,ROMANIA,15354,11,octavian calota-popa,7,0,2,0,0,0,0,0,2,0,0,0,0,0,0,0,1,0,2,1,0,0
440528,499_14_15,ROMANIA,11102,12,bogdan tibirna,0,0,0,0,0,0,0,0,0,0,0,0,0,0,0,0,0,0,0,0,0,0
440529,499_14_15,ROMANIA,15358,13,teodor gabriel jucan,9,0,0,0,0,0,0,0,0,0,0,0,0,0,0,0,0,1,0,0,0,0
440530,499_14_15,ROMANIA,2125,14,titus nicoara,16,2,7,28.6,1,6,16.7,1,1,100,1,2,50,2,6,8,1,1,1,0,0,6
440531,499_14_15,ROMANIA,4965,15,mihai vlad silvasan,23,6,11,54.5,5,7,71.4,1,4,25,2,4,50,0,2,2,2,4,1,0,0,15
440532,499_14_15,ROMANIA,5016,21,adrian tudor,21,1,4,25,0,0,0,1,4,25,2,2,100,1,1,2,4,5,3,2,0,5
440533,499_14_15,ROMANIA,12712,44,adrian gutoaia,29,3,6,50,3,5,60,0,1,0,3,4,75,0,2,2,5,2,0,0,1,9
440534,499_14_15,ROMANIA,0,TOTALS,ROMANIA,225,28,62,45.2,22,38,57.9,6,24,25,15,26,57.7,10,29,39,21,27,17,8,3,77
440535,499_14_15,SWEDEN,20455,4,ludvig hakanson,8,0,2,0,0,1,0,0,1,0,0,0,0,0,1,1,1,0,1,0,0,0
440536,499_14_15,SWEDEN,16053,5,tobias borg,0,0,0,0,0,0,0,0,0,0,0,0,0,0,0,0,0,0,0,0,0,0
440537,499_14_15,SWEDEN,4748,6,joakim kjellbom,26,3,6,50,3,6,50,0,0,0,1,2,50,4,5,9,1,4,3,0,3,7
440538,499_14_15,SWEDEN,10481,7,dino pita,24,2,9,22.2,1,3,33.3,1,6,16.7,3,4,75,0,2,2,1,2,0,0,0,8
440539,499_14_15,SWEDEN,10740,8,john gaddefors,14,3,7,42.9,0,0,0,3,7,42.9,0,0,0,2,0,2,1,2,3,0,0,9
440540,499_14_15,SWEDEN,1176,9,thomas massamba,35,0,6,0,0,2,0,0,4,0,6,8,75,0,6,6,3,3,2,2,0,6
440541,499_14_15,SWEDEN,1972,10,martin pahlmblad,28,6,17,35.3,3,9,33.3,3,8,37.5,2,2,100,3,1,4,3,4,3,0,0,17
440542,499_14_15,SWEDEN,5844,11,tom liden,2,0,1,0,0,1,0,0,0,0,0,0,0,0,0,0,0,1,0,0,0,0
440543,499_14_15,SWEDEN,2702,12,brice massamba,29,2,4,50,2,4,50,0,0,0,3,8,37.5,2,2,4,0,5,2,1,1,7
440544,499_14_15,SWEDEN,11099,14,alexander lindqvist,27,2,4,50,2,2,100,0,2,0,0,0,0,0,5,5,3,3,1,1,0,4
440545,499_14_15,SWEDEN,13061,15,jonathan person,26,4,8,50,3,6,50,1,2,50,5,6,83.3,0,4,4,2,1,1,3,0,14
440546,499_14_15,SWEDEN,15688,40,carl engstrom,5,0,0,0,0,0,0,0,0,0,0,0,0,0,1,1,0,0,0,0,1,0
440547,499_14_15,SWEDEN,0,TOTALS,SWEDEN,225,22,64,34.4,14,34,41.2,8,30,26.7,20,30,66.7,14,28,42,15,25,17,7,5,72
440548,499_14_16,RUSSIA,1809,5,nikita kurbanov,28,3,5,60,3,3,100,0,2,0,2,5,40,3,7,10,1,2,1,0,0,8
440549,499_14_16,RUSSIA,11050,6,pavel antipov,0,0,0,0,0,0,0,0,0,0,0,0,0,0,0,0,0,0,0,0,0,0
440550,499_14_16,RUSSIA,12959,7,dmitrii kulagin,15,1,6,16.7,1,5,20,0,1,0,2,2,100,2,1,3,2,3,0,1,0,4
440551,499_14_16,RUSSIA,29520,8,pavel korobkov,1,0,0,0,0,0,0,0,0,0,0,0,0,0,0,0,0,0,0,0,0,0
440552,499_14_16,RUSSIA,1083,9,egor vyaltsev,15,2,3,66.7,2,2,100,0,1,0,0,0,0,0,0,0,2,3,0,1,0,4
440553,499_14_16,RUSSIA,1079,10,dmitry sokolov,16,2,4,50,2,4,50,0,0,0,1,2,50,1,1,2,1,0,1,0,0,5
440554,499_14_16,RUSSIA,19857,12,andrey zubkov,16,2,6,33.3,2,3,66.7,0,3,0,0,0,0,0,4,4,2,2,0,0,0,4
440555,499_14_16,RUSSIA,2554,13,dmitry khvostov,22,0,5,0,0,3,0,0,2,0,2,2,100,1,2,3,3,1,0,0,0,2
440556,499_14_16,RUSSIA,1808,14,anton ponkrashov,18,2,6,33.3,1,5,20,1,1,100,2,4,50,0,2,2,0,0,0,0,1,7
440557,499_14_16,RUSSIA,15377,15,timofey mozgov,23,7,11,63.6,7,11,63.6,0,0,0,3,4,75,4,6,10,1,4,4,0,1,17
440558,499_14_16,RUSSIA,10610,23,semen antonov,24,1,7,14.3,1,3,33.3,0,4,0,2,2,100,2,2,4,0,3,1,1,1,4
440559,499_14_16,RUSSIA,1810,24,evgeny voronov,22,3,9,33.3,2,7,28.6,1,2,50,1,2,50,1,2,3,0,4,1,0,0,8
440560,499_14_16,RUSSIA,0,TOTALS,RUSSIA,200,23,62,37.1,21,46,45.7,2,16,12.5,15,23,65.2,17,27,44,12,22,8,3,3,63
440561,499_14_16,ITALY,12988,5,alessandro gentile,35,8,20,40,7,14,50,1,6,16.7,3,6,50,0,3,3,2,3,1,1,0,20
440562,499_14_16,ITALY,1705,7,luca vitali,13,1,2,50,1,2,50,0,0,0,0,0,0,1,2,3,0,2,0,0,0,2
440563,499_14_16,ITALY,15319,12,marco cusin,28,3,5,60,3,5,60,0,0,0,3,3,100,4,3,7,0,4,0,0,4,9
440564,499_14_16,ITALY,1861,13,luigi datome,34,4,11,36.4,3,8,37.5,1,3,33.3,2,2,100,1,7,8,0,3,0,0,0,11
440565,499_14_16,ITALY,19847,14,riccardo cervi,10,1,1,100,1,1,100,0,0,0,0,0,0,0,0,0,0,4,1,0,2,2
440566,499_14_16,ITALY,24206,18,daniele magro,1,0,0,0,0,0,0,0,0,0,0,0,0,0,0,0,0,0,0,0,0,0
440567,499_14_16,ITALY,19752,20,andrea cinciarini,35,4,8,50,4,8,50,0,0,0,2,2,100,1,6,7,2,2,1,1,0,10
440568,499_14_16,ITALY,10579,22,stefano gentile,8,0,1,0,0,1,0,0,0,0,0,0,0,0,1,1,0,2,0,0,0,0
440569,499_14_16,ITALY,17241,27,davide pascolo,1,0,0,0,0,0,0,0,0,0,0,0,0,0,0,0,0,0,0,0,0,0
440570,499_14_16,ITALY,20021,32,amedeo della valle,0,0,0,0,0,0,0,0,0,0,0,0,0,0,0,0,0,0,0,0,0,0
440571,499_14_16,ITALY,7944,33,pietro aradori,32,5,12,41.7,5,10,50,0,2,0,1,2,50,0,1,1,1,2,2,1,0,11
440572,499_14_16,ITALY,15644,34,achille polonara,2,0,1,0,0,1,0,0,0,0,0,0,0,0,0,0,0,1,0,0,0,0
440573,499_14_16,ITALY,0,TOTALS,ITALY,200,26,61,42.6,24,50,48,2,11,18.2,11,15,73.3,10,24,34,5,23,5,3,6,65
440574,499_14_17,LUXEMBOURG,5011,4,tom schumacher,22,0,2,0,0,0,0,0,2,0,0,0,0,0,0,0,0,2,1,0,0,0
440575,499_14_17,LUXEMBOURG,5918,5,pitt koster,15,0,1,0,0,1,0,0,0,0,0,0,0,1,0,1,0,0,1,1,0,0
440576,499_14_17,LUXEMBOURG,2966,6,raul leandro birenbaum,20,4,7,57.1,2,3,66.7,2,4,50,0,0,0,1,1,2,1,1,1,0,0,10
440577,499_14_17,LUXEMBOURG,8344,8,christopher c. g. jones,26,7,13,53.8,5,8,62.5,2,5,40,0,0,0,0,2,2,1,1,4,2,0,16
440578,499_14_17,LUXEMBOURG,19727,10,patrick arbaut,18,2,5,40,1,2,50,1,3,33.3,0,0,0,1,1,2,0,1,1,1,0,5
440579,499_14_17,LUXEMBOURG,13285,11,bob melcher,18,4,7,57.1,4,5,80,0,2,0,4,4,100,0,1,1,0,0,3,0,0,12
440580,499_14_17,LUXEMBOURG,19728,12,alexandre rodenbourg,23,1,3,33.3,1,3,33.3,0,0,0,1,2,50,1,0,1,1,3,2,2,0,3
440581,499_14_17,LUXEMBOURG,8340,22,jean nicolas c. kox,13,0,1,0,0,1,0,0,0,0,1,3,33.3,1,1,2,0,1,0,0,0,1
440582,499_14_17,LUXEMBOURG,1283,23,jairo emanuel delgado ferreira,27,4,9,44.4,2,3,66.7,2,6,33.3,0,0,0,1,0,1,0,2,1,1,0,10
440583,499_14_17,LUXEMBOURG,17901,24,thomas grun,0,0,0,0,0,0,0,0,0,0,0,0,0,0,0,0,0,0,0,0,0,0
440584,499_14_17,LUXEMBOURG,29517,30,dominique benseghir,3,0,1,0,0,1,0,0,0,0,0,0,0,0,0,0,0,0,0,0,0,0
440585,499_14_17,LUXEMBOURG,13176,31,alex laurent,16,1,8,12.5,1,6,16.7,0,2,0,2,2,100,0,0,0,0,4,0,0,0,4
440586,499_14_17,LUXEMBOURG,0,TOTALS,LUXEMBOURG,200,23,57,40.4,16,33,48.5,7,24,29.2,8,11,72.7,7,6,13,3,15,16,7,0,61
440587,499_14_17,POLAND,5694,5,aaron cel,23,5,6,83.3,5,6,83.3,0,0,0,0,0,0,1,4,5,2,1,3,2,0,10
440588,499_14_17,POLAND,4799,6,robert jozef skibniewski,21,1,3,33.3,0,0,0,1,3,33.3,0,0,0,1,0,1,1,1,0,0,0,3
440589,499_14_17,POLAND,7833,7,damian kulig,18,6,8,75,5,7,71.4,1,1,100,1,1,100,3,4,7,2,4,1,1,0,14
440590,499_14_17,POLAND,24194,8,przemyslaw zamojski,14,5,7,71.4,2,3,66.7,3,4,75,0,0,0,0,2,2,1,0,1,2,0,13
440591,499_14_17,POLAND,15981,9,mateusz ponitka,17,6,7,85.7,4,5,80,2,2,100,1,1,100,1,2,3,1,0,1,1,0,15
440592,499_14_17,POLAND,4804,10,szymon pawel szewczyk,22,8,9,88.9,8,8,100,0,1,0,4,6,66.7,0,5,5,3,0,1,0,0,20
440593,499_14_17,POLAND,8034,12,adam waczynski,15,4,5,80,2,2,100,2,3,66.7,0,0,0,0,0,0,2,1,2,0,0,10
440594,499_14_17,POLAND,19694,14,adam hrycaniuk,16,3,4,75,3,4,75,0,0,0,0,0,0,3,2,5,0,0,4,0,1,6
440595,499_14_17,POLAND,6190,15,kamil jacek laczynski,17,2,3,66.7,0,0,0,2,3,66.7,1,2,50,0,1,1,3,2,2,1,1,7
440596,499_14_17,POLAND,15983,21,tomasz gielo,21,5,8,62.5,4,5,80,1,3,33.3,2,2,100,1,4,5,1,1,2,0,0,13
440597,499_14_17,POLAND,15977,23,michal michalak,16,1,5,20,1,3,33.3,0,2,0,0,0,0,0,3,3,1,3,3,0,0,2
440598,499_14_17,POLAND,0,TOTALS,POLAND,200,46,65,70.8,34,43,79.1,12,22,54.5,9,12,75,11,27,38,17,13,20,7,2,113
440599,499_14_18,NETHERLANDS,10202,4,arvin slagter,22,1,7,14.3,1,3,33.3,0,4,0,0,0,0,1,6,7,7,4,5,0,0,2
440600,499_14_18,NETHERLANDS,15661,5,leon williams,35,3,6,50,1,3,33.3,2,3,66.7,0,0,0,1,3,4,1,2,1,1,0,8
440601,499_14_18,NETHERLANDS,24213,6,worthy de jong,31,5,14,35.7,5,13,38.5,0,1,0,0,0,0,3,1,4,4,2,5,2,0,10
440602,499_14_18,NETHERLANDS,22012,7,julius clay van sauers,0,0,0,0,0,0,0,0,0,0,0,0,0,0,0,0,0,0,0,0,0,0
440603,499_14_18,NETHERLANDS,13250,8,dexter cornelis hope,5,0,0,0,0,0,0,0,0,0,0,0,0,0,0,0,0,0,1,0,0,0
440604,499_14_18,NETHERLANDS,10671,9,mohamed kherrazi,16,1,5,20,1,4,25,0,1,0,0,0,0,1,0,1,2,2,1,2,0,2
440605,499_14_18,NETHERLANDS,12501,10,ralf de pagter,15,1,2,50,1,2,50,0,0,0,2,2,100,0,3,3,1,0,0,0,0,4
440606,499_14_18,NETHERLANDS,6397,11,thomas koenis,15,4,5,80,4,5,80,0,0,0,0,0,0,2,3,5,0,4,2,1,0,8
440607,499_14_18,NETHERLANDS,16075,12,shane gerrit hammink,0,0,0,0,0,0,0,0,0,0,0,0,0,0,0,0,0,0,0,0,0,0
440608,499_14_18,NETHERLANDS,20078,13,kevin bleeker,4,0,1,0,0,1,0,0,0,0,0,0,0,0,0,0,0,0,0,0,0,0
440609,499_14_18,NETHERLANDS,5812,14,nick oudendag,25,4,12,33.3,4,11,36.4,0,1,0,3,3,100,4,7,11,0,4,2,0,0,11
440610,499_14_18,NETHERLANDS,2871,21,roeland schaftenaar,32,5,9,55.6,3,6,50,2,3,66.7,0,0,0,2,4,6,2,2,0,1,0,12
440611,499_14_18,NETHERLANDS,0,TOTALS,NETHERLANDS,200,24,61,39.3,20,48,41.7,4,13,30.8,5,5,100,14,27,41,17,20,18,7,0,57
440612,499_14_18,ISRAEL,1680,4,nitzan yehuda hanochi,0,0,0,0,0,0,0,0,0,0,0,0,0,0,0,0,0,0,0,0,0,0
440613,499_14_18,ISRAEL,4794,5,afik nissim,17,1,7,14.3,1,6,16.7,0,1,0,0,0,0,1,4,5,0,1,0,0,0,2
440614,499_14_18,ISRAEL,1022,6,raviv guy limonad,12,0,2,0,0,1,0,0,1,0,1,2,50,0,2,2,1,0,1,1,0,1
440615,499_14_18,ISRAEL,2522,7,gal mekel,28,3,6,50,2,3,66.7,1,3,33.3,1,3,33.3,0,1,1,5,2,2,2,0,8
440616,499_14_18,ISRAEL,1023,8,lior eliyahu,29,6,12,50,6,12,50,0,0,0,1,2,50,3,1,4,3,2,1,3,0,13
440617,499_14_18,ISRAEL,1933,9,omri casspi,29,3,8,37.5,2,4,50,1,4,25,2,5,40,0,8,8,1,0,4,1,0,9
440618,499_14_18,ISRAEL,10164,10,guy pnini,29,6,10,60,2,3,66.7,4,7,57.1,0,0,0,1,5,6,4,3,4,2,1,16
440619,499_14_18,ISRAEL,1019,12,yotam halperin,24,1,5,20,0,1,0,1,4,25,2,2,100,1,1,2,2,3,2,1,0,5
440620,499_14_18,ISRAEL,5780,13,elishay kadir,1,0,0,0,0,0,0,0,0,0,0,0,0,0,0,0,0,0,0,0,0,0
440621,499_14_18,ISRAEL,4620,14,yaniv green,17,3,4,75,3,4,75,0,0,0,1,1,100,2,1,3,1,2,2,0,0,7
440622,499_14_18,ISRAEL,29526,15,dor anthony naheem fischer,12,2,3,66.7,2,3,66.7,0,0,0,1,1,100,0,0,0,2,3,1,1,0,5
440623,499_14_18,ISRAEL,24229,21,dagan yivzori,0,0,0,0,0,0,0,0,0,0,0,0,0,0,0,0,0,0,0,0,0,0
440624,499_14_18,ISRAEL,0,TOTALS,ISRAEL,200,25,57,43.9,18,37,48.6,7,20,35,9,16,56.2,9,23,32,19,16,17,11,1,66
440625,499_14_19,DENMARK,29522,4,darko jukic,30,5,10,50,4,9,44.4,1,1,100,0,0,0,3,3,6,2,1,2,2,0,11
440626,499_14_19,DENMARK,16165,5,frederik rungby,16,1,2,50,1,2,50,0,0,0,1,3,33.3,0,1,1,0,2,0,1,0,3
440627,499_14_19,DENMARK,24492,6,tobias reinholt,10,1,1,100,1,1,100,0,0,0,0,0,0,0,0,0,1,1,2,0,0,2
440628,499_14_19,DENMARK,16162,7,esben reinholt,27,6,11,54.5,5,9,55.6,1,2,50,3,4,75,2,4,6,4,2,1,2,0,16
440629,499_14_19,DENMARK,21908,8,gabriel lundberg,15,0,4,0,0,4,0,0,0,0,3,4,75,1,2,3,1,2,1,1,0,3
440630,499_14_19,DENMARK,12662,9,alexander heidenheim bak,14,2,6,33.3,1,3,33.3,1,3,33.3,0,0,0,1,1,2,0,2,1,0,0,5
440631,499_14_19,DENMARK,10649,10,mathias seilund,27,7,10,70,4,5,80,3,5,60,0,0,0,0,1,1,1,0,0,0,1,17
440632,499_14_19,DENMARK,15650,11,thomas sebastian laerke,24,4,8,50,3,4,75,1,4,25,2,2,100,0,0,0,2,4,4,0,0,11
440633,499_14_19,DENMARK,17655,12,peter moeller,3,0,0,0,0,0,0,0,0,0,0,0,0,0,0,0,0,0,0,0,0,0
440634,499_14_19,DENMARK,29523,13,asger hjorth,0,0,0,0,0,0,0,0,0,0,0,0,0,0,0,0,0,0,0,0,0,0
440635,499_14_19,DENMARK,13180,14,anders kristoffer haas,6,1,2,50,0,1,0,1,1,100,0,0,0,0,1,1,1,2,0,0,0,3
440636,499_14_19,DENMARK,12663,15,jonas zohore bergstedt,28,1,12,8.3,1,11,9.1,0,1,0,2,2,100,4,6,10,0,1,4,0,0,4
440637,499_14_19,DENMARK,0,TOTALS,DENMARK,200,28,66,42.4,20,49,40.8,8,17,47.1,11,15,73.3,13,22,35,12,17,15,6,1,75
440638,499_14_19,MKD,6304,4,ivica dimchevski,4,0,2,0,0,0,0,0,2,0,0,0,0,0,0,0,0,0,1,0,0,0
440639,499_14_19,MKD,22445,5,andrej magdevski,19,1,1,100,1,1,100,0,0,0,2,2,100,0,2,2,0,3,1,2,0,4
440640,499_14_19,MKD,7810,6,darko sokolov,21,5,10,50,3,6,50,2,4,50,0,0,0,1,2,3,2,1,3,2,0,12
440641,499_14_19,MKD,2709,7,aleksandar kostoski,21,4,7,57.1,3,3,100,1,4,25,0,0,0,0,2,2,2,2,0,0,0,9
440642,499_14_19,MKD,5892,8,vojdan stojanovski,14,5,6,83.3,3,4,75,2,2,100,0,1,0,0,2,2,1,4,0,1,0,12
440643,499_14_19,MKD,5892,9,damjan stojanovski,18,4,6,66.7,4,4,100,0,2,0,1,2,50,0,0,0,0,3,0,0,0,9
440644,499_14_19,MKD,6300,10,marko simonovski,23,4,8,50,2,2,100,2,6,33.3,2,2,100,0,4,4,3,1,2,0,0,12
440645,499_14_19,MKD,6306,11,vladimir brckov,0,0,0,0,0,0,0,0,0,0,0,0,0,0,0,0,0,0,0,0,0,0
440646,499_14_19,MKD,2714,12,bojan trajkovski,25,4,9,44.4,3,5,60,1,4,25,0,2,0,0,4,4,4,3,2,1,2,9
440647,499_14_19,MKD,11275,13,stojan gjuroski,25,2,4,50,2,3,66.7,0,1,0,0,0,0,3,0,3,1,0,2,0,0,4
440648,499_14_19,MKD,2715,14,marjan janeski,6,0,1,0,0,1,0,0,0,0,2,2,100,0,0,0,2,2,1,0,0,2
440649,499_14_19,MKD,29507,15,venard richard hendriks,24,4,7,57.1,4,6,66.7,0,1,0,0,0,0,1,6,7,1,1,1,4,2,8
440650,499_14_19,MKD,0,TOTALS,MKD,200,33,61,54.1,25,35,71.4,8,26,30.8,7,11,63.6,5,23,28,16,20,13,10,4,81
440651,499_14_20,GREAT BRITAIN,805,4,kieron achara,26,3,5,60,1,3,33.3,2,2,100,5,6,83.3,2,3,5,2,2,2,2,0,13
440652,499_14_20,GREAT BRITAIN,5821,5,ashley hamilton,0,0,0,0,0,0,0,0,0,0,0,0,0,0,0,0,0,0,0,0,0,0
440653,499_14_20,GREAT BRITAIN,6383,6,devan bailey,17,3,4,75,3,3,100,0,1,0,0,0,0,1,2,3,2,3,1,1,0,6
440654,499_14_20,GREAT BRITAIN,13115,7,devon van oostrum,25,3,12,25,3,8,37.5,0,4,0,2,2,100,0,4,4,3,4,1,1,0,8
440655,499_14_20,GREAT BRITAIN,10185,8,andrew sullivan,20,2,5,40,2,4,50,0,1,0,0,2,0,2,0,2,0,2,2,1,0,4
440656,499_14_20,GREAT BRITAIN,12429,9,gareth murray,22,0,1,0,0,0,0,0,1,0,0,0,0,0,0,0,0,3,0,0,0,0
440657,499_14_20,GREAT BRITAIN,1984,10,dan clark,30,4,15,26.7,4,8,50,0,7,0,6,6,100,3,6,9,0,2,1,0,1,14
440658,499_14_20,GREAT BRITAIN,15538,12,myles edward sinclair hesson,14,0,5,0,0,4,0,0,1,0,2,4,50,0,0,0,0,0,2,0,0,2
440659,499_14_20,GREAT BRITAIN,2833,13,matt bryan-amaning,4,1,1,100,1,1,100,0,0,0,0,0,0,0,0,0,0,1,0,0,0,2
440660,499_14_20,GREAT BRITAIN,10192,14,eric boateng,5,1,1,100,1,1,100,0,0,0,0,0,0,1,1,2,0,0,0,0,0,2
440661,499_14_20,GREAT BRITAIN,19759,15,kyle johnson,28,6,13,46.2,5,7,71.4,1,6,16.7,0,0,0,3,5,8,1,1,0,0,1,13
440662,499_14_20,GREAT BRITAIN,12534,24,ben mockford,11,1,3,33.3,1,3,33.3,0,0,0,1,2,50,1,0,1,0,2,0,1,0,3
440663,499_14_20,GREAT BRITAIN,0,TOTALS,GREAT BRITAIN,200,24,65,36.9,21,42,50,3,23,13,16,22,72.7,13,25,38,8,20,10,6,2,67
440664,499_14_20,BOSNIA AND HERZEGOVINA,5859,4,muhamed pasalic,14,0,2,0,0,0,0,0,2,0,1,2,50,0,0,0,4,4,0,0,0,1
440665,499_14_20,BOSNIA AND HERZEGOVINA,20566,5,nedim buza,6,0,1,0,0,1,0,0,0,0,0,0,0,0,0,0,0,1,0,1,1,0
440666,499_14_20,BOSNIA AND HERZEGOVINA,7780,6,andrija stipanovic,28,5,7,71.4,5,7,71.4,0,0,0,0,0,0,4,1,5,4,4,0,0,0,10
440667,499_14_20,BOSNIA AND HERZEGOVINA,24189,7,marko sutalo,29,3,7,42.9,2,5,40,1,2,50,2,2,100,0,6,6,3,2,1,1,0,9
440668,499_14_20,BOSNIA AND HERZEGOVINA,2887,10,nemanja gordic,27,3,7,42.9,3,5,60,0,2,0,3,6,50,1,5,6,2,2,5,0,0,9
440669,499_14_20,BOSNIA AND HERZEGOVINA,2891,11,elmedin kikanovic,24,5,10,50,5,10,50,0,0,0,2,3,66.7,1,1,2,0,2,1,0,0,12
440670,499_14_20,BOSNIA AND HERZEGOVINA,4561,12,mirza teletovic,27,8,13,61.5,5,8,62.5,3,5,60,6,6,100,0,6,6,2,2,1,3,0,25
440671,499_14_20,BOSNIA AND HERZEGOVINA,11206,13,miralem halilovic,1,0,0,0,0,0,0,0,0,0,0,0,0,0,0,0,0,0,0,0,0,0
440672,499_14_20,BOSNIA AND HERZEGOVINA,24216,14,nemanja mitrovic,33,4,8,50,0,0,0,4,8,50,0,0,0,0,7,7,2,3,1,0,0,12
440673,499_14_20,BOSNIA AND HERZEGOVINA,29531,21,drasko knezevic,0,0,0,0,0,0,0,0,0,0,0,0,0,0,0,0,0,0,0,0,0,0
440674,499_14_20,BOSNIA AND HERZEGOVINA,17436,22,adin vrabac,12,1,1,100,1,1,100,0,0,0,0,0,0,0,2,2,1,3,2,2,1,2
440675,499_14_20,BOSNIA AND HERZEGOVINA,29498,23,drasko albijanic,0,0,0,0,0,0,0,0,0,0,0,0,0,0,0,0,0,0,0,0,0,0
440676,499_14_20,BOSNIA AND HERZEGOVINA,0,TOTALS,BOSNIA AND HERZEGOVINA,200,29,56,51.8,21,37,56.8,8,19,42.1,14,19,73.7,6,29,35,18,23,11,7,2,80
440677,499_14_21,LATVIA,19755,5,mareks mejeris,1,0,1,0,0,1,0,0,0,0,0,0,0,0,0,0,0,0,0,0,0,0
440678,499_14_21,LATVIA,2539,6,rolands freimanis,20,4,5,80,3,3,100,1,2,50,5,5,100,0,1,1,0,1,1,1,1,14
440679,499_14_21,LATVIA,5029,7,janis blums,25,2,5,40,0,1,0,2,4,50,0,0,0,1,4,5,4,3,1,2,0,6
440680,499_14_21,LATVIA,6271,9,dairis bertans,22,1,5,20,1,3,33.3,0,2,0,6,6,100,1,4,5,4,3,3,1,0,8
440681,499_14_21,LATVIA,12927,10,janis timma,19,4,7,57.1,2,2,100,2,5,40,0,0,0,1,3,4,4,0,4,1,1,10
440682,499_14_21,LATVIA,20350,11,rolands smits,1,0,0,0,0,0,0,0,0,0,0,0,0,0,0,0,0,0,0,0,0,0
440683,499_14_21,LATVIA,4604,12,kristaps janicenoks,26,3,8,37.5,1,3,33.3,2,5,40,4,6,66.7,1,2,3,3,2,1,0,0,12
440684,499_14_21,LATVIA,10585,13,janis strelnieks,23,1,3,33.3,1,2,50,0,1,0,0,0,0,0,3,3,6,1,3,1,1,2
440685,499_14_21,LATVIA,1002,14,kaspars berzins,26,7,13,53.8,6,9,66.7,1,4,25,3,4,75,2,6,8,0,2,2,2,1,18
440686,499_14_21,LATVIA,29525,21,aigars skele,11,2,2,100,2,2,100,0,0,0,2,2,100,1,3,4,2,0,0,0,0,6
440687,499_14_21,LATVIA,5721,30,ronalds zakis,14,1,6,16.7,1,5,20,0,1,0,0,2,0,2,1,3,0,0,0,0,0,2
440688,499_14_21,LATVIA,15602,33,martins meiers,12,4,5,80,4,5,80,0,0,0,0,0,0,1,1,2,2,3,2,0,1,8
440689,499_14_21,LATVIA,0,TOTALS,LATVIA,200,29,60,48.3,21,36,58.3,8,24,33.3,20,25,80,10,31,41,25,15,17,8,5,86
440690,499_14_21,SLOVAK REPUBLIC,15367,4,marek kozlik,6,0,1,0,0,0,0,0,1,0,0,0,0,0,1,1,1,0,0,0,0,0
440691,499_14_21,SLOVAK REPUBLIC,6339,5,peter dorazil,12,3,4,75,3,4,75,0,0,0,0,0,0,1,0,1,0,4,1,0,0,6
440692,499_14_21,SLOVAK REPUBLIC,1154,6,peter sedmak,30,7,19,36.8,4,11,36.4,3,8,37.5,0,0,0,2,3,5,2,1,1,1,4,17
440693,499_14_21,SLOVAK REPUBLIC,11264,7,tomas mrvis,15,0,4,0,0,1,0,0,3,0,0,0,0,0,2,2,1,2,4,0,0,0
440694,499_14_21,SLOVAK REPUBLIC,10469,8,milan ziak,25,4,6,66.7,4,5,80,0,1,0,1,2,50,1,0,1,4,3,2,0,0,9
440695,499_14_21,SLOVAK REPUBLIC,5862,9,martin bilik,29,4,7,57.1,0,1,0,4,6,66.7,0,0,0,0,1,1,1,4,1,0,0,12
440696,499_14_21,SLOVAK REPUBLIC,29524,10,nenad milosevic,22,0,6,0,0,4,0,0,2,0,2,2,100,0,3,3,5,0,4,1,0,2
440697,499_14_21,SLOVAK REPUBLIC,17785,11,oliver tot,0,0,0,0,0,0,0,0,0,0,0,0,0,0,0,0,0,0,0,0,0,0
440698,499_14_21,SLOVAK REPUBLIC,8025,12,peter simek,19,5,9,55.6,5,9,55.6,0,0,0,2,4,50,1,5,6,0,1,2,1,0,12
440699,499_14_21,SLOVAK REPUBLIC,12668,13,andrej kuffa,19,2,7,28.6,1,5,20,1,2,50,1,1,100,0,3,3,1,3,1,1,0,6
440700,499_14_21,SLOVAK REPUBLIC,8444,15,marek jass,23,1,3,33.3,1,3,33.3,0,0,0,0,0,0,1,2,3,1,2,1,2,0,2
440701,499_14_21,SLOVAK REPUBLIC,0,TOTALS,SLOVAK REPUBLIC,200,26,66,39.4,18,43,41.9,8,23,34.8,6,9,66.7,8,21,29,16,20,17,6,4,66
440702,499_14_22,AUSTRIA,2103,5,thomas schreiner,26,1,11,9.1,0,1,0,1,10,10,2,2,100,0,1,1,6,1,1,1,0,5
440703,499_14_22,AUSTRIA,29530,8,enis murati,32,11,16,68.8,6,8,75,5,8,62.5,0,0,0,0,2,2,3,5,3,0,0,27
440704,499_14_22,AUSTRIA,16191,14,jozo rados,18,1,4,25,1,4,25,0,0,0,0,0,0,0,3,3,0,2,0,0,0,2
440705,499_14_22,AUSTRIA,8395,15,david hasenburger,15,2,3,66.7,2,3,66.7,0,0,0,0,0,0,1,3,4,0,5,1,0,0,4
440706,499_14_22,AUSTRIA,8392,20,romed vieider,0,0,0,0,0,0,0,0,0,0,0,0,0,0,0,0,0,0,0,0,0,0
440707,499_14_22,AUSTRIA,8396,24,rasid mahalbasic,36,6,12,50,6,9,66.7,0,3,0,2,2,100,3,5,8,2,3,2,1,3,14
440708,499_14_22,AUSTRIA,8386,25,jesse nii l. seilern und aspang,1,0,0,0,0,0,0,0,0,0,0,0,0,0,0,0,0,0,0,0,0,0
440709,499_14_22,AUSTRIA,6415,34,moritz lanegger,21,1,2,50,1,1,100,0,1,0,2,2,100,1,1,2,2,3,2,2,0,4
440710,499_14_22,AUSTRIA,12529,35,sebastian koch,0,0,0,0,0,0,0,0,0,0,0,0,0,0,0,0,0,0,0,0,0,0
440711,499_14_22,AUSTRIA,13271,41,maximilian hopfgartner,12,1,5,20,0,2,0,1,3,33.3,0,0,0,0,0,0,0,1,0,1,0,3
440712,499_14_22,AUSTRIA,11250,42,thomas klepeisz,21,1,5,20,1,1,100,0,4,0,0,0,0,2,1,3,2,2,1,1,0,2
440713,499_14_22,AUSTRIA,15717,43,anton maresch,19,1,7,14.3,0,4,0,1,3,33.3,0,0,0,0,1,1,1,2,2,0,0,3
440714,499_14_22,AUSTRIA,0,TOTALS,AUSTRIA,200,25,65,38.5,17,33,51.5,8,32,25,6,6,100,8,21,29,16,24,13,6,3,64
440715,499_14_22,GERMANY,8244,7,akeem vargas,5,0,2,0,0,0,0,0,2,0,1,2,50,0,1,1,0,1,0,0,0,1
440716,499_14_22,GERMANY,15385,8,heiko schaffartzik,27,1,6,16.7,0,2,0,1,4,25,2,2,100,0,1,1,5,0,1,2,0,5
440717,499_14_22,GERMANY,10446,9,karsten tadda,25,1,1,100,0,0,0,1,1,100,5,6,83.3,0,1,1,1,3,2,2,0,8
440718,499_14_22,GERMANY,5747,10,lucca staiger,18,1,6,16.7,1,4,25,0,2,0,0,0,0,1,0,1,0,2,1,0,0,2
440719,499_14_22,GERMANY,6326,12,robin benzing,23,0,3,0,0,2,0,0,1,0,2,2,100,0,1,1,1,2,0,0,0,2
440720,499_14_22,GERMANY,15492,13,bastian doreth,0,0,0,0,0,0,0,0,0,0,0,0,0,0,0,0,0,0,0,0,0,0
440721,499_14_22,GERMANY,15493,14,andreas seiferth,5,0,0,0,0,0,0,0,0,0,1,2,50,0,2,2,0,2,1,1,0,1
440722,499_14_22,GERMANY,6324,20,elias harris,12,2,5,40,2,4,50,0,1,0,0,0,0,0,2,2,0,0,0,0,0,4
440723,499_14_22,GERMANY,19866,21,daniel theis,15,1,2,50,1,2,50,0,0,0,2,3,66.7,2,1,3,1,4,1,0,0,4
440724,499_14_22,GERMANY,19990,22,dennis schroder,20,5,7,71.4,4,4,100,1,3,33.3,2,2,100,0,1,1,3,2,5,1,0,13
440725,499_14_22,GERMANY,29529,24,maximilian kleber,22,6,10,60,2,5,40,4,5,80,4,5,80,2,5,7,0,0,0,0,2,20
440726,499_14_22,GERMANY,12608,33,maik hendrik zirbes,27,8,10,80,8,10,80,0,0,0,1,3,33.3,1,6,7,0,2,1,0,0,17
440727,499_14_22,GERMANY,0,TOTALS,GERMANY,200,25,52,48.1,18,33,54.5,7,19,36.8,20,27,74.1,7,26,33,11,18,13,6,2,77
440728,499_14_23,BELGIUM,10156,4,lionel georges m bosco,25,3,9,33.3,2,5,40,1,4,25,0,0,0,0,1,1,3,4,2,3,0,7
440729,499_14_23,BELGIUM,19894,6,kevin tumba,11,2,4,50,2,4,50,0,0,0,0,0,0,2,3,5,0,1,0,0,1,4
440730,499_14_23,BELGIUM,4548,7,axel hervelle,25,2,5,40,2,5,40,0,0,0,4,4,100,1,4,5,3,1,3,0,1,8
440731,499_14_23,BELGIUM,6157,8,jean-marc mwema,8,0,1,0,0,1,0,0,0,0,0,0,0,1,4,5,0,0,0,0,0,0
440732,499_14_23,BELGIUM,10706,9,olivier troisfontaines,9,0,4,0,0,2,0,0,2,0,0,0,0,1,1,2,0,1,2,0,0,0
440733,499_14_23,BELGIUM,13030,10,loic robin b. schwartz,23,2,4,50,1,1,100,1,3,33.3,2,2,100,0,0,0,2,4,1,3,0,7
440734,499_14_23,BELGIUM,19709,11,guy muya,16,1,7,14.3,0,4,0,1,3,33.3,0,0,0,1,1,2,2,1,2,1,0,3
440735,499_14_23,BELGIUM,24196,12,wen-boss mukubu,15,1,4,25,1,3,33.3,0,1,0,2,2,100,0,1,1,1,2,3,0,1,4
440736,499_14_23,BELGIUM,11181,13,pierre-antoine gillet,28,6,9,66.7,3,4,75,3,5,60,0,0,0,3,4,7,0,3,1,1,0,15
440737,499_14_23,BELGIUM,10498,14,maxime de zeeuw,15,5,9,55.6,3,5,60,2,4,50,1,1,100,3,4,7,2,3,1,0,1,13
440738,499_14_23,BELGIUM,4550,20,roel moors,0,0,0,0,0,0,0,0,0,0,0,0,0,0,0,0,0,0,0,0,0,0
440739,499_14_23,BELGIUM,29508,24,matt lojeski,25,3,9,33.3,2,4,50,1,5,20,3,4,75,2,1,3,1,1,2,5,0,10
440740,499_14_23,BELGIUM,0,TOTALS,BELGIUM,200,25,65,38.5,16,38,42.1,9,27,33.3,12,13,92.3,15,26,41,14,21,18,13,4,71
440741,499_14_23,BELARUS,1646,4,kanstantsin yafremau,20,1,2,50,1,2,50,0,0,0,0,0,0,2,2,4,0,1,3,1,0,2
440742,499_14_23,BELARUS,15346,5,siarhei charykau,27,0,5,0,0,4,0,0,1,0,1,2,50,0,0,0,4,2,2,1,0,1
440743,499_14_23,BELARUS,16119,6,aliaksandr semianiuk,20,2,5,40,2,5,40,0,0,0,2,2,100,0,1,1,0,2,2,0,0,6
440744,499_14_23,BELARUS,29521,7,kiryl sitnik,17,2,4,50,1,2,50,1,2,50,0,2,0,0,1,1,1,3,1,0,0,5
440745,499_14_23,BELARUS,2847,8,mikita meshcharakou,5,1,2,50,1,2,50,0,0,0,0,0,0,0,0,0,0,0,0,0,0,2
440746,499_14_23,BELARUS,4916,9,mikalai aliakseyeu,0,0,0,0,0,0,0,0,0,0,0,0,0,0,0,0,0,0,0,0,0,0
440747,499_14_23,BELARUS,13157,10,vitali liutych,22,3,11,27.3,3,8,37.5,0,3,0,2,2,100,0,6,6,0,0,3,1,0,8
440748,499_14_23,BELARUS,997,11,dzmitry paliashchuk,24,2,4,50,1,2,50,1,2,50,2,2,100,0,1,1,0,2,1,0,0,7
440749,499_14_23,BELARUS,998,12,aliaksandr pustahvar,10,1,3,33.3,1,2,50,0,1,0,0,0,0,2,1,3,0,4,0,0,0,2
440750,499_14_23,BELARUS,5476,13,valery gandlin,3,0,1,0,0,1,0,0,0,0,2,2,100,0,0,0,0,0,0,0,0,2
440751,499_14_23,BELARUS,4915,14,aliaksandr kudrautsau,25,4,9,44.4,2,4,50,2,5,40,5,7,71.4,1,7,8,2,3,8,2,0,15
440752,499_14_23,BELARUS,1645,15,aliaksei trastsinetski,27,3,8,37.5,2,5,40,1,3,33.3,0,0,0,2,3,5,0,2,1,3,0,7
440753,499_14_23,BELARUS,0,TOTALS,BELARUS,200,19,54,35.2,14,37,37.8,5,17,29.4,14,19,73.7,9,25,34,7,19,22,8,0,57
440754,499_14_24,MONTENEGRO,12640,5,vladimir mihailovic,24,1,7,14.3,1,3,33.3,0,4,0,1,1,100,0,1,1,6,2,0,0,0,3
440755,499_14_24,MONTENEGRO,10453,6,suad sehovic,17,1,5,20,1,1,100,0,4,0,0,0,0,2,3,5,0,1,1,0,0,2
440756,499_14_24,MONTENEGRO,19707,7,vladimir dragicevic,23,9,16,56.2,9,16,56.2,0,0,0,2,2,100,5,4,9,0,0,1,2,0,20
440757,499_14_24,MONTENEGRO,10457,8,sead sehovic,34,3,7,42.9,1,3,33.3,2,4,50,1,2,50,0,3,3,2,0,4,0,1,9
440758,499_14_24,MONTENEGRO,1863,9,vladimir golubovic,22,5,6,83.3,5,6,83.3,0,0,0,0,0,0,4,3,7,1,0,1,1,1,10
440759,499_14_24,MONTENEGRO,24211,10,taylor campbell rochestie,16,2,11,18.2,2,6,33.3,0,5,0,0,0,0,0,3,3,1,4,2,1,0,4
440760,499_14_24,MONTENEGRO,19706,11,milko bjelica,8,0,2,0,0,1,0,0,1,0,0,0,0,1,4,5,0,0,0,0,0,0
440761,499_14_24,MONTENEGRO,11120,12,nemanja radovic,32,2,6,33.3,1,2,50,1,4,25,2,2,100,3,5,8,2,4,1,0,0,7
440762,499_14_24,MONTENEGRO,1723,14,ivan maras,0,0,0,0,0,0,0,0,0,0,0,0,0,0,0,0,0,0,0,0,0,0
440763,499_14_24,MONTENEGRO,10455,15,aleksa popovic,19,1,1,100,1,1,100,0,0,0,1,2,50,2,2,4,0,2,0,1,1,3
440764,499_14_24,MONTENEGRO,15868,20,nikola ivanovic,25,6,14,42.9,6,13,46.2,0,1,0,0,0,0,2,1,3,2,3,1,2,0,12
440765,499_14_24,MONTENEGRO,15355,22,milos borisov,5,0,1,0,0,0,0,0,1,0,0,0,0,0,1,1,0,0,0,1,0,0
440766,499_14_24,MONTENEGRO,0,TOTALS,MONTENEGRO,225,30,76,39.5,27,52,51.9,3,24,12.5,7,9,77.8,19,31,50,14,16,13,8,3,70
440767,499_14_24,BULGARIA,8350,7,hristo zahariev,3,0,1,0,0,1,0,0,0,0,0,0,0,0,0,0,0,0,1,0,0,0
440768,499_14_24,BULGARIA,7960,9,pavel marinov,27,5,9,55.6,4,6,66.7,1,3,33.3,0,0,0,0,3,3,1,2,2,0,0,11
440769,499_14_24,BULGARIA,8347,10,bozhidar avramov,36,3,10,30,3,8,37.5,0,2,0,1,2,50,0,4,4,3,1,1,0,0,7
440770,499_14_24,BULGARIA,8346,12,aleksandar georgiev,1,0,0,0,0,0,0,0,0,0,0,0,0,0,0,0,0,0,0,0,0,0
440771,499_14_24,BULGARIA,1675,13,asen velikov,10,1,3,33.3,1,2,50,0,1,0,0,0,0,0,0,0,2,0,0,1,0,2
440772,499_14_24,BULGARIA,2852,14,chavdar kostov,29,5,8,62.5,4,6,66.7,1,2,50,0,0,0,1,3,4,2,3,3,1,0,11
440773,499_14_24,BULGARIA,5588,21,nikolay varbanov,37,3,6,50,3,6,50,0,0,0,1,3,33.3,1,4,5,0,3,2,0,3,7
440774,499_14_24,BULGARIA,2851,22,pavel ivanov,6,0,0,0,0,0,0,0,0,0,0,0,0,0,0,0,0,1,0,1,0,0
440775,499_14_24,BULGARIA,15604,23,stanimir marinov,25,4,9,44.4,4,8,50,0,1,0,1,2,50,0,5,5,3,4,2,2,0,9
440776,499_14_24,BULGARIA,7959,24,kostadin marshavelski,7,1,1,100,1,1,100,0,0,0,1,2,50,1,0,1,0,2,0,0,0,3
440777,499_14_24,BULGARIA,17555,41,aleksandar vezenkov,33,6,14,42.9,4,8,50,2,6,33.3,0,0,0,2,6,8,2,2,1,1,0,14
440778,499_14_24,BULGARIA,13088,50,dimitar dimitrov,11,0,1,0,0,1,0,0,0,0,0,0,0,0,1,1,0,0,1,1,0,0
440779,499_14_24,BULGARIA,0,TOTALS,BULGARIA,225,28,62,45.2,24,47,51.1,4,15,26.7,4,9,44.4,9,28,37,13,18,13,7,3,64
440780,499_14_25,BELGIUM,10156,4,lionel georges m bosco,27,3,5,60,1,3,33.3,2,2,100,2,2,100,0,2,2,6,2,2,0,0,10
440781,499_14_25,BELGIUM,19894,6,kevin tumba,13,1,2,50,1,2,50,0,0,0,0,0,0,0,2,2,0,3,1,0,3,2
440782,499_14_25,BELGIUM,4548,7,axel hervelle,11,1,4,25,1,3,33.3,0,1,0,0,0,0,1,0,1,1,4,1,3,0,2
440783,499_14_25,BELGIUM,6157,8,jean-marc mwema,18,1,2,50,1,1,100,0,1,0,0,0,0,1,5,6,1,1,1,1,0,2
440784,499_14_25,BELGIUM,10706,9,olivier troisfontaines,7,0,3,0,0,0,0,0,3,0,1,2,50,0,2,2,1,1,0,0,0,1
440785,499_14_25,BELGIUM,13030,10,loic robin b. schwartz,17,4,7,57.1,0,0,0,4,7,57.1,0,2,0,0,0,0,0,3,0,3,0,12
440786,499_14_25,BELGIUM,19709,11,guy muya,22,4,6,66.7,3,5,60,1,1,100,2,4,50,0,2,2,2,1,2,1,0,11
440787,499_14_25,BELGIUM,24196,12,wen-boss mukubu,20,4,8,50,3,5,60,1,3,33.3,0,0,0,4,1,5,2,2,2,0,0,9
440788,499_14_25,BELGIUM,11181,13,pierre-antoine gillet,22,3,8,37.5,2,4,50,1,4,25,0,0,0,2,2,4,2,0,0,0,0,7
440789,499_14_25,BELGIUM,10498,14,maxime de zeeuw,21,4,9,44.4,2,4,50,2,5,40,1,1,100,3,6,9,0,3,3,1,0,11
440790,499_14_25,BELGIUM,4550,20,roel moors,13,1,2,50,1,1,100,0,1,0,2,2,100,1,3,4,2,0,4,0,0,4
440791,499_14_25,BELGIUM,29508,24,matt lojeski,10,0,2,0,0,0,0,0,2,0,0,0,0,0,0,0,0,0,1,0,0,0
440792,499_14_25,BELGIUM,0,TOTALS,BELGIUM,200,26,58,44.8,15,28,53.6,11,30,36.7,8,13,61.5,12,26,38,17,20,18,9,3,71
440793,499_14_25,DENMARK,29522,4,darko jukic,26,5,10,50,4,9,44.4,1,1,100,3,4,75,2,2,4,0,2,1,2,1,14
440794,499_14_25,DENMARK,16165,5,frederik rungby,16,1,2,50,1,2,50,0,0,0,0,0,0,3,1,4,0,1,2,2,0,2
440795,499_14_25,DENMARK,24492,6,tobias reinholt,12,1,2,50,1,2,50,0,0,0,0,0,0,0,2,2,0,0,1,0,0,2
440796,499_14_25,DENMARK,16162,7,esben reinholt,27,2,9,22.2,0,4,0,2,5,40,2,4,50,1,2,3,2,1,3,1,0,8
440797,499_14_25,DENMARK,21908,8,gabriel lundberg,18,2,5,40,2,5,40,0,0,0,1,2,50,1,1,2,0,2,3,1,0,5
440798,499_14_25,DENMARK,12662,9,alexander heidenheim bak,8,0,1,0,0,1,0,0,0,0,0,0,0,0,1,1,0,1,1,0,0,0
440799,499_14_25,DENMARK,10649,10,mathias seilund,28,1,5,20,0,1,0,1,4,25,0,2,0,2,2,4,1,3,3,1,0,3
440800,499_14_25,DENMARK,15650,11,thomas sebastian laerke,20,2,6,33.3,1,2,50,1,4,25,0,0,0,0,4,4,2,4,3,1,0,5
440801,499_14_25,DENMARK,17655,12,peter moeller,12,1,3,33.3,1,3,33.3,0,0,0,0,0,0,0,0,0,0,0,1,0,0,2
440802,499_14_25,DENMARK,29523,13,asger hjorth,3,0,0,0,0,0,0,0,0,0,0,0,0,0,0,0,0,1,1,0,0,0
440803,499_14_25,DENMARK,13180,14,anders kristoffer haas,7,0,1,0,0,0,0,0,1,0,0,0,0,0,0,0,0,2,2,0,0,0
440804,499_14_25,DENMARK,12663,15,jonas zohore bergstedt,24,4,10,40,4,10,40,0,0,0,1,2,50,3,4,7,0,2,2,1,0,9
440805,499_14_25,DENMARK,0,TOTALS,DENMARK,200,19,54,35.2,14,39,35.9,5,15,33.3,7,14,50,13,22,35,5,19,25,9,1,50
440806,499_14_26,PORTUGAL,2730,4,jose silva,38,10,21,47.6,5,10,50,5,11,45.5,1,2,50,0,3,3,3,2,2,1,1,26
440807,499_14_26,PORTUGAL,8199,5,joao soares,29,4,10,40,4,9,44.4,0,1,0,5,7,71.4,4,5,9,2,4,2,2,0,13
440808,499_14_26,PORTUGAL,8195,6,jose barbosa,0,0,0,0,0,0,0,0,0,0,0,0,0,0,0,0,0,0,0,0,0,0
440809,499_14_26,PORTUGAL,15697,7,carlos diogo serra ferreirinho,0,0,0,0,0,0,0,0,0,0,0,0,0,0,0,0,0,0,0,0,0,0
440810,499_14_26,PORTUGAL,10266,8,mario fernandes,35,5,15,33.3,2,7,28.6,3,8,37.5,4,4,100,1,1,2,8,4,1,1,0,17
440811,499_14_26,PORTUGAL,2736,10,fabio lima,31,3,7,42.9,0,1,0,3,6,50,0,0,0,1,1,2,4,2,3,2,0,9
440812,499_14_26,PORTUGAL,10956,11,miguel queiroz,17,1,4,25,1,3,33.3,0,1,0,0,0,0,0,3,3,0,5,1,1,0,2
440813,499_14_26,PORTUGAL,8200,12,joao guerreiro,23,2,6,33.3,2,5,40,0,1,0,0,0,0,4,3,7,2,5,1,0,0,4
440814,499_14_26,PORTUGAL,7851,13,joao balseiro,13,2,7,28.6,1,5,20,1,2,50,0,0,0,0,1,1,1,1,0,0,0,5
440815,499_14_26,PORTUGAL,2732,14,pedro pinto,14,4,7,57.1,3,5,60,1,2,50,2,2,100,0,1,1,2,4,2,0,0,11
440816,499_14_26,PORTUGAL,2918,21,claudio fonseca,7,0,0,0,0,0,0,0,0,0,0,0,0,0,1,1,1,5,0,0,1,0
440817,499_14_26,PORTUGAL,29527,22,arnette hallman,17,0,2,0,0,2,0,0,0,0,3,4,75,2,3,5,1,5,4,0,0,3
440818,499_14_26,PORTUGAL,0,TOTALS,PORTUGAL,225,31,79,39.2,18,47,38.3,13,32,40.6,15,19,78.9,12,22,34,24,37,16,7,2,90
440819,499_14_26,GEORGIA,16023,5,otar pkhakadze,1,0,0,0,0,0,0,0,0,0,0,0,0,0,0,0,0,0,0,0,0,0
440820,499_14_26,GEORGIA,4919,7,zaza pachulia,39,7,11,63.6,7,11,63.6,0,0,0,11,15,73.3,3,6,9,2,5,7,0,1,25
440821,499_14_26,GEORGIA,1690,8,george tsintsadze,44,2,8,25,0,1,0,2,7,28.6,5,8,62.5,1,1,2,5,1,2,2,1,11
440822,499_14_26,GEORGIA,15684,10,duda sanadze,11,1,1,100,1,1,100,0,0,0,2,2,100,0,0,0,0,2,0,1,0,4
440823,499_14_26,GEORGIA,12467,12,levan patsatsia,28,5,7,71.4,4,6,66.7,1,1,100,3,3,100,0,4,4,2,5,4,0,1,14
440824,499_14_26,GEORGIA,1699,13,viktor sanikidze,43,3,10,30,3,6,50,0,4,0,4,10,40,3,10,13,3,3,0,1,0,10
440825,499_14_26,GEORGIA,16022,15,beka burjanadze,22,2,4,50,2,2,100,0,2,0,3,5,60,1,3,4,0,4,2,2,0,7
440826,499_14_26,GEORGIA,8382,22,george sharabidze,0,0,0,0,0,0,0,0,0,0,0,0,0,0,0,0,0,0,0,0,0,0
440827,499_14_26,GEORGIA,11036,23,tornike shengelia,28,6,10,60,6,9,66.7,0,1,0,8,10,80,1,4,5,3,5,3,0,1,20
440828,499_14_26,GEORGIA,7836,24,mikhail berishvili,0,0,0,0,0,0,0,0,0,0,0,0,0,0,0,0,0,0,0,0,0,0
440829,499_14_26,GEORGIA,1693,25,besik lezhava,9,0,1,0,0,0,0,0,1,0,0,0,0,0,0,0,0,0,0,0,0,0
440830,499_14_26,GEORGIA,2604,31,beka tsivtsivadze,0,0,0,0,0,0,0,0,0,0,0,0,0,0,0,0,0,0,0,0,0,0
440831,499_14_26,GEORGIA,0,TOTALS,GEORGIA,225,26,52,50,23,36,63.9,3,16,18.8,36,53,67.9,9,28,37,15,25,18,6,4,91
440832,499_14_27,BELARUS,1646,4,kanstantsin yafremau,23,2,3,66.7,2,2,100,0,1,0,0,0,0,2,5,7,0,1,1,1,0,4
440833,499_14_27,BELARUS,15346,5,siarhei charykau,22,1,2,50,1,1,100,0,1,0,0,0,0,0,0,0,3,2,1,0,0,2
440834,499_14_27,BELARUS,16119,6,aliaksandr semianiuk,10,1,3,33.3,1,3,33.3,0,0,0,0,2,0,0,1,1,0,3,0,0,0,2
440835,499_14_27,BELARUS,29521,7,kiryl sitnik,20,5,10,50,2,4,50,3,6,50,2,2,100,1,3,4,2,0,2,0,0,15
440836,499_14_27,BELARUS,2847,8,mikita meshcharakou,0,0,0,0,0,0,0,0,0,0,0,0,0,0,0,0,0,0,0,0,0,0
440837,499_14_27,BELARUS,4916,9,mikalai aliakseyeu,11,2,5,40,2,5,40,0,0,0,2,2,100,1,1,2,1,1,1,0,0,6
440838,499_14_27,BELARUS,13157,10,vitali liutych,22,4,7,57.1,1,4,25,3,3,100,6,9,66.7,2,5,7,0,0,2,0,0,17
440839,499_14_27,BELARUS,997,11,dzmitry paliashchuk,23,0,4,0,0,1,0,0,3,0,0,0,0,3,7,10,1,3,1,1,0,0
440840,499_14_27,BELARUS,998,12,aliaksandr pustahvar,24,3,8,37.5,1,1,100,2,7,28.6,0,0,0,1,1,2,1,0,2,0,0,8
440841,499_14_27,BELARUS,5476,13,valery gandlin,0,0,0,0,0,0,0,0,0,0,0,0,0,0,0,0,0,0,0,0,0,0
440842,499_14_27,BELARUS,4915,14,aliaksandr kudrautsau,26,4,7,57.1,2,3,66.7,2,4,50,2,2,100,0,2,2,2,3,3,0,0,12
440843,499_14_27,BELARUS,1645,15,aliaksei trastsinetski,18,1,7,14.3,1,4,25,0,3,0,2,2,100,1,2,3,1,3,1,0,1,4
440844,499_14_27,BELARUS,0,TOTALS,BELARUS,200,23,56,41.1,13,28,46.4,10,28,35.7,14,19,73.7,12,29,41,11,16,14,2,1,70
440845,499_14_27,MKD,6304,4,ivica dimchevski,0,0,0,0,0,0,0,0,0,0,0,0,0,0,0,0,0,0,0,0,0,0
440846,499_14_27,MKD,22445,5,andrej magdevski,18,3,7,42.9,2,3,66.7,1,4,25,0,0,0,1,1,2,1,3,0,2,0,7
440847,499_14_27,MKD,7810,6,darko sokolov,26,3,7,42.9,0,2,0,3,5,60,2,2,100,1,2,3,5,2,0,0,0,11
440848,499_14_27,MKD,2709,7,aleksandar kostoski,18,5,10,50,2,4,50,3,6,50,2,2,100,1,1,2,3,1,1,1,0,15
440849,499_14_27,MKD,5892,8,vojdan stojanovski,21,3,8,37.5,1,4,25,2,4,50,0,0,0,0,2,2,3,0,1,1,0,8
440850,499_14_27,MKD,5892,9,damjan stojanovski,14,0,4,0,0,3,0,0,1,0,0,0,0,0,0,0,2,2,1,0,0,0
440851,499_14_27,MKD,6300,10,marko simonovski,24,4,9,44.4,1,4,25,3,5,60,0,0,0,1,0,1,1,3,1,1,0,11
440852,499_14_27,MKD,6306,11,vladimir brckov,0,0,0,0,0,0,0,0,0,0,0,0,0,0,0,0,0,0,0,0,0,0
440853,499_14_27,MKD,2714,12,bojan trajkovski,31,6,10,60,2,5,40,4,5,80,1,2,50,0,7,7,0,3,0,0,1,17
440854,499_14_27,MKD,11275,13,stojan gjuroski,15,1,2,50,1,1,100,0,1,0,0,0,0,1,0,1,0,0,2,0,0,2
440855,499_14_27,MKD,2715,14,marjan janeski,6,0,1,0,0,1,0,0,0,0,0,0,0,0,0,0,0,1,0,1,0,0
440856,499_14_27,MKD,29507,15,venard richard hendriks,28,3,7,42.9,3,7,42.9,0,0,0,4,4,100,4,6,10,3,4,2,2,0,10
440857,499_14_27,MKD,0,TOTALS,MKD,200,28,65,43.1,12,34,35.3,16,31,51.6,9,10,90,9,22,31,18,19,8,8,1,81
440858,499_14_28,CZECH REPUBLIC,29502,4,patrik auda,24,4,9,44.4,3,7,42.9,1,2,50,2,2,100,2,4,6,0,0,2,1,1,11
440859,499_14_28,CZECH REPUBLIC,12522,5,tomas pomikalek,0,0,0,0,0,0,0,0,0,0,0,0,0,0,0,0,0,0,0,0,0,0
440860,499_14_28,CZECH REPUBLIC,5478,6,pavel pumprla,39,6,10,60,5,7,71.4,1,3,33.3,1,2,50,3,4,7,0,1,2,3,1,14
440861,499_14_28,CZECH REPUBLIC,10700,7,vojtech hruban,27,4,10,40,2,6,33.3,2,4,50,1,1,100,0,1,1,2,2,4,0,0,11
440862,499_14_28,CZECH REPUBLIC,4774,9,jiri welsch,36,5,8,62.5,3,6,50,2,2,100,0,4,0,0,6,6,7,4,3,3,0,12
440863,499_14_28,CZECH REPUBLIC,10702,10,lukas palyza,7,0,2,0,0,1,0,0,1,0,0,0,0,0,0,0,0,2,0,0,0,0
440864,499_14_28,CZECH REPUBLIC,4775,11,lubos barton,20,0,3,0,0,1,0,0,2,0,3,4,75,1,4,5,1,0,1,0,0,3
440865,499_14_28,CZECH REPUBLIC,12850,12,ondrej balvin,32,6,8,75,6,8,75,0,0,0,1,2,50,1,5,6,3,3,2,0,1,13
440866,499_14_28,CZECH REPUBLIC,10484,13,jakub sirina,11,0,3,0,0,2,0,0,1,0,0,0,0,1,0,1,1,2,1,3,0,0
440867,499_14_28,CZECH REPUBLIC,7823,14,kamil svrdlik,1,0,2,0,0,2,0,0,0,0,1,2,50,1,0,1,0,0,0,0,0,1
440868,499_14_28,CZECH REPUBLIC,19726,21,ales chan,0,0,0,0,0,0,0,0,0,0,0,0,0,0,0,0,0,0,0,0,0,0
440869,499_14_28,CZECH REPUBLIC,1096,22,pavel houska,2,0,0,0,0,0,0,0,0,0,1,2,50,0,0,0,0,0,0,0,0,1
440870,499_14_28,CZECH REPUBLIC,0,TOTALS,CZECH REPUBLIC,200,25,55,45.5,19,40,47.5,6,15,40,10,19,52.6,11,24,35,14,14,15,10,3,66
440871,499_14_28,HUNGARY,4537,5,gabor denes,21,1,4,25,1,3,33.3,0,1,0,0,0,0,1,0,1,0,4,0,1,0,2
440872,499_14_28,HUNGARY,12503,6,akos keller,25,6,9,66.7,6,9,66.7,0,0,0,0,1,0,1,2,3,0,2,0,1,1,12
440873,499_14_28,HUNGARY,1125,7,krisztian wittmann,18,2,5,40,1,2,50,1,3,33.3,0,0,0,0,2,2,3,4,1,0,0,5
440874,499_14_28,HUNGARY,8415,9,david vojvoda,33,8,14,57.1,4,8,50,4,6,66.7,5,6,83.3,1,1,2,1,3,4,1,0,25
440875,499_14_28,HUNGARY,2743,10,zoltan supola,8,1,3,33.3,1,2,50,0,1,0,0,0,0,0,0,0,1,0,1,0,0,2
440876,499_14_28,HUNGARY,1942,11,norbert toth,18,1,1,100,1,1,100,0,0,0,0,0,0,0,3,3,0,1,2,0,0,2
440877,499_14_28,HUNGARY,2750,12,milan csorvasi,0,0,0,0,0,0,0,0,0,0,0,0,0,0,0,0,0,0,0,0,0,0
440878,499_14_28,HUNGARY,2751,13,adam toth,15,3,5,60,3,5,60,0,0,0,2,2,100,6,3,9,0,3,0,1,0,8
440879,499_14_28,HUNGARY,29528,14,jermaine dontay thomas,27,0,9,0,0,6,0,0,3,0,0,0,0,1,3,4,3,4,2,1,0,0
440880,499_14_28,HUNGARY,1123,15,csaba ferencz,19,1,3,33.3,0,1,0,1,2,50,0,0,0,0,2,2,0,1,2,1,0,3
440881,499_14_28,HUNGARY,8051,21,andras rujak,15,2,6,33.3,2,5,40,0,1,0,0,0,0,0,3,3,1,0,2,0,0,4
440882,499_14_28,HUNGARY,11148,22,janos eilingsfeld,0,0,0,0,0,0,0,0,0,0,0,0,0,0,0,0,0,0,0,0,0,0
440883,499_14_28,HUNGARY,0,TOTALS,HUNGARY,200,25,59,42.4,19,42,45.2,6,17,35.3,7,9,77.8,11,22,33,9,22,15,6,1,63
440884,499_14_29,SLOVAK REPUBLIC,15367,4,marek kozlik,13,1,2,50,1,2,50,0,0,0,0,0,0,1,0,1,0,2,0,0,0,2
440885,499_14_29,SLOVAK REPUBLIC,6339,5,peter dorazil,0,0,0,0,0,0,0,0,0,0,0,0,0,0,0,0,0,0,0,0,0,0
440886,499_14_29,SLOVAK REPUBLIC,1154,6,peter sedmak,36,9,17,52.9,8,12,66.7,1,5,20,4,8,50,0,4,4,1,2,1,0,1,23
440887,499_14_29,SLOVAK REPUBLIC,11264,7,tomas mrvis,20,2,3,66.7,1,2,50,1,1,100,2,2,100,0,1,1,1,2,2,0,0,7
440888,499_14_29,SLOVAK REPUBLIC,10469,8,milan ziak,22,3,6,50,3,5,60,0,1,0,0,0,0,4,4,8,3,1,2,0,1,6
440889,499_14_29,SLOVAK REPUBLIC,5862,9,martin bilik,24,2,6,33.3,2,4,50,0,2,0,0,0,0,1,3,4,0,5,4,1,0,4
440890,499_14_29,SLOVAK REPUBLIC,29524,10,nenad milosevic,27,6,10,60,3,5,60,3,5,60,2,2,100,0,1,1,3,4,3,0,0,17
440891,499_14_29,SLOVAK REPUBLIC,6335,11,stanislav baldovsky,4,0,0,0,0,0,0,0,0,0,0,0,0,0,0,0,0,0,1,0,0,0
440892,499_14_29,SLOVAK REPUBLIC,13095,12,maurizio galata,3,0,4,0,0,4,0,0,0,0,0,0,0,2,0,2,0,1,0,0,0,0
440893,499_14_29,SLOVAK REPUBLIC,12668,13,andrej kuffa,26,4,5,80,3,3,100,1,2,50,2,2,100,1,4,5,1,3,3,3,1,11
440894,499_14_29,SLOVAK REPUBLIC,8444,15,marek jass,26,0,2,0,0,2,0,0,0,0,2,2,100,0,4,4,2,3,0,6,0,2
440895,499_14_29,SLOVAK REPUBLIC,0,TOTALS,SLOVAK REPUBLIC,200,27,55,49.1,21,39,53.8,6,16,37.5,12,16,75,9,23,32,11,23,17,10,3,72
440896,499_14_29,SWEDEN,20455,4,ludvig hakanson,0,0,0,0,0,0,0,0,0,0,0,0,0,0,0,0,0,0,0,0,0,0
440897,499_14_29,SWEDEN,16053,5,tobias borg,21,2,8,25,1,4,25,1,4,25,0,0,0,0,1,1,1,1,0,0,1,5
440898,499_14_29,SWEDEN,4748,6,joakim kjellbom,26,6,8,75,6,8,75,0,0,0,1,1,100,5,4,9,1,2,2,2,0,13
440899,499_14_29,SWEDEN,10481,7,dino pita,13,0,4,0,0,2,0,0,2,0,2,2,100,1,0,1,2,1,0,0,0,2
440900,499_14_29,SWEDEN,10740,8,john gaddefors,24,4,10,40,1,4,25,3,6,50,2,2,100,1,2,3,0,4,1,0,1,13
440901,499_14_29,SWEDEN,1176,9,thomas massamba,26,3,8,37.5,2,3,66.7,1,5,20,0,0,0,3,2,5,4,4,2,3,0,7
440902,499_14_29,SWEDEN,1972,10,martin pahlmblad,33,6,13,46.2,4,7,57.1,2,6,33.3,0,0,0,0,2,2,1,1,3,1,0,14
440903,499_14_29,SWEDEN,5844,11,tom liden,0,0,0,0,0,0,0,0,0,0,0,0,0,0,0,0,0,0,0,0,0,0
440904,499_14_29,SWEDEN,2702,12,brice massamba,13,2,2,100,2,2,100,0,0,0,5,6,83.3,3,2,5,1,3,2,0,1,9
440905,499_14_29,SWEDEN,11099,14,alexander lindqvist,18,1,4,25,0,1,0,1,3,33.3,0,0,0,0,1,1,1,2,1,2,0,3
440906,499_14_29,SWEDEN,13061,15,jonathan person,26,2,6,33.3,2,4,50,0,2,0,5,6,83.3,1,1,2,3,1,2,1,0,9
440907,499_14_29,SWEDEN,15688,40,carl engstrom,0,0,0,0,0,0,0,0,0,0,0,0,0,0,0,0,0,0,0,0,0,0
440908,499_14_29,SWEDEN,0,TOTALS,SWEDEN,200,26,63,41.3,18,35,51.4,8,28,28.6,15,17,88.2,15,19,34,14,19,14,9,3,75
440909,499_14_30,GERMANY,8244,7,akeem vargas,20,2,3,66.7,1,1,100,1,2,50,0,0,0,0,3,3,1,2,1,2,0,5
440910,499_14_30,GERMANY,15385,8,heiko schaffartzik,17,3,4,75,1,1,100,2,3,66.7,1,2,50,0,1,1,6,1,3,1,0,9
440911,499_14_30,GERMANY,10446,9,karsten tadda,18,4,5,80,1,1,100,3,4,75,1,2,50,0,1,1,3,0,1,1,0,12
440912,499_14_30,GERMANY,5747,10,lucca staiger,19,4,8,50,0,0,0,4,8,50,0,1,0,0,4,4,2,1,5,0,0,12
440913,499_14_30,GERMANY,6326,12,robin benzing,15,2,5,40,2,2,100,0,3,0,2,2,100,1,1,2,2,0,2,1,0,6
440914,499_14_30,GERMANY,15492,13,bastian doreth,13,2,4,50,1,1,100,1,3,33.3,0,0,0,0,2,2,3,0,1,1,0,5
440915,499_14_30,GERMANY,15493,14,andreas seiferth,12,5,6,83.3,5,6,83.3,0,0,0,2,5,40,1,3,4,1,2,0,0,0,12
440916,499_14_30,GERMANY,6324,20,elias harris,22,5,5,100,4,4,100,1,1,100,1,2,50,1,4,5,2,0,1,1,0,12
440917,499_14_30,GERMANY,19866,21,daniel theis,18,2,3,66.7,2,3,66.7,0,0,0,2,2,100,5,7,12,0,3,1,2,0,6
440918,499_14_30,GERMANY,19990,22,dennis schroder,18,4,6,66.7,3,4,75,1,2,50,0,0,0,0,0,0,4,1,2,0,0,9
440919,499_14_30,GERMANY,19867,25,johannes voigtmann,15,4,6,66.7,4,6,66.7,0,0,0,1,1,100,1,8,9,1,2,2,0,0,9
440920,499_14_30,GERMANY,12608,33,maik hendrik zirbes,14,6,6,100,6,6,100,0,0,0,0,0,0,1,4,5,0,0,3,0,0,12
440921,499_14_30,GERMANY,0,TOTALS,GERMANY,200,43,61,70.5,30,35,85.7,13,26,50,10,17,58.8,12,41,53,25,12,23,9,0,109
440922,499_14_30,LUXEMBOURG,5011,4,tom schumacher,33,4,10,40,3,6,50,1,4,25,0,0,0,1,3,4,4,4,3,4,0,9
440923,499_14_30,LUXEMBOURG,5918,5,pitt koster,15,0,2,0,0,2,0,0,0,0,0,0,0,0,1,1,2,1,2,0,0,0
440924,499_14_30,LUXEMBOURG,2966,6,raul leandro birenbaum,17,2,4,50,0,0,0,2,4,50,1,2,50,0,0,0,1,1,1,0,0,7
440925,499_14_30,LUXEMBOURG,8344,8,christopher c. g. jones,17,5,9,55.6,4,4,100,1,5,20,1,2,50,2,2,4,1,0,2,1,0,12
440926,499_14_30,LUXEMBOURG,19727,10,patrick arbaut,13,1,4,25,1,2,50,0,2,0,0,0,0,0,2,2,0,0,1,1,0,2
440927,499_14_30,LUXEMBOURG,13285,11,bob melcher,13,1,4,25,1,3,33.3,0,1,0,0,0,0,0,0,0,1,1,0,1,0,2
440928,499_14_30,LUXEMBOURG,19728,12,alexandre rodenbourg,18,1,3,33.3,0,0,0,1,3,33.3,0,0,0,0,0,0,0,3,1,0,0,3
440929,499_14_30,LUXEMBOURG,8340,22,jean nicolas c. kox,16,0,4,0,0,3,0,0,1,0,0,0,0,1,0,1,0,3,0,0,0,0
440930,499_14_30,LUXEMBOURG,1283,23,jairo emanuel delgado ferreira,26,1,6,16.7,1,2,50,0,4,0,0,0,0,0,0,0,2,0,2,2,0,2
440931,499_14_30,LUXEMBOURG,17901,24,thomas grun,6,1,3,33.3,1,1,100,0,2,0,1,1,100,0,0,0,0,0,1,0,0,3
440932,499_14_30,LUXEMBOURG,29517,30,dominique benseghir,3,0,1,0,0,0,0,0,1,0,0,0,0,0,0,0,1,0,1,0,0,0
440933,499_14_30,LUXEMBOURG,13176,31,alex laurent,23,4,13,30.8,4,8,50,0,5,0,1,2,50,0,1,1,0,2,1,0,0,9
440934,499_14_30,LUXEMBOURG,0,TOTALS,LUXEMBOURG,200,20,63,31.7,15,31,48.4,5,32,15.6,4,7,57.1,4,9,13,12,15,16,9,0,49
440935,499_14_31,BOSNIA AND HERZEGOVINA,5859,4,muhamed pasalic,10,1,3,33.3,0,0,0,1,3,33.3,0,0,0,1,0,1,0,2,0,0,0,3
440936,499_14_31,BOSNIA AND HERZEGOVINA,20566,5,nedim buza,8,1,3,33.3,1,2,50,0,1,0,0,0,0,1,2,3,0,1,1,0,0,2
440937,499_14_31,BOSNIA AND HERZEGOVINA,7780,6,andrija stipanovic,31,4,13,30.8,4,13,30.8,0,0,0,0,2,0,5,4,9,0,3,1,0,0,8
440938,499_14_31,BOSNIA AND HERZEGOVINA,24189,7,marko sutalo,27,4,8,50,2,2,100,2,6,33.3,1,2,50,0,3,3,2,3,0,2,0,11
440939,499_14_31,BOSNIA AND HERZEGOVINA,17435,8,stefan glogovac,0,0,0,0,0,0,0,0,0,0,0,0,0,0,0,0,0,0,0,0,0,0
440940,499_14_31,BOSNIA AND HERZEGOVINA,2887,10,nemanja gordic,33,3,6,50,2,4,50,1,2,50,0,0,0,0,1,1,5,2,1,0,0,7
440941,499_14_31,BOSNIA AND HERZEGOVINA,2891,11,elmedin kikanovic,18,2,8,25,2,8,25,0,0,0,5,7,71.4,4,5,9,0,2,6,0,1,9
440942,499_14_31,BOSNIA AND HERZEGOVINA,4561,12,mirza teletovic,27,11,23,47.8,7,11,63.6,4,12,33.3,3,5,60,2,10,12,2,1,2,2,1,29
440943,499_14_31,BOSNIA AND HERZEGOVINA,11206,13,miralem halilovic,5,0,0,0,0,0,0,0,0,0,0,0,0,0,1,1,0,1,1,0,0,0
440944,499_14_31,BOSNIA AND HERZEGOVINA,24216,14,nemanja mitrovic,20,0,3,0,0,2,0,0,1,0,0,0,0,0,5,5,1,3,0,1,0,0
440945,499_14_31,BOSNIA AND HERZEGOVINA,15282,15,milan milosevic,19,1,2,50,0,0,0,1,2,50,0,0,0,2,7,9,0,3,0,0,1,3
440946,499_14_31,BOSNIA AND HERZEGOVINA,17436,22,adin vrabac,3,0,1,0,0,1,0,0,0,0,0,0,0,1,1,2,0,1,1,0,0,0
440947,499_14_31,BOSNIA AND HERZEGOVINA,0,TOTALS,BOSNIA AND HERZEGOVINA,200,27,70,38.6,18,43,41.9,9,27,33.3,9,16,56.2,18,40,58,10,22,13,5,3,72
440948,499_14_31,ICELAND,24208,4,axel karason,13,1,3,33.3,0,1,0,1,2,50,0,0,0,0,1,1,0,2,0,0,0,3
440949,499_14_31,ICELAND,13211,5,haukur palsson,14,0,5,0,0,3,0,0,2,0,2,2,100,0,2,2,0,3,1,0,0,2
440950,499_14_31,ICELAND,21997,6,elvar mar fridriksson,24,2,8,25,1,5,20,1,3,33.3,1,2,50,2,3,5,1,1,0,2,1,6
440951,499_14_31,ICELAND,2760,7,sigurdur gunnar thorsteinsson,7,1,3,33.3,1,3,33.3,0,0,0,0,0,0,1,2,3,1,0,0,0,0,2
440952,499_14_31,ICELAND,4841,8,hlynur baeringsson,19,0,4,0,0,4,0,0,0,0,0,0,0,1,4,5,1,2,2,0,0,0
440953,499_14_31,ICELAND,19926,9,martin hermannsson,28,2,10,20,2,8,25,0,2,0,5,5,100,1,5,6,1,0,4,1,0,9
440954,499_14_31,ICELAND,8257,10,olafur olafsson,7,0,2,0,0,1,0,0,1,0,0,0,0,0,0,0,0,2,0,0,0,0
440955,499_14_31,ICELAND,4839,11,sigurdur thorvaldsson,13,1,5,20,0,1,0,1,4,25,2,2,100,1,3,4,0,2,0,0,0,5
440956,499_14_31,ICELAND,15700,12,ragnar agust nathanaelsson,16,1,2,50,1,2,50,0,0,0,1,5,20,2,1,3,0,1,0,0,0,3
440957,499_14_31,ICELAND,2764,13,hordur vilhjalmsson,26,6,8,75,4,5,80,2,3,66.7,0,1,0,0,1,1,2,0,2,2,0,14
440958,499_14_31,ICELAND,4980,14,logi gunnarsson,31,7,15,46.7,4,9,44.4,3,6,50,1,2,50,0,4,4,1,3,0,0,2,18
440959,499_14_31,ICELAND,2071,15,pavel ermolinskij,0,0,0,0,0,0,0,0,0,0,0,0,0,0,0,0,0,0,0,0,0,0
440960,499_14_31,ICELAND,0,TOTALS,ICELAND,200,21,65,32.3,13,42,31,8,23,34.8,12,19,63.2,9,27,36,7,16,9,5,3,62
440961,499_14_32,LATVIA,19755,5,mareks mejeris,15,4,5,80,4,4,100,0,1,0,2,4,50,4,1,5,1,2,0,0,0,10
440962,499_14_32,LATVIA,2539,6,rolands freimanis,18,5,7,71.4,4,4,100,1,3,33.3,0,0,0,1,3,4,0,4,1,0,0,11
440963,499_14_32,LATVIA,5029,7,janis blums,22,6,9,66.7,2,3,66.7,4,6,66.7,1,2,50,0,2,2,1,1,1,1,0,17
440964,499_14_32,LATVIA,6271,9,dairis bertans,24,1,6,16.7,0,1,0,1,5,20,5,5,100,2,2,4,1,2,2,0,0,8
440965,499_14_32,LATVIA,12927,10,janis timma,24,1,3,33.3,1,3,33.3,0,0,0,3,6,50,0,3,3,3,3,0,4,0,5
440966,499_14_32,LATVIA,20350,11,rolands smits,1,0,1,0,0,1,0,0,0,0,0,0,0,0,0,0,0,0,0,0,0,0
440967,499_14_32,LATVIA,4604,12,kristaps janicenoks,22,2,9,22.2,2,5,40,0,4,0,5,5,100,0,0,0,2,2,0,0,0,9
440968,499_14_32,LATVIA,10585,13,janis strelnieks,22,4,7,57.1,4,5,80,0,2,0,4,4,100,0,0,0,6,1,4,1,0,12
440969,499_14_32,LATVIA,1002,14,kaspars berzins,26,3,8,37.5,3,8,37.5,0,0,0,2,4,50,6,3,9,0,2,2,1,1,8
440970,499_14_32,LATVIA,29525,21,aigars skele,13,2,3,66.7,1,1,100,1,2,50,0,0,0,0,1,1,5,2,1,1,0,5
440971,499_14_32,LATVIA,5721,30,ronalds zakis,5,0,1,0,0,1,0,0,0,0,0,0,0,0,0,0,0,0,1,0,2,0
440972,499_14_32,LATVIA,15602,33,martins meiers,10,1,2,50,1,2,50,0,0,0,1,2,50,1,1,2,0,3,0,1,0,3
440973,499_14_32,LATVIA,0,TOTALS,LATVIA,200,29,61,47.5,22,38,57.9,7,23,30.4,23,32,71.9,16,21,37,19,22,13,9,3,88
440974,499_14_32,ROMANIA,2115,4,andrei mandache,16,0,1,0,0,0,0,0,1,0,2,2,100,0,1,1,1,2,3,0,0,2
440975,499_14_32,ROMANIA,10239,5,mihail-octavian paul,5,0,1,0,0,1,0,0,0,0,0,0,0,0,1,1,1,0,0,0,0,0
440976,499_14_32,ROMANIA,5015,6,levente szijarto,27,1,3,33.3,1,1,100,0,2,0,0,0,0,2,3,5,1,3,1,1,0,2
440977,499_14_32,ROMANIA,2900,9,vlad moldoveanu,23,7,13,53.8,4,7,57.1,3,6,50,0,0,0,0,2,2,0,3,1,2,0,17
440978,499_14_32,ROMANIA,2915,10,catalin baciu,14,4,6,66.7,4,6,66.7,0,0,0,2,4,50,1,2,3,0,2,1,0,0,10
440979,499_14_32,ROMANIA,15354,11,octavian calota-popa,5,0,1,0,0,1,0,0,0,0,0,0,0,0,0,0,0,1,1,0,0,0
440980,499_14_32,ROMANIA,11102,12,bogdan tibirna,5,0,0,0,0,0,0,0,0,0,0,0,0,0,0,0,0,1,0,0,0,0
440981,499_14_32,ROMANIA,15358,13,teodor gabriel jucan,13,0,0,0,0,0,0,0,0,0,0,0,0,0,0,0,0,4,0,0,0,0
440982,499_14_32,ROMANIA,2125,14,titus nicoara,16,4,9,44.4,4,8,50,0,1,0,0,2,0,2,4,6,1,4,1,0,1,8
440983,499_14_32,ROMANIA,4965,15,mihai vlad silvasan,22,5,9,55.6,5,7,71.4,0,2,0,3,5,60,3,1,4,1,3,4,0,0,13
440984,499_14_32,ROMANIA,5016,21,adrian tudor,29,1,5,20,1,4,25,0,1,0,0,0,0,1,0,1,3,4,3,0,0,2
440985,499_14_32,ROMANIA,12712,44,adrian gutoaia,26,3,5,60,2,3,66.7,1,2,50,4,8,50,0,3,3,2,3,3,4,0,11
440986,499_14_32,ROMANIA,0,TOTALS,ROMANIA,200,25,53,47.2,21,38,55.3,4,15,26.7,11,21,52.4,9,18,27,10,30,18,7,1,65
440987,499_14_33,AUSTRIA,2103,5,thomas schreiner,28,2,7,28.6,0,1,0,2,6,33.3,0,0,0,0,3,3,4,1,0,2,0,6
440988,499_14_33,AUSTRIA,29530,8,enis murati,28,7,10,70,5,7,71.4,2,3,66.7,2,2,100,2,2,4,2,2,1,2,0,18
440989,499_14_33,AUSTRIA,16191,14,jozo rados,9,0,3,0,0,3,0,0,0,0,0,2,0,0,2,2,0,0,0,2,0,0
440990,499_14_33,AUSTRIA,8395,15,david hasenburger,15,3,6,50,3,4,75,0,2,0,0,0,0,2,0,2,1,2,0,0,0,6
440991,499_14_33,AUSTRIA,8392,20,romed vieider,0,0,0,0,0,0,0,0,0,0,0,0,0,0,0,0,0,0,0,0,0,0
440992,499_14_33,AUSTRIA,8396,24,rasid mahalbasic,31,10,15,66.7,9,14,64.3,1,1,100,3,4,75,2,3,5,4,4,1,2,1,24
440993,499_14_33,AUSTRIA,8386,25,jesse nii l. seilern und aspang,0,0,0,0,0,0,0,0,0,0,0,0,0,0,0,0,0,0,0,0,0,0
440994,499_14_33,AUSTRIA,6415,34,moritz lanegger,20,0,1,0,0,0,0,0,1,0,1,2,50,0,1,1,1,3,2,0,0,1
440995,499_14_33,AUSTRIA,12529,35,sebastian koch,18,3,11,27.3,1,4,25,2,7,28.6,0,0,0,0,2,2,1,1,0,0,0,8
440996,499_14_33,AUSTRIA,13271,41,maximilian hopfgartner,4,0,1,0,0,0,0,0,1,0,0,0,0,0,1,1,0,2,1,0,0,0
440997,499_14_33,AUSTRIA,11250,42,thomas klepeisz,24,3,5,60,1,2,50,2,3,66.7,5,5,100,1,1,2,0,2,0,1,0,13
440998,499_14_33,AUSTRIA,15717,43,anton maresch,24,2,4,50,1,1,100,1,3,33.3,2,2,100,0,1,1,3,1,5,1,1,7
440999,499_14_33,AUSTRIA,0,TOTALS,AUSTRIA,200,30,63,47.6,20,36,55.6,10,27,37,13,17,76.5,11,17,28,16,18,10,10,2,83
441000,499_14_33,POLAND,5694,5,aaron cel,25,5,9,55.6,3,6,50,2,3,66.7,2,2,100,2,2,4,2,2,3,0,0,14
441001,499_14_33,POLAND,4799,6,robert jozef skibniewski,31,4,6,66.7,0,1,0,4,5,80,0,0,0,0,2,2,6,4,3,1,0,12
441002,499_14_33,POLAND,7833,7,damian kulig,14,3,3,100,2,2,100,1,1,100,2,2,100,1,3,4,1,0,2,0,0,9
441003,499_14_33,POLAND,24194,8,przemyslaw zamojski,28,3,7,42.9,2,3,66.7,1,4,25,0,0,0,1,1,2,2,3,1,1,0,7
441004,499_14_33,POLAND,15981,9,mateusz ponitka,27,3,6,50,3,5,60,0,1,0,5,5,100,0,3,3,0,2,1,2,0,11
441005,499_14_33,POLAND,4804,10,szymon pawel szewczyk,18,3,8,37.5,2,4,50,1,4,25,1,2,50,1,1,2,0,2,1,0,0,8
441006,499_14_33,POLAND,8034,12,adam waczynski,31,4,10,40,2,6,33.3,2,4,50,1,1,100,3,5,8,2,1,6,1,1,11
441007,499_14_33,POLAND,19694,14,adam hrycaniuk,17,4,6,66.7,4,6,66.7,0,0,0,1,2,50,0,3,3,1,2,1,0,0,9
441008,499_14_33,POLAND,6190,15,kamil jacek laczynski,0,0,0,0,0,0,0,0,0,0,0,0,0,0,0,0,0,0,0,0,0,0
441009,499_14_33,POLAND,15983,21,tomasz gielo,9,0,0,0,0,0,0,0,0,0,0,0,0,0,2,2,0,1,1,1,1,0
441010,499_14_33,POLAND,15977,23,michal michalak,0,0,0,0,0,0,0,0,0,0,0,0,0,0,0,0,0,0,0,0,0,0
441011,499_14_33,POLAND,0,TOTALS,POLAND,200,29,55,52.7,18,33,54.5,11,22,50,12,14,85.7,9,23,32,14,17,19,6,2,81
441012,499_14_34,BULGARIA,8350,7,hristo zahariev,18,7,10,70,6,8,75,1,2,50,0,0,0,6,1,7,0,3,1,1,0,15
441013,499_14_34,BULGARIA,7960,9,pavel marinov,18,3,5,60,3,4,75,0,1,0,2,2,100,1,1,2,1,4,1,0,0,8
441014,499_14_34,BULGARIA,8347,10,bozhidar avramov,17,2,10,20,0,3,0,2,7,28.6,0,0,0,1,3,4,2,3,0,1,0,6
441015,499_14_34,BULGARIA,8346,12,aleksandar georgiev,7,0,0,0,0,0,0,0,0,0,0,0,0,0,0,0,1,2,2,0,0,0
441016,499_14_34,BULGARIA,1675,13,asen velikov,16,3,7,42.9,2,3,66.7,1,4,25,4,4,100,0,1,1,3,2,1,3,0,11
441017,499_14_34,BULGARIA,2852,14,chavdar kostov,15,2,5,40,1,2,50,1,3,33.3,0,0,0,0,0,0,1,1,0,0,0,5
441018,499_14_34,BULGARIA,10589,15,stanislav vaklinov,7,0,0,0,0,0,0,0,0,0,0,0,0,0,2,2,0,1,1,0,0,0
441019,499_14_34,BULGARIA,5588,21,nikolay varbanov,26,3,8,37.5,3,8,37.5,0,0,0,1,2,50,6,6,12,0,2,2,0,0,7
441020,499_14_34,BULGARIA,13084,22,pavlin ivanov,5,0,1,0,0,1,0,0,0,0,0,0,0,0,0,0,0,0,0,0,0,0
441021,499_14_34,BULGARIA,15604,23,stanimir marinov,24,3,10,30,1,5,20,2,5,40,3,4,75,1,1,2,5,0,4,0,0,11
441022,499_14_34,BULGARIA,17555,41,aleksandar vezenkov,34,7,12,58.3,5,8,62.5,2,4,50,2,2,100,4,1,5,2,2,1,1,1,18
441023,499_14_34,BULGARIA,13088,50,dimitar dimitrov,13,1,4,25,1,3,33.3,0,1,0,1,2,50,0,0,0,0,0,1,0,0,3
441024,499_14_34,BULGARIA,0,TOTALS,BULGARIA,200,31,72,43.1,22,45,48.9,9,27,33.3,13,16,81.2,20,17,37,15,20,14,6,1,84
441025,499_14_34,ISRAEL,1680,4,nitzan yehuda hanochi,11,0,0,0,0,0,0,0,0,0,0,0,0,0,1,1,0,2,0,1,0,0
441026,499_14_34,ISRAEL,4794,5,afik nissim,0,0,0,0,0,0,0,0,0,0,0,0,0,0,0,0,0,0,0,0,0,0
441027,499_14_34,ISRAEL,1022,6,raviv guy limonad,26,7,12,58.3,7,11,63.6,0,1,0,1,1,100,0,1,1,1,0,1,0,0,15
441028,499_14_34,ISRAEL,2522,7,gal mekel,35,6,10,60,6,8,75,0,2,0,4,4,100,0,2,2,7,2,2,2,0,16
441029,499_14_34,ISRAEL,1023,8,lior eliyahu,20,3,6,50,3,6,50,0,0,0,0,0,0,1,3,4,2,3,3,0,0,6
441030,499_14_34,ISRAEL,1933,9,omri casspi,24,7,11,63.6,6,9,66.7,1,2,50,4,4,100,0,2,2,2,2,2,2,1,19
441031,499_14_34,ISRAEL,10164,10,guy pnini,25,5,9,55.6,4,5,80,1,4,25,1,2,50,0,2,2,1,2,0,0,0,12
441032,499_14_34,ISRAEL,1019,12,yotam halperin,17,3,4,75,2,2,100,1,2,50,4,4,100,0,0,0,5,2,0,1,0,11
441033,499_14_34,ISRAEL,5780,13,elishay kadir,5,0,0,0,0,0,0,0,0,0,0,0,0,0,1,1,1,0,2,1,0,0
441034,499_14_34,ISRAEL,4620,14,yaniv green,10,0,1,0,0,1,0,0,0,0,0,0,0,0,3,3,0,0,0,0,1,0
441035,499_14_34,ISRAEL,29526,15,dor anthony naheem fischer,25,9,10,90,9,10,90,0,0,0,0,1,0,4,9,13,1,4,0,0,3,18
441036,499_14_34,ISRAEL,24229,21,dagan yivzori,2,1,1,100,0,0,0,1,1,100,0,0,0,0,0,0,0,1,0,0,0,3
441037,499_14_34,ISRAEL,0,TOTALS,ISRAEL,200,41,64,64.1,37,52,71.2,4,12,33.3,14,16,87.5,5,24,29,20,18,10,7,5,100
441038,499_14_35,ITALY,12988,5,alessandro gentile,31,6,10,60,4,5,80,2,5,40,3,4,75,1,4,5,5,3,1,0,0,17
441039,499_14_35,ITALY,1705,7,luca vitali,14,0,4,0,0,3,0,0,1,0,0,0,0,0,4,4,2,0,1,0,0,0
441040,499_14_35,ITALY,15319,12,marco cusin,21,2,3,66.7,2,3,66.7,0,0,0,2,2,100,1,7,8,0,0,1,0,2,6
441041,499_14_35,ITALY,1861,13,luigi datome,25,6,10,60,3,5,60,3,5,60,0,0,0,0,3,3,3,1,2,0,0,15
441042,499_14_35,ITALY,19847,14,riccardo cervi,16,3,4,75,3,4,75,0,0,0,1,2,50,3,3,6,0,3,1,0,3,7
441043,499_14_35,ITALY,19752,20,andrea cinciarini,28,1,5,20,1,4,25,0,1,0,8,8,100,0,3,3,6,2,2,1,0,10
441044,499_14_35,ITALY,10579,22,stefano gentile,12,1,3,33.3,0,0,0,1,3,33.3,0,0,0,0,2,2,1,1,0,0,0,3
441045,499_14_35,ITALY,10962,24,riccardo moraschini,2,0,0,0,0,0,0,0,0,0,0,0,0,0,1,1,1,0,0,0,0,0
441046,499_14_35,ITALY,17241,27,davide pascolo,2,0,1,0,0,1,0,0,0,0,0,0,0,0,0,0,0,0,0,0,0,0
441047,499_14_35,ITALY,15645,31,michele vitali,3,0,0,0,0,0,0,0,0,0,1,2,50,1,0,1,0,0,0,0,0,1
441048,499_14_35,ITALY,7944,33,pietro aradori,30,6,11,54.5,3,7,42.9,3,4,75,2,2,100,1,2,3,5,1,0,2,0,17
441049,499_14_35,ITALY,15644,34,achille polonara,15,4,7,57.1,1,1,100,3,6,50,3,4,75,1,2,3,1,1,0,1,1,14
441050,499_14_35,ITALY,0,TOTALS,ITALY,200,29,58,50,17,33,51.5,12,25,48,20,24,83.3,10,32,42,24,12,9,4,6,90
441051,499_14_35,SWITZERLAND,12691,4,jonathan malu kazadi-muyombu,23,1,5,20,1,3,33.3,0,2,0,0,0,0,1,1,2,1,3,1,0,0,2
441052,499_14_35,SWITZERLAND,7804,6,dusan mladjan,31,6,17,35.3,1,8,12.5,5,9,55.6,1,1,100,0,2,2,1,4,2,0,0,18
441053,499_14_35,SWITZERLAND,16096,7,marko mladjan,24,6,10,60,5,6,83.3,1,4,25,0,0,0,2,4,6,0,2,2,1,1,13
441054,499_14_35,SWITZERLAND,1260,8,cedric lionel mafuta,20,1,2,50,1,2,50,0,0,0,1,1,100,0,1,1,1,3,2,0,0,3
441055,499_14_35,SWITZERLAND,19748,9,roberto kovac,15,0,4,0,0,3,0,0,1,0,2,3,66.7,1,0,1,0,0,1,0,0,2
441056,499_14_35,SWITZERLAND,19912,10,alexis herrmann,0,0,0,0,0,0,0,0,0,0,0,0,0,0,0,0,0,0,0,0,0,0
441057,499_14_35,SWITZERLAND,10497,12,nicolas dos santos,23,3,7,42.9,3,6,50,0,1,0,0,0,0,2,2,4,1,2,2,0,0,6
441058,499_14_35,SWITZERLAND,17888,15,arnaud amedee cotture,26,1,5,20,1,4,25,0,1,0,1,2,50,1,4,5,1,2,1,0,0,3
441059,499_14_35,SWITZERLAND,12695,20,brian savoy,21,3,9,33.3,3,4,75,0,5,0,0,0,0,1,3,4,3,3,1,1,0,6
441060,499_14_35,SWITZERLAND,4860,21,oliver matthias vogt,7,1,3,33.3,0,2,0,1,1,100,0,0,0,1,0,1,0,2,0,0,0,3
441061,499_14_35,SWITZERLAND,17392,22,evrard adam atcho,11,1,3,33.3,1,3,33.3,0,0,0,2,4,50,1,0,1,0,1,0,1,0,4
441062,499_14_35,SWITZERLAND,0,TOTALS,SWITZERLAND,200,23,65,35.4,16,41,39,7,24,29.2,7,11,63.6,11,19,30,8,22,13,3,1,60
441063,499_14_36,MONTENEGRO,12640,5,vladimir mihailovic,26,3,10,30,0,2,0,3,8,37.5,0,0,0,0,3,3,2,1,0,0,0,9
441064,499_14_36,MONTENEGRO,10453,6,suad sehovic,19,0,3,0,0,0,0,0,3,0,0,0,0,0,2,2,2,1,0,0,0,0
441065,499_14_36,MONTENEGRO,19707,7,vladimir dragicevic,23,3,6,50,3,6,50,0,0,0,3,4,75,1,2,3,0,2,1,4,1,9
441066,499_14_36,MONTENEGRO,10457,8,sead sehovic,30,4,10,40,2,3,66.7,2,7,28.6,3,4,75,2,1,3,0,5,5,1,0,13
441067,499_14_36,MONTENEGRO,1863,9,vladimir golubovic,19,2,3,66.7,2,3,66.7,0,0,0,0,4,0,1,6,7,0,0,1,1,3,4
441068,499_14_36,MONTENEGRO,24211,10,taylor campbell rochestie,25,4,8,50,3,5,60,1,3,33.3,0,0,0,1,1,2,6,2,6,0,0,9
441069,499_14_36,MONTENEGRO,11120,12,nemanja radovic,25,1,7,14.3,0,2,0,1,5,20,2,2,100,3,3,6,2,4,2,0,0,5
441070,499_14_36,MONTENEGRO,11117,13,nemanja djurisic,0,0,0,0,0,0,0,0,0,0,0,0,0,0,0,0,0,0,0,0,0,0
441071,499_14_36,MONTENEGRO,1723,14,ivan maras,12,1,2,50,0,0,0,1,2,50,0,0,0,0,4,4,1,0,0,0,0,3
441072,499_14_36,MONTENEGRO,10455,15,aleksa popovic,5,0,2,0,0,1,0,0,1,0,0,0,0,0,0,0,0,0,1,0,0,0
441073,499_14_36,MONTENEGRO,15868,20,nikola ivanovic,15,2,3,66.7,1,2,50,1,1,100,3,6,50,0,1,1,2,1,1,0,0,8
441074,499_14_36,MONTENEGRO,15355,22,milos borisov,0,0,0,0,0,0,0,0,0,0,0,0,0,0,0,0,0,0,0,0,0,0
441075,499_14_36,MONTENEGRO,0,TOTALS,MONTENEGRO,200,20,54,37,11,24,45.8,9,30,30,11,20,55,10,25,35,15,16,17,6,4,60
441076,499_14_36,NETHERLANDS,10202,4,arvin slagter,30,5,11,45.5,3,6,50,2,5,40,0,0,0,0,2,2,4,1,2,3,0,12
441077,499_14_36,NETHERLANDS,15661,5,leon williams,30,2,5,40,2,2,100,0,3,0,0,1,0,2,3,5,2,2,2,1,0,4
441078,499_14_36,NETHERLANDS,24213,6,worthy de jong,31,2,7,28.6,2,7,28.6,0,0,0,2,4,50,1,3,4,3,2,3,3,0,6
441079,499_14_36,NETHERLANDS,22012,7,julius clay van sauers,0,0,0,0,0,0,0,0,0,0,0,0,0,0,0,0,0,0,0,0,0,0
441080,499_14_36,NETHERLANDS,13250,8,dexter cornelis hope,12,0,3,0,0,3,0,0,0,0,0,0,0,1,2,3,1,0,0,0,0,0
441081,499_14_36,NETHERLANDS,10671,9,mohamed kherrazi,20,2,4,50,2,3,66.7,0,1,0,0,1,0,0,1,1,0,5,1,1,0,4
441082,499_14_36,NETHERLANDS,12501,10,ralf de pagter,9,2,2,100,2,2,100,0,0,0,0,0,0,0,3,3,0,1,1,1,0,4
441083,499_14_36,NETHERLANDS,6397,11,thomas koenis,13,2,2,100,2,2,100,0,0,0,3,4,75,1,4,5,0,5,3,0,1,7
441084,499_14_36,NETHERLANDS,16075,12,shane gerrit hammink,0,0,0,0,0,0,0,0,0,0,0,0,0,0,0,0,0,0,0,0,0,0
441085,499_14_36,NETHERLANDS,20078,13,kevin bleeker,0,0,0,0,0,0,0,0,0,0,0,0,0,0,0,0,0,0,0,0,0,0
441086,499_14_36,NETHERLANDS,5812,14,nick oudendag,25,5,10,50,5,9,55.6,0,1,0,0,0,0,2,5,7,0,4,3,3,1,10
441087,499_14_36,NETHERLANDS,2871,21,roeland schaftenaar,31,7,11,63.6,5,7,71.4,2,4,50,2,2,100,1,4,5,1,2,2,0,0,18
441088,499_14_36,NETHERLANDS,0,TOTALS,NETHERLANDS,200,27,55,49.1,23,41,56.1,4,14,28.6,7,12,58.3,10,30,40,11,22,17,12,2,65
441089,499_14_37,HUNGARY,4537,5,gabor denes,0,0,0,0,0,0,0,0,0,0,0,0,0,0,0,0,0,0,0,0,0,0
441090,499_14_37,HUNGARY,12503,6,akos keller,22,7,9,77.8,7,9,77.8,0,0,0,0,1,0,1,2,3,0,3,2,1,0,14
441091,499_14_37,HUNGARY,1125,7,krisztian wittmann,38,6,11,54.5,5,7,71.4,1,4,25,3,6,50,0,0,0,1,3,4,1,0,16
441092,499_14_37,HUNGARY,8415,9,david vojvoda,35,3,10,30,3,6,50,0,4,0,1,2,50,0,8,8,3,4,1,1,0,7
441093,499_14_37,HUNGARY,2743,10,zoltan supola,1,1,1,100,1,1,100,0,0,0,0,0,0,0,0,0,0,0,1,0,0,2
441094,499_14_37,HUNGARY,1942,11,norbert toth,35,2,4,50,2,2,100,0,2,0,0,0,0,2,1,3,1,1,0,2,0,4
441095,499_14_37,HUNGARY,2750,12,milan csorvasi,8,1,1,100,1,1,100,0,0,0,2,2,100,0,2,2,1,2,1,0,0,4
441096,499_14_37,HUNGARY,2751,13,adam toth,10,1,2,50,1,2,50,0,0,0,1,1,100,0,0,0,0,4,0,0,0,3
441097,499_14_37,HUNGARY,29528,14,jermaine dontay thomas,26,5,10,50,4,7,57.1,1,3,33.3,1,2,50,1,2,3,3,2,0,1,0,12
441098,499_14_37,HUNGARY,1123,15,csaba ferencz,19,0,3,0,0,0,0,0,3,0,0,0,0,1,2,3,0,1,1,0,0,0
441099,499_14_37,HUNGARY,8051,21,andras rujak,1,0,0,0,0,0,0,0,0,0,0,0,0,0,2,2,0,0,1,0,0,0
441100,499_14_37,HUNGARY,11148,22,janos eilingsfeld,6,1,3,33.3,0,0,0,1,3,33.3,0,0,0,0,3,3,1,2,0,2,0,3
441101,499_14_37,HUNGARY,0,TOTALS,HUNGARY,200,27,54,50,24,35,68.6,3,19,15.8,8,14,57.1,6,24,30,10,22,11,8,0,65
441102,499_14_37,PORTUGAL,2730,4,jose silva,1,0,0,0,0,0,0,0,0,0,0,0,0,0,0,0,0,0,0,0,0,0
441103,499_14_37,PORTUGAL,8199,5,joao soares,26,1,4,25,0,1,0,1,3,33.3,0,0,0,1,1,2,0,2,0,1,0,3
441104,499_14_37,PORTUGAL,8195,6,jose barbosa,4,0,1,0,0,0,0,0,1,0,0,0,0,0,0,0,0,0,0,0,0,0
441105,499_14_37,PORTUGAL,15697,7,carlos diogo serra ferreirinho,7,0,1,0,0,0,0,0,1,0,0,0,0,0,0,0,0,1,1,1,0,0
441106,499_14_37,PORTUGAL,10266,8,mario fernandes,18,3,9,33.3,2,4,50,1,5,20,2,2,100,0,2,2,0,3,2,0,0,9
441107,499_14_37,PORTUGAL,2736,10,fabio lima,19,0,1,0,0,0,0,0,1,0,2,2,100,1,0,1,0,2,1,0,0,2
441108,499_14_37,PORTUGAL,10956,11,miguel queiroz,8,1,2,50,1,2,50,0,0,0,0,0,0,1,0,1,0,2,1,0,0,2
441109,499_14_37,PORTUGAL,8200,12,joao guerreiro,15,2,4,50,2,3,66.7,0,1,0,1,2,50,0,1,1,0,0,2,0,0,5
441110,499_14_37,PORTUGAL,7851,13,joao balseiro,33,1,5,20,1,3,33.3,0,2,0,2,2,100,0,0,0,2,2,2,0,0,4
441111,499_14_37,PORTUGAL,2732,14,pedro pinto,18,1,6,16.7,0,1,0,1,5,20,2,2,100,0,0,0,2,3,1,0,0,5
441112,499_14_37,PORTUGAL,2918,21,claudio fonseca,21,3,8,37.5,3,7,42.9,0,1,0,1,1,100,2,6,8,0,3,3,0,0,7
441113,499_14_37,PORTUGAL,29527,22,arnette hallman,30,5,12,41.7,2,6,33.3,3,6,50,2,2,100,3,6,9,0,3,2,0,0,15
441114,499_14_37,PORTUGAL,0,TOTALS,PORTUGAL,200,17,53,32.1,11,27,40.7,6,26,23.1,12,13,92.3,8,18,26,4,21,15,2,0,52
441115,499_14_38,CZECH REPUBLIC,29502,4,patrik auda,22,5,10,50,5,9,55.6,0,1,0,2,2,100,0,0,0,4,3,2,0,0,12
441116,499_14_38,CZECH REPUBLIC,12522,5,tomas pomikalek,0,0,0,0,0,0,0,0,0,0,0,0,0,0,0,0,0,0,0,0,0,0
441117,499_14_38,CZECH REPUBLIC,5478,6,pavel pumprla,36,7,9,77.8,6,7,85.7,1,2,50,0,0,0,1,3,4,2,4,1,1,0,15
441118,499_14_38,CZECH REPUBLIC,10700,7,vojtech hruban,13,2,4,50,1,1,100,1,3,33.3,1,2,50,0,2,2,1,3,1,1,1,6
441119,499_14_38,CZECH REPUBLIC,8325,8,tomas satoransky,36,6,9,66.7,3,5,60,3,4,75,1,2,50,0,6,6,6,3,4,4,0,16
441120,499_14_38,CZECH REPUBLIC,4774,9,jiri welsch,29,6,9,66.7,6,8,75,0,1,0,1,2,50,0,4,4,3,3,1,2,0,13
441121,499_14_38,CZECH REPUBLIC,10702,10,lukas palyza,0,0,0,0,0,0,0,0,0,0,0,0,0,0,0,0,0,0,0,0,0,0
441122,499_14_38,CZECH REPUBLIC,4775,11,lubos barton,16,1,7,14.3,1,4,25,0,3,0,0,0,0,2,1,3,0,0,1,0,1,2
441123,499_14_38,CZECH REPUBLIC,12850,12,ondrej balvin,28,0,1,0,0,1,0,0,0,0,4,4,100,3,4,7,1,5,0,1,1,4
441124,499_14_38,CZECH REPUBLIC,10484,13,jakub sirina,4,2,3,66.7,1,1,100,1,2,50,0,0,0,0,1,1,0,0,0,0,0,5
441125,499_14_38,CZECH REPUBLIC,7823,14,kamil svrdlik,0,0,0,0,0,0,0,0,0,0,0,0,0,0,0,0,0,0,0,0,0,0
441126,499_14_38,CZECH REPUBLIC,1096,22,pavel houska,16,4,6,66.7,1,2,50,3,4,75,2,2,100,0,2,2,2,4,0,2,0,13
441127,499_14_38,CZECH REPUBLIC,0,TOTALS,CZECH REPUBLIC,200,33,58,56.9,24,38,63.2,9,20,45,11,14,78.6,6,24,30,19,25,11,11,3,86
441128,499_14_38,GEORGIA,8378,4,nika metreveli,0,0,0,0,0,0,0,0,0,0,0,0,0,0,0,0,0,0,0,0,0,0
441129,499_14_38,GEORGIA,16023,5,otar pkhakadze,0,0,0,0,0,0,0,0,0,0,0,0,0,0,0,0,0,0,0,0,0,0
441130,499_14_38,GEORGIA,4919,7,zaza pachulia,30,2,11,18.2,2,11,18.2,0,0,0,6,8,75,3,4,7,0,5,2,0,0,10
441131,499_14_38,GEORGIA,1690,8,george tsintsadze,40,1,7,14.3,1,4,25,0,3,0,7,8,87.5,0,3,3,4,3,4,1,0,9
441132,499_14_38,GEORGIA,15684,10,duda sanadze,4,0,1,0,0,1,0,0,0,0,0,0,0,0,0,0,0,1,1,0,0,0
441133,499_14_38,GEORGIA,12467,12,levan patsatsia,27,1,2,50,0,0,0,1,2,50,2,2,100,0,0,0,0,0,0,1,0,5
441134,499_14_38,GEORGIA,1699,13,viktor sanikidze,36,7,14,50,6,10,60,1,4,25,2,3,66.7,1,3,4,2,1,3,2,2,17
441135,499_14_38,GEORGIA,16022,15,beka burjanadze,15,1,1,100,0,0,0,1,1,100,2,2,100,1,3,4,0,1,1,0,0,5
441136,499_14_38,GEORGIA,8382,22,george sharabidze,6,2,3,66.7,2,3,66.7,0,0,0,0,0,0,1,0,1,0,3,0,0,0,4
441137,499_14_38,GEORGIA,11036,23,tornike shengelia,28,6,10,60,5,8,62.5,1,2,50,4,8,50,2,2,4,2,5,4,1,0,17
441138,499_14_38,GEORGIA,7836,24,mikhail berishvili,0,0,0,0,0,0,0,0,0,0,0,0,0,0,0,0,0,0,0,0,0,0
441139,499_14_38,GEORGIA,1693,25,besik lezhava,13,0,2,0,0,1,0,0,1,0,0,0,0,0,1,1,1,1,1,1,0,0
441140,499_14_38,GEORGIA,0,TOTALS,GEORGIA,200,20,51,39.2,16,38,42.1,4,13,30.8,23,31,74.2,11,18,29,9,20,16,6,2,67
441141,499_14_39,ROMANIA,2115,4,andrei mandache,24,3,7,42.9,1,1,100,2,6,33.3,2,2,100,0,1,1,4,3,6,1,0,10
441142,499_14_39,ROMANIA,10239,5,mihail-octavian paul,24,5,9,55.6,5,5,100,0,4,0,4,6,66.7,0,4,4,4,3,2,0,0,14
441143,499_14_39,ROMANIA,5015,6,levente szijarto,10,1,2,50,0,1,0,1,1,100,0,0,0,0,1,1,1,1,1,1,0,3
441144,499_14_39,ROMANIA,2900,9,vlad moldoveanu,23,3,6,50,3,4,75,0,2,0,3,4,75,0,1,1,2,0,1,0,0,9
441145,499_14_39,ROMANIA,2915,10,catalin baciu,4,1,1,100,1,1,100,0,0,0,0,0,0,0,0,0,0,1,0,0,0,2
441146,499_14_39,ROMANIA,15354,11,octavian calota-popa,0,0,0,0,0,0,0,0,0,0,0,0,0,0,0,0,0,0,0,0,0,0
441147,499_14_39,ROMANIA,11102,12,bogdan tibirna,0,0,0,0,0,0,0,0,0,0,0,0,0,0,0,0,0,0,0,0,0,0
441148,499_14_39,ROMANIA,15358,13,teodor gabriel jucan,6,0,1,0,0,0,0,0,1,0,0,0,0,1,0,1,1,0,0,2,0,0
441149,499_14_39,ROMANIA,2125,14,titus nicoara,27,9,10,90,9,10,90,0,0,0,2,3,66.7,4,8,12,1,4,1,0,0,20
441150,499_14_39,ROMANIA,4965,15,mihai vlad silvasan,26,3,5,60,2,2,100,1,3,33.3,1,1,100,0,5,5,4,5,1,3,0,8
441151,499_14_39,ROMANIA,5016,21,adrian tudor,23,1,2,50,1,2,50,0,0,0,2,4,50,0,1,1,9,2,1,2,0,4
441152,499_14_39,ROMANIA,12712,44,adrian gutoaia,34,8,13,61.5,7,8,87.5,1,5,20,3,4,75,0,3,3,0,4,4,1,0,20
441153,499_14_39,ROMANIA,0,TOTALS,ROMANIA,200,34,56,60.7,29,34,85.3,5,22,22.7,17,24,70.8,5,24,29,26,23,17,10,0,90
441154,499_14_39,SLOVAK REPUBLIC,15367,4,marek kozlik,14,3,6,50,2,2,100,1,4,25,2,2,100,1,1,2,4,1,1,0,0,9
441155,499_14_39,SLOVAK REPUBLIC,6339,5,peter dorazil,16,1,1,100,1,1,100,0,0,0,1,2,50,1,2,3,1,4,1,2,0,3
441156,499_14_39,SLOVAK REPUBLIC,1154,6,peter sedmak,39,5,12,41.7,5,9,55.6,0,3,0,4,7,57.1,3,5,8,2,2,3,2,1,14
441157,499_14_39,SLOVAK REPUBLIC,11264,7,tomas mrvis,13,3,5,60,2,3,66.7,1,2,50,0,0,0,0,3,3,2,3,0,1,0,7
441158,499_14_39,SLOVAK REPUBLIC,10469,8,milan ziak,5,0,0,0,0,0,0,0,0,0,0,0,0,0,1,1,0,2,0,0,0,0
441159,499_14_39,SLOVAK REPUBLIC,5862,9,martin bilik,24,3,8,37.5,0,1,0,3,7,42.9,0,0,0,2,0,2,2,2,3,1,0,9
441160,499_14_39,SLOVAK REPUBLIC,29524,10,nenad milosevic,35,3,7,42.9,1,2,50,2,5,40,7,8,87.5,3,3,6,6,5,6,0,0,15
441161,499_14_39,SLOVAK REPUBLIC,6335,11,stanislav baldovsky,5,1,2,50,1,1,100,0,1,0,0,0,0,0,0,0,0,2,0,0,0,2
441162,499_14_39,SLOVAK REPUBLIC,13095,12,maurizio galata,1,1,1,100,1,1,100,0,0,0,0,0,0,0,0,0,0,0,0,0,0,2
441163,499_14_39,SLOVAK REPUBLIC,12668,13,andrej kuffa,23,4,9,44.4,4,5,80,0,4,0,0,0,0,1,2,3,2,1,1,0,0,8
441164,499_14_39,SLOVAK REPUBLIC,8444,15,marek jass,23,6,12,50,3,5,60,3,7,42.9,2,4,50,2,2,4,1,2,2,5,0,17
441165,499_14_39,SLOVAK REPUBLIC,0,TOTALS,SLOVAK REPUBLIC,200,30,63,47.6,20,30,66.7,10,33,30.3,16,23,69.6,13,21,34,20,24,17,11,1,86
441166,499_14_40,RUSSIA,1809,5,nikita kurbanov,24,3,5,60,0,1,0,3,4,75,2,4,50,5,8,13,6,2,0,0,1,11
441167,499_14_40,RUSSIA,12959,7,dmitrii kulagin,1,1,1,100,1,1,100,0,0,0,0,0,0,0,0,0,0,1,0,1,0,2
441168,499_14_40,RUSSIA,29520,8,pavel korobkov,11,3,3,100,3,3,100,0,0,0,8,12,66.7,2,1,3,0,2,1,1,0,14
441169,499_14_40,RUSSIA,1083,9,egor vyaltsev,17,2,4,50,2,3,66.7,0,1,0,0,0,0,1,4,5,1,2,0,1,0,4
441170,499_14_40,RUSSIA,1079,10,dmitry sokolov,15,5,6,83.3,5,6,83.3,0,0,0,5,6,83.3,3,3,6,0,0,1,0,1,15
441171,499_14_40,RUSSIA,19857,12,andrey zubkov,17,5,9,55.6,3,6,50,2,3,66.7,3,3,100,1,4,5,3,1,1,0,0,15
441172,499_14_40,RUSSIA,2554,13,dmitry khvostov,14,0,1,0,0,0,0,0,1,0,0,0,0,0,0,0,1,2,0,0,0,0
441173,499_14_40,RUSSIA,1808,14,anton ponkrashov,27,1,8,12.5,0,1,0,1,7,14.3,3,3,100,1,2,3,12,1,0,3,0,6
441174,499_14_40,RUSSIA,15377,15,timofey mozgov,14,1,4,25,1,4,25,0,0,0,0,2,0,1,1,2,0,1,1,0,0,2
441175,499_14_40,RUSSIA,15956,22,sergey karasev,23,4,7,57.1,0,1,0,4,6,66.7,2,2,100,0,1,1,1,4,2,1,1,14
441176,499_14_40,RUSSIA,10610,23,semen antonov,23,5,6,83.3,3,4,75,2,2,100,2,2,100,1,2,3,0,2,1,1,0,14
441177,499_14_40,RUSSIA,1810,24,evgeny voronov,14,2,8,25,2,6,33.3,0,2,0,0,2,0,2,3,5,1,3,2,1,0,4
441178,499_14_40,RUSSIA,0,TOTALS,RUSSIA,200,32,62,51.6,20,36,55.6,12,26,46.2,25,36,69.4,17,29,46,25,21,9,9,3,101
441179,499_14_40,SWITZERLAND,12691,4,jonathan malu kazadi-muyombu,24,3,10,30,2,7,28.6,1,3,33.3,1,2,50,0,1,1,1,1,3,1,0,8
441180,499_14_40,SWITZERLAND,7804,6,dusan mladjan,29,2,8,25,2,4,50,0,4,0,8,8,100,0,3,3,1,4,3,1,2,12
441181,499_14_40,SWITZERLAND,16096,7,marko mladjan,32,6,12,50,4,6,66.7,2,6,33.3,2,2,100,3,4,7,2,5,0,1,0,16
441182,499_14_40,SWITZERLAND,1260,8,cedric lionel mafuta,31,3,8,37.5,2,5,40,1,3,33.3,0,1,0,2,3,5,3,2,3,1,1,7
441183,499_14_40,SWITZERLAND,19748,9,roberto kovac,22,0,4,0,0,1,0,0,3,0,0,0,0,0,1,1,0,2,1,0,0,0
441184,499_14_40,SWITZERLAND,19912,10,alexis herrmann,18,0,1,0,0,1,0,0,0,0,0,0,0,0,1,1,1,1,3,0,0,0
441185,499_14_40,SWITZERLAND,10497,12,nicolas dos santos,17,2,6,33.3,2,5,40,0,1,0,0,2,0,2,0,2,2,3,1,1,0,4
441186,499_14_40,SWITZERLAND,17888,15,arnaud amedee cotture,25,3,6,50,3,5,60,0,1,0,0,0,0,0,2,2,0,5,1,0,1,6
441187,499_14_40,SWITZERLAND,12695,20,brian savoy,1,1,1,100,0,0,0,1,1,100,0,0,0,0,0,0,0,2,1,0,0,3
441188,499_14_40,SWITZERLAND,4860,21,oliver matthias vogt,0,0,0,0,0,0,0,0,0,0,0,0,0,0,0,0,0,0,0,0,0,0
441189,499_14_40,SWITZERLAND,0,TOTALS,SWITZERLAND,200,20,56,35.7,15,34,44.1,5,22,22.7,11,15,73.3,9,18,27,10,25,16,5,4,56
441190,499_14_41,LUXEMBOURG,5011,4,tom schumacher,32,6,14,42.9,4,11,36.4,2,3,66.7,5,7,71.4,1,0,1,1,3,4,1,0,19
441191,499_14_41,LUXEMBOURG,5918,5,pitt koster,0,0,0,0,0,0,0,0,0,0,0,0,0,0,0,0,0,0,0,0,0,0
441192,499_14_41,LUXEMBOURG,2966,6,raul leandro birenbaum,31,5,7,71.4,1,2,50,4,5,80,2,3,66.7,1,2,3,2,3,2,0,0,16
441193,499_14_41,LUXEMBOURG,8344,8,christopher c. g. jones,28,2,9,22.2,2,4,50,0,5,0,3,4,75,2,4,6,1,2,1,0,0,7
441194,499_14_41,LUXEMBOURG,19727,10,patrick arbaut,15,1,3,33.3,1,3,33.3,0,0,0,0,0,0,1,1,2,0,3,2,1,0,2
441195,499_14_41,LUXEMBOURG,13285,11,bob melcher,17,2,3,66.7,2,2,100,0,1,0,1,3,33.3,1,2,3,0,0,1,1,0,5
441196,499_14_41,LUXEMBOURG,19728,12,alexandre rodenbourg,20,1,7,14.3,0,3,0,1,4,25,0,0,0,0,4,4,0,4,0,0,0,3
441197,499_14_41,LUXEMBOURG,8340,22,jean nicolas c. kox,4,0,0,0,0,0,0,0,0,0,0,0,0,0,0,0,0,1,0,0,0,0
441198,499_14_41,LUXEMBOURG,1283,23,jairo emanuel delgado ferreira,32,6,9,66.7,5,6,83.3,1,3,33.3,1,1,100,1,2,3,5,3,1,0,0,14
441199,499_14_41,LUXEMBOURG,17901,24,thomas grun,0,0,0,0,0,0,0,0,0,0,0,0,0,0,0,0,0,0,0,0,0,0
441200,499_14_41,LUXEMBOURG,29517,30,dominique benseghir,0,0,0,0,0,0,0,0,0,0,0,0,0,0,0,0,0,0,0,0,0,0
441201,499_14_41,LUXEMBOURG,13176,31,alex laurent,20,2,10,20,2,7,28.6,0,3,0,1,2,50,1,0,1,0,1,1,1,0,5
441202,499_14_41,LUXEMBOURG,0,TOTALS,LUXEMBOURG,200,25,62,40.3,17,38,44.7,8,24,33.3,13,20,65,8,16,24,9,20,12,4,0,71
441203,499_14_41,AUSTRIA,2103,5,thomas schreiner,31,3,10,30,0,2,0,3,8,37.5,0,0,0,0,2,2,3,2,2,2,0,9
441204,499_14_41,AUSTRIA,29530,8,enis murati,30,6,9,66.7,5,7,71.4,1,2,50,1,2,50,2,6,8,3,2,1,1,0,14
441205,499_14_41,AUSTRIA,16191,14,jozo rados,5,1,1,100,1,1,100,0,0,0,0,0,0,0,1,1,0,3,1,0,0,2
441206,499_14_41,AUSTRIA,8395,15,david hasenburger,7,1,1,100,1,1,100,0,0,0,0,0,0,0,1,1,0,2,0,0,0,2
441207,499_14_41,AUSTRIA,8392,20,romed vieider,0,0,0,0,0,0,0,0,0,0,0,0,0,0,0,0,0,0,0,0,0,0
441208,499_14_41,AUSTRIA,8396,24,rasid mahalbasic,32,7,9,77.8,7,9,77.8,0,0,0,5,5,100,3,9,12,6,3,2,1,0,19
441209,499_14_41,AUSTRIA,8386,25,jesse nii l. seilern und aspang,9,0,3,0,0,1,0,0,2,0,0,0,0,0,0,0,0,1,1,1,0,0
441210,499_14_41,AUSTRIA,6415,34,moritz lanegger,21,3,3,100,1,1,100,2,2,100,2,4,50,0,6,6,2,4,3,2,0,10
441211,499_14_41,AUSTRIA,12529,35,sebastian koch,16,2,2,100,1,1,100,1,1,100,2,2,100,1,0,1,0,1,2,0,0,7
441212,499_14_41,AUSTRIA,13271,41,maximilian hopfgartner,6,1,3,33.3,1,2,50,0,1,0,0,0,0,1,0,1,0,1,0,0,0,2
441213,499_14_41,AUSTRIA,11250,42,thomas klepeisz,18,0,2,0,0,2,0,0,0,0,2,2,100,0,1,1,2,1,3,0,0,2
441214,499_14_41,AUSTRIA,15717,43,anton maresch,25,4,10,40,2,5,40,2,5,40,3,6,50,0,3,3,1,3,4,2,0,13
441215,499_14_41,AUSTRIA,0,TOTALS,AUSTRIA,200,28,53,52.8,19,32,59.4,9,21,42.9,15,21,71.4,9,32,41,17,23,20,9,0,80
441216,499_14_42,DENMARK,29522,4,darko jukic,21,4,9,44.4,4,5,80,0,4,0,2,2,100,1,3,4,1,2,0,1,0,10
441217,499_14_42,DENMARK,16165,5,frederik rungby,15,0,0,0,0,0,0,0,0,0,0,0,0,3,1,4,0,1,1,1,0,0
441218,499_14_42,DENMARK,24492,6,tobias reinholt,12,1,4,25,1,4,25,0,0,0,2,2,100,0,2,2,0,3,0,0,1,4
441219,499_14_42,DENMARK,16162,7,esben reinholt,27,6,15,40,5,9,55.6,1,6,16.7,4,4,100,0,3,3,3,2,4,2,1,17
441220,499_14_42,DENMARK,21908,8,gabriel lundberg,13,3,5,60,3,3,100,0,2,0,0,0,0,0,1,1,0,0,0,0,0,6
441221,499_14_42,DENMARK,12662,9,alexander heidenheim bak,20,3,7,42.9,2,4,50,1,3,33.3,0,0,0,0,0,0,2,3,1,3,0,7
441222,499_14_42,DENMARK,10649,10,mathias seilund,21,4,8,50,3,6,50,1,2,50,0,1,0,2,1,3,0,4,1,0,1,9
441223,499_14_42,DENMARK,15650,11,thomas sebastian laerke,24,0,5,0,0,3,0,0,2,0,0,0,0,0,2,2,2,1,1,0,0,0
441224,499_14_42,DENMARK,17655,12,peter moeller,19,3,7,42.9,3,7,42.9,0,0,0,0,0,0,0,1,1,1,1,0,0,0,6
441225,499_14_42,DENMARK,29523,13,asger hjorth,2,0,0,0,0,0,0,0,0,0,0,0,0,0,0,0,0,1,0,0,0,0
441226,499_14_42,DENMARK,13180,14,anders kristoffer haas,2,0,1,0,0,0,0,0,1,0,0,0,0,0,0,0,0,0,0,0,0,0
441227,499_14_42,DENMARK,12663,15,jonas zohore bergstedt,22,2,6,33.3,2,6,33.3,0,0,0,3,4,75,2,3,5,1,3,4,0,1,7
441228,499_14_42,DENMARK,0,TOTALS,DENMARK,200,26,67,38.8,23,47,48.9,3,20,15,11,13,84.6,13,19,32,10,21,12,7,4,66
441229,499_14_42,BELARUS,1646,4,kanstantsin yafremau,14,0,1,0,0,1,0,0,0,0,0,0,0,0,1,1,1,2,1,1,0,0
441230,499_14_42,BELARUS,15346,5,siarhei charykau,20,0,4,0,0,4,0,0,0,0,0,0,0,0,1,1,4,1,2,2,0,0
441231,499_14_42,BELARUS,16119,6,aliaksandr semianiuk,4,0,0,0,0,0,0,0,0,0,0,0,0,0,1,1,0,1,1,0,1,0
441232,499_14_42,BELARUS,29521,7,kiryl sitnik,20,5,9,55.6,2,4,50,3,5,60,0,0,0,2,4,6,2,3,0,0,0,13
441233,499_14_42,BELARUS,2847,8,mikita meshcharakou,6,0,1,0,0,1,0,0,0,0,1,2,50,0,0,0,0,1,0,0,0,1
441234,499_14_42,BELARUS,4916,9,mikalai aliakseyeu,5,0,0,0,0,0,0,0,0,0,2,2,100,0,2,2,1,2,0,0,1,2
441235,499_14_42,BELARUS,13157,10,vitali liutych,32,7,13,53.8,4,6,66.7,3,7,42.9,4,6,66.7,0,5,5,3,3,2,0,0,21
441236,499_14_42,BELARUS,997,11,dzmitry paliashchuk,25,6,10,60,4,5,80,2,5,40,0,0,0,1,6,7,2,4,1,2,0,14
441237,499_14_42,BELARUS,998,12,aliaksandr pustahvar,32,2,7,28.6,1,3,33.3,1,4,25,0,0,0,3,4,7,2,2,4,0,1,5
441238,499_14_42,BELARUS,5476,13,valery gandlin,0,0,0,0,0,0,0,0,0,0,0,0,0,0,0,0,0,0,0,0,0,0
441239,499_14_42,BELARUS,4915,14,aliaksandr kudrautsau,24,3,7,42.9,1,3,33.3,2,4,50,2,2,100,0,0,0,2,1,4,1,1,10
441240,499_14_42,BELARUS,1645,15,aliaksei trastsinetski,18,2,6,33.3,1,4,25,1,2,50,2,2,100,2,4,6,0,1,0,0,0,7
441241,499_14_42,BELARUS,0,TOTALS,BELARUS,200,25,58,43.1,13,31,41.9,12,27,44.4,11,14,78.6,11,28,39,17,21,15,6,4,73
441242,499_14_43,GREAT BRITAIN,805,4,kieron achara,22,5,8,62.5,5,8,62.5,0,0,0,5,5,100,5,2,7,4,0,0,0,0,15
441243,499_14_43,GREAT BRITAIN,5821,5,ashley hamilton,0,0,0,0,0,0,0,0,0,0,0,0,0,0,0,0,0,0,0,0,0,0
441244,499_14_43,GREAT BRITAIN,6383,6,devan bailey,13,1,3,33.3,0,2,0,1,1,100,0,0,0,0,1,1,1,3,0,0,0,3
441245,499_14_43,GREAT BRITAIN,13115,7,devon van oostrum,31,0,6,0,0,2,0,0,4,0,0,0,0,0,8,8,5,2,5,0,0,0
441246,499_14_43,GREAT BRITAIN,10185,8,andrew sullivan,27,4,6,66.7,4,6,66.7,0,0,0,2,4,50,0,3,3,3,2,2,0,0,10
441247,499_14_43,GREAT BRITAIN,12429,9,gareth murray,17,1,4,25,0,2,0,1,2,50,0,0,0,0,1,1,0,3,0,1,2,3
441248,499_14_43,GREAT BRITAIN,1984,10,dan clark,33,6,13,46.2,5,7,71.4,1,6,16.7,1,1,100,1,7,8,2,1,2,0,1,14
441249,499_14_43,GREAT BRITAIN,15538,12,myles edward sinclair hesson,20,5,9,55.6,3,6,50,2,3,66.7,0,3,0,3,2,5,2,3,0,1,0,12
441250,499_14_43,GREAT BRITAIN,2833,13,matt bryan-amaning,0,0,0,0,0,0,0,0,0,0,0,0,0,0,0,0,0,0,0,0,0,0
441251,499_14_43,GREAT BRITAIN,10192,14,eric boateng,0,0,0,0,0,0,0,0,0,0,0,0,0,0,0,0,0,0,0,0,0,0
441252,499_14_43,GREAT BRITAIN,19759,15,kyle johnson,34,4,13,30.8,2,9,22.2,2,4,50,0,0,0,0,2,2,2,5,4,0,0,10
441253,499_14_43,GREAT BRITAIN,12534,24,ben mockford,2,1,2,50,1,2,50,0,0,0,0,0,0,0,0,0,0,1,0,0,0,2
441254,499_14_43,GREAT BRITAIN,0,TOTALS,GREAT BRITAIN,200,27,64,42.2,20,44,45.5,7,20,35,8,13,61.5,11,27,38,19,20,15,2,3,69
441255,499_14_43,ICELAND,24208,4,axel karason,0,0,0,0,0,0,0,0,0,0,0,0,0,0,0,0,0,0,0,0,0,0
441256,499_14_43,ICELAND,13211,5,haukur palsson,35,3,6,50,2,4,50,1,2,50,0,0,0,0,4,4,1,4,0,0,0,7
441257,499_14_43,ICELAND,2760,7,sigurdur gunnar thorsteinsson,0,0,0,0,0,0,0,0,0,0,0,0,0,0,0,0,0,0,0,0,0,0
441258,499_14_43,ICELAND,4841,8,hlynur baeringsson,37,3,10,30,3,6,50,0,4,0,1,2,50,7,6,13,3,2,1,0,1,7
441259,499_14_43,ICELAND,19926,9,martin hermannsson,12,1,3,33.3,1,2,50,0,1,0,0,0,0,0,2,2,2,3,1,0,0,2
441260,499_14_43,ICELAND,4837,9,jon arnor stefansson,29,8,17,47.1,4,8,50,4,9,44.4,3,4,75,0,1,1,2,1,3,0,0,23
441261,499_14_43,ICELAND,4840,10,helgi mar magnusson,4,1,2,50,0,1,0,1,1,100,0,0,0,0,1,1,1,0,0,0,0,3
441262,499_14_43,ICELAND,4839,11,sigurdur thorvaldsson,0,0,0,0,0,0,0,0,0,0,0,0,0,0,0,0,0,0,0,0,0,0
441263,499_14_43,ICELAND,15700,12,ragnar agust nathanaelsson,1,0,0,0,0,0,0,0,0,0,0,0,0,0,0,0,0,0,0,0,0,0
441264,499_14_43,ICELAND,2764,13,hordur vilhjalmsson,29,6,12,50,3,7,42.9,3,5,60,2,4,50,1,1,2,5,4,0,1,0,17
441265,499_14_43,ICELAND,4980,14,logi gunnarsson,16,3,6,50,2,2,100,1,4,25,2,2,100,0,1,1,0,1,2,0,0,9
441266,499_14_43,ICELAND,2071,15,pavel ermolinskij,37,1,8,12.5,0,5,0,1,3,33.3,0,0,0,0,10,10,2,3,4,2,3,3
441267,499_14_43,ICELAND,0,TOTALS,ICELAND,200,26,64,40.6,15,35,42.9,11,29,37.9,8,12,66.7,11,28,39,16,18,11,3,4,71
441268,499_14_44,NETHERLANDS,10202,4,arvin slagter,25,5,14,35.7,3,7,42.9,2,7,28.6,0,0,0,0,5,5,4,2,6,1,1,12
441269,499_14_44,NETHERLANDS,15661,5,leon williams,34,1,4,25,0,0,0,1,4,25,0,0,0,0,0,0,4,2,1,2,0,3
441270,499_14_44,NETHERLANDS,24213,6,worthy de jong,25,4,7,57.1,3,5,60,1,2,50,1,2,50,5,0,5,3,0,3,0,0,10
441271,499_14_44,NETHERLANDS,22012,7,julius clay van sauers,0,0,0,0,0,0,0,0,0,0,0,0,0,0,0,0,0,0,0,0,0,0
441272,499_14_44,NETHERLANDS,13250,8,dexter cornelis hope,3,0,0,0,0,0,0,0,0,0,0,0,0,0,1,1,0,0,0,0,0,0
441273,499_14_44,NETHERLANDS,10671,9,mohamed kherrazi,23,3,5,60,3,5,60,0,0,0,0,0,0,2,4,6,0,3,2,2,0,6
441274,499_14_44,NETHERLANDS,12501,10,ralf de pagter,14,0,3,0,0,2,0,0,1,0,0,0,0,1,0,1,1,0,0,0,0,0
441275,499_14_44,NETHERLANDS,6397,11,thomas koenis,25,5,9,55.6,5,9,55.6,0,0,0,2,3,66.7,4,3,7,0,4,1,2,0,12
441276,499_14_44,NETHERLANDS,16075,12,shane gerrit hammink,1,0,0,0,0,0,0,0,0,0,0,0,0,0,0,0,0,0,0,0,0,0
441277,499_14_44,NETHERLANDS,20078,13,kevin bleeker,6,0,1,0,0,1,0,0,0,0,0,0,0,0,2,2,0,0,0,0,0,0
441278,499_14_44,NETHERLANDS,5812,14,nick oudendag,15,3,6,50,3,6,50,0,0,0,0,0,0,5,2,7,0,1,0,1,0,6
441279,499_14_44,NETHERLANDS,2871,21,roeland schaftenaar,29,6,13,46.2,4,7,57.1,2,6,33.3,3,6,50,2,5,7,2,3,0,2,0,17
441280,499_14_44,NETHERLANDS,0,TOTALS,NETHERLANDS,200,27,62,43.5,21,42,50,6,20,30,6,11,54.5,19,22,41,14,15,15,10,1,66
441281,499_14_44,BULGARIA,8350,7,hristo zahariev,23,3,6,50,3,4,75,0,2,0,1,2,50,1,0,1,1,2,2,1,0,7
441282,499_14_44,BULGARIA,7960,9,pavel marinov,4,0,0,0,0,0,0,0,0,0,0,0,0,0,1,1,0,1,1,0,0,0
441283,499_14_44,BULGARIA,8347,10,bozhidar avramov,27,1,7,14.3,0,2,0,1,5,20,0,0,0,0,0,0,3,2,5,2,1,3
441284,499_14_44,BULGARIA,1675,13,asen velikov,25,2,7,28.6,1,2,50,1,5,20,1,2,50,0,2,2,4,1,1,0,0,6
441285,499_14_44,BULGARIA,2852,14,chavdar kostov,3,1,1,100,1,1,100,0,0,0,0,0,0,0,0,0,0,0,0,0,0,2
441286,499_14_44,BULGARIA,10589,15,stanislav vaklinov,1,0,0,0,0,0,0,0,0,0,0,0,0,0,0,0,0,1,0,0,0,0
441287,499_14_44,BULGARIA,5588,21,nikolay varbanov,0,0,0,0,0,0,0,0,0,0,0,0,0,0,0,0,0,0,0,0,0,0
441288,499_14_44,BULGARIA,13084,22,pavlin ivanov,18,1,3,33.3,1,2,50,0,1,0,0,0,0,0,0,0,2,2,0,0,0,2
441289,499_14_44,BULGARIA,15604,23,stanimir marinov,21,2,7,28.6,0,1,0,2,6,33.3,0,0,0,0,1,1,3,1,4,0,0,6
441290,499_14_44,BULGARIA,7959,24,kostadin marshavelski,20,2,4,50,2,4,50,0,0,0,0,0,0,0,4,4,0,5,0,0,0,4
441291,499_14_44,BULGARIA,17555,41,aleksandar vezenkov,39,9,14,64.3,4,4,100,5,10,50,3,4,75,1,4,5,1,2,1,3,0,26
441292,499_14_44,BULGARIA,13088,50,dimitar dimitrov,19,0,2,0,0,1,0,0,1,0,1,2,50,0,3,3,0,2,2,0,0,1
441293,499_14_44,BULGARIA,0,TOTALS,BULGARIA,200,21,51,41.2,12,21,57.1,9,30,30,6,10,60,2,15,17,14,19,16,6,1,57
441294,499_14_45,GERMANY,8244,7,akeem vargas,6,0,0,0,0,0,0,0,0,0,0,0,0,0,2,2,0,0,0,0,0,0
441295,499_14_45,GERMANY,15385,8,heiko schaffartzik,28,1,3,33.3,0,0,0,1,3,33.3,2,2,100,2,1,3,3,5,3,1,0,5
441296,499_14_45,GERMANY,10446,9,karsten tadda,13,0,1,0,0,0,0,0,1,0,2,2,100,0,1,1,0,4,1,0,0,2
441297,499_14_45,GERMANY,5747,10,lucca staiger,4,0,1,0,0,1,0,0,0,0,0,0,0,1,0,1,0,0,1,0,0,0
441298,499_14_45,GERMANY,6326,12,robin benzing,38,6,11,54.5,4,6,66.7,2,5,40,5,6,83.3,1,4,5,4,3,2,0,0,19
441299,499_14_45,GERMANY,15492,13,bastian doreth,0,0,0,0,0,0,0,0,0,0,0,0,0,0,0,0,0,0,0,0,0,0
441300,499_14_45,GERMANY,15493,14,andreas seiferth,5,0,0,0,0,0,0,0,0,0,0,0,0,0,0,0,0,1,0,0,0,0
441301,499_14_45,GERMANY,6324,20,elias harris,13,1,4,25,1,1,100,0,3,0,2,2,100,2,2,4,0,2,0,0,0,4
441302,499_14_45,GERMANY,19866,21,daniel theis,24,9,13,69.2,8,11,72.7,1,2,50,1,3,33.3,1,7,8,0,5,2,0,0,20
441303,499_14_45,GERMANY,19990,22,dennis schroder,32,7,13,53.8,3,7,42.9,4,6,66.7,2,2,100,3,0,3,7,0,3,0,0,20
441304,499_14_45,GERMANY,29529,24,maximilian kleber,21,2,4,50,0,0,0,2,4,50,0,0,0,0,5,5,1,3,1,0,0,6
441305,499_14_45,GERMANY,12608,33,maik hendrik zirbes,16,0,3,0,0,3,0,0,0,0,0,0,0,1,0,1,1,2,2,0,0,0
441306,499_14_45,GERMANY,0,TOTALS,GERMANY,200,26,53,49.1,16,29,55.2,10,24,41.7,14,17,82.4,11,22,33,16,25,17,1,0,76
441307,499_14_45,POLAND,5694,5,aaron cel,27,6,9,66.7,4,7,57.1,2,2,100,2,2,100,1,4,5,3,2,1,2,0,16
441308,499_14_45,POLAND,4799,6,robert jozef skibniewski,29,3,5,60,1,2,50,2,3,66.7,0,0,0,0,0,0,6,3,1,0,0,8
441309,499_14_45,POLAND,7833,7,damian kulig,22,6,10,60,4,6,66.7,2,4,50,2,2,100,0,4,4,0,3,2,1,2,16
441310,499_14_45,POLAND,24194,8,przemyslaw zamojski,27,1,7,14.3,1,3,33.3,0,4,0,0,0,0,1,3,4,1,2,0,3,0,2
441311,499_14_45,POLAND,15981,9,mateusz ponitka,24,5,9,55.6,1,3,33.3,4,6,66.7,5,6,83.3,0,0,0,0,2,2,1,0,19
441312,499_14_45,POLAND,4804,10,szymon pawel szewczyk,5,0,1,0,0,0,0,0,1,0,0,0,0,0,1,1,0,1,0,0,0,0
441313,499_14_45,POLAND,8034,12,adam waczynski,28,3,8,37.5,1,4,25,2,4,50,4,4,100,1,3,4,7,3,0,0,0,12
441314,499_14_45,POLAND,19694,14,adam hrycaniuk,27,6,9,66.7,6,9,66.7,0,0,0,3,4,75,3,1,4,1,4,1,0,0,15
441315,499_14_45,POLAND,6190,15,kamil jacek laczynski,10,0,0,0,0,0,0,0,0,0,0,0,0,0,0,0,1,2,0,0,0,0
441316,499_14_45,POLAND,8470,20,jaroslaw karol mokros,0,0,0,0,0,0,0,0,0,0,0,0,0,0,0,0,0,0,0,0,0,0
441317,499_14_45,POLAND,15983,21,tomasz gielo,2,0,0,0,0,0,0,0,0,0,0,0,0,0,0,0,0,1,0,0,0,0
441318,499_14_45,POLAND,15977,23,michal michalak,0,0,0,0,0,0,0,0,0,0,0,0,0,0,0,0,0,0,0,0,0,0
441319,499_14_45,POLAND,0,TOTALS,POLAND,200,30,58,51.7,18,34,52.9,12,24,50,16,18,88.9,6,17,23,19,23,7,7,2,88
441320,499_14_46,LATVIA,19755,5,mareks mejeris,6,0,2,0,0,2,0,0,0,0,0,0,0,1,2,3,0,0,0,0,0,0
441321,499_14_46,LATVIA,2539,6,rolands freimanis,16,2,7,28.6,1,3,33.3,1,4,25,2,2,100,0,0,0,2,1,0,1,1,7
441322,499_14_46,LATVIA,5029,7,janis blums,26,2,7,28.6,0,0,0,2,7,28.6,0,0,0,0,1,1,0,2,0,1,0,6
441323,499_14_46,LATVIA,6271,9,dairis bertans,24,3,10,30,1,2,50,2,8,25,0,0,0,0,3,3,1,3,3,0,0,8
441324,499_14_46,LATVIA,12927,10,janis timma,18,2,8,25,1,5,20,1,3,33.3,2,2,100,1,0,1,2,2,0,2,0,7
441325,499_14_46,LATVIA,20350,11,rolands smits,0,0,0,0,0,0,0,0,0,0,0,0,0,0,0,0,0,0,0,0,0,0
441326,499_14_46,LATVIA,4604,12,kristaps janicenoks,32,0,5,0,0,2,0,0,3,0,4,4,100,0,1,1,2,1,0,2,0,4
441327,499_14_46,LATVIA,10585,13,janis strelnieks,33,5,9,55.6,3,5,60,2,4,50,2,4,50,0,6,6,6,4,4,0,0,14
441328,499_14_46,LATVIA,1002,14,kaspars berzins,32,9,16,56.2,8,11,72.7,1,5,20,4,4,100,5,5,10,1,5,3,0,4,23
441329,499_14_46,LATVIA,29525,21,aigars skele,12,2,4,50,2,2,100,0,2,0,0,0,0,1,1,2,1,3,0,2,0,4
441330,499_14_46,LATVIA,5721,30,ronalds zakis,3,0,1,0,0,1,0,0,0,0,0,0,0,0,1,1,0,0,1,0,0,0
441331,499_14_46,LATVIA,15602,33,martins meiers,23,1,3,33.3,1,3,33.3,0,0,0,4,8,50,7,2,9,3,2,1,2,0,6
441332,499_14_46,LATVIA,0,TOTALS,LATVIA,225,26,72,36.1,17,36,47.2,9,36,25,18,24,75,17,24,41,18,23,12,10,5,79
441333,499_14_46,SWEDEN,20455,4,ludvig hakanson,18,0,3,0,0,1,0,0,2,0,4,4,100,0,2,2,2,1,1,0,0,4
441334,499_14_46,SWEDEN,16053,5,tobias borg,24,4,5,80,3,4,75,1,1,100,2,2,100,0,1,1,4,1,5,1,0,11
441335,499_14_46,SWEDEN,4748,6,joakim kjellbom,36,9,15,60,9,15,60,0,0,0,1,2,50,5,8,13,0,3,2,0,2,19
441336,499_14_46,SWEDEN,10481,7,dino pita,4,0,0,0,0,0,0,0,0,0,0,0,0,0,1,1,0,2,0,0,0,0
441337,499_14_46,SWEDEN,10740,8,john gaddefors,28,4,8,50,1,4,25,3,4,75,4,4,100,1,3,4,1,3,0,0,0,15
441338,499_14_46,SWEDEN,1176,9,thomas massamba,12,0,4,0,0,2,0,0,2,0,0,0,0,0,2,2,3,1,1,1,0,0
441339,499_14_46,SWEDEN,1972,10,martin pahlmblad,23,0,3,0,0,1,0,0,2,0,0,0,0,0,1,1,0,2,1,0,0,0
441340,499_14_46,SWEDEN,5844,11,tom liden,26,2,5,40,2,3,66.7,0,2,0,0,0,0,0,1,1,1,3,1,0,2,4
441341,499_14_46,SWEDEN,2702,12,brice massamba,9,0,4,0,0,4,0,0,0,0,1,2,50,0,1,1,0,1,0,0,1,1
441342,499_14_46,SWEDEN,11099,14,alexander lindqvist,17,4,7,57.1,2,5,40,2,2,100,3,4,75,1,4,5,0,5,0,0,0,13
441343,499_14_46,SWEDEN,13061,15,jonathan person,29,3,6,50,3,5,60,0,1,0,3,4,75,1,6,7,4,4,5,0,1,9
441344,499_14_46,SWEDEN,0,TOTALS,SWEDEN,225,26,60,43.3,20,44,45.5,6,16,37.5,18,22,81.8,9,33,42,15,26,19,2,6,76
441345,499_14_47,BELGIUM,10156,4,lionel georges m bosco,30,2,7,28.6,2,4,50,0,3,0,0,0,0,1,3,4,4,1,3,4,0,4
441346,499_14_47,BELGIUM,19894,6,kevin tumba,3,0,0,0,0,0,0,0,0,0,0,0,0,0,0,0,0,1,1,0,0,0
441347,499_14_47,BELGIUM,4548,7,axel hervelle,31,4,14,28.6,3,8,37.5,1,6,16.7,2,4,50,2,8,10,3,3,1,1,0,11
441348,499_14_47,BELGIUM,6157,8,jean-marc mwema,3,0,0,0,0,0,0,0,0,0,0,0,0,0,0,0,0,0,0,0,0,0
441349,499_14_47,BELGIUM,10706,9,olivier troisfontaines,0,0,0,0,0,0,0,0,0,0,0,0,0,0,0,0,0,0,0,0,0,0
441350,499_14_47,BELGIUM,13030,10,loic robin b. schwartz,14,2,4,50,2,3,66.7,0,1,0,0,0,0,2,1,3,1,2,2,1,0,4
441351,499_14_47,BELGIUM,19709,11,guy muya,28,4,6,66.7,4,4,100,0,2,0,1,1,100,0,0,0,1,2,3,2,0,9
441352,499_14_47,BELGIUM,24196,12,wen-boss mukubu,12,3,10,30,1,6,16.7,2,4,50,3,6,50,1,0,1,1,2,1,2,0,11
441353,499_14_47,BELGIUM,11181,13,pierre-antoine gillet,28,1,4,25,0,1,0,1,3,33.3,0,0,0,2,6,8,1,3,0,0,0,3
441354,499_14_47,BELGIUM,10498,14,maxime de zeeuw,18,5,8,62.5,4,5,80,1,3,33.3,2,2,100,2,3,5,1,4,3,0,1,13
441355,499_14_47,BELGIUM,4550,20,roel moors,7,0,4,0,0,4,0,0,0,0,0,0,0,0,0,0,0,1,0,1,0,0
441356,499_14_47,BELGIUM,29508,24,matt lojeski,26,2,7,28.6,2,4,50,0,3,0,4,4,100,1,1,2,2,2,2,1,0,8
441357,499_14_47,BELGIUM,0,TOTALS,BELGIUM,200,23,64,35.9,18,39,46.2,5,25,20,12,17,70.6,11,24,35,14,21,16,12,1,63
441358,499_14_47,MKD,6304,4,ivica dimchevski,0,0,0,0,0,0,0,0,0,0,0,0,0,0,0,0,0,0,0,0,0,0
441359,499_14_47,MKD,22445,5,andrej magdevski,13,0,3,0,0,1,0,0,2,0,0,2,0,0,1,1,0,2,3,0,0,0
441360,499_14_47,MKD,7810,6,darko sokolov,23,0,3,0,0,1,0,0,2,0,3,4,75,0,2,2,1,0,1,2,0,3
441361,499_14_47,MKD,2709,7,aleksandar kostoski,20,2,7,28.6,0,2,0,2,5,40,0,0,0,0,0,0,2,1,5,1,0,6
441362,499_14_47,MKD,5892,8,vojdan stojanovski,27,2,4,50,2,3,66.7,0,1,0,2,3,66.7,1,2,3,4,3,5,1,0,6
441363,499_14_47,MKD,5892,9,damjan stojanovski,11,1,2,50,0,0,0,1,2,50,2,2,100,0,1,1,1,5,2,0,0,5
441364,499_14_47,MKD,6300,10,marko simonovski,28,3,7,42.9,0,1,0,3,6,50,2,2,100,0,4,4,0,0,1,2,0,11
441365,499_14_47,MKD,6306,11,vladimir brckov,0,0,0,0,0,0,0,0,0,0,0,0,0,0,0,0,0,0,0,0,0,0
441366,499_14_47,MKD,2714,12,bojan trajkovski,30,3,11,27.3,2,6,33.3,1,5,20,1,2,50,1,5,6,1,5,3,0,2,8
441367,499_14_47,MKD,11275,13,stojan gjuroski,21,3,5,60,2,2,100,1,3,33.3,0,0,0,3,2,5,0,2,2,0,0,7
441368,499_14_47,MKD,2715,14,marjan janeski,0,0,0,0,0,0,0,0,0,0,0,0,0,0,0,0,0,0,0,0,0,0
441369,499_14_47,MKD,29507,15,venard richard hendriks,27,6,9,66.7,6,8,75,0,1,0,2,3,66.7,3,11,14,0,3,3,0,0,14
441370,499_14_47,MKD,0,TOTALS,MKD,200,20,51,39.2,12,24,50,8,27,29.6,12,18,66.7,9,30,39,9,21,25,6,2,60
441371,499_14_48,MONTENEGRO,12640,5,vladimir mihailovic,12,1,4,25,1,3,33.3,0,1,0,1,3,33.3,1,1,2,1,0,0,0,0,3
441372,499_14_48,MONTENEGRO,10453,6,suad sehovic,29,4,10,40,3,3,100,1,7,14.3,0,0,0,2,2,4,0,4,2,1,0,9
441373,499_14_48,MONTENEGRO,19707,7,vladimir dragicevic,29,8,12,66.7,8,12,66.7,0,0,0,3,4,75,2,3,5,1,2,0,0,1,19
441374,499_14_48,MONTENEGRO,10457,8,sead sehovic,20,2,7,28.6,1,4,25,1,3,33.3,2,3,66.7,1,1,2,3,5,0,0,0,7
441375,499_14_48,MONTENEGRO,1863,9,vladimir golubovic,14,1,1,100,1,1,100,0,0,0,0,0,0,0,2,2,0,2,2,0,1,2
441376,499_14_48,MONTENEGRO,24211,10,taylor campbell rochestie,31,6,10,60,5,8,62.5,1,2,50,0,0,0,0,1,1,5,1,1,1,0,13
441377,499_14_48,MONTENEGRO,11120,12,nemanja radovic,19,1,4,25,1,2,50,0,2,0,0,0,0,0,6,6,0,3,1,0,0,2
441378,499_14_48,MONTENEGRO,11117,13,nemanja djurisic,0,0,0,0,0,0,0,0,0,0,0,0,0,0,0,0,0,0,0,0,0,0
441379,499_14_48,MONTENEGRO,1723,14,ivan maras,0,0,0,0,0,0,0,0,0,0,0,0,0,0,0,0,0,0,0,0,0,0
441380,499_14_48,MONTENEGRO,10455,15,aleksa popovic,18,1,5,20,1,1,100,0,4,0,0,0,0,0,0,0,1,2,0,0,0,2
441381,499_14_48,MONTENEGRO,15868,20,nikola ivanovic,9,0,4,0,0,3,0,0,1,0,0,0,0,0,0,0,0,1,0,0,0,0
441382,499_14_48,MONTENEGRO,15355,22,milos borisov,20,3,7,42.9,1,3,33.3,2,4,50,0,0,0,3,4,7,0,2,0,0,0,8
441383,499_14_48,MONTENEGRO,0,TOTALS,MONTENEGRO,200,27,64,42.2,22,40,55,5,24,20.8,6,10,60,10,22,32,11,22,6,2,2,65
441384,499_14_48,ISRAEL,1680,4,nitzan yehuda hanochi,1,0,0,0,0,0,0,0,0,0,0,0,0,0,0,0,0,1,0,0,0,0
441385,499_14_48,ISRAEL,4794,5,afik nissim,0,0,0,0,0,0,0,0,0,0,0,0,0,0,0,0,0,0,0,0,0,0
441386,499_14_48,ISRAEL,1022,6,raviv guy limonad,16,2,3,66.7,1,2,50,1,1,100,0,0,0,0,1,1,2,2,2,0,0,5
441387,499_14_48,ISRAEL,2522,7,gal mekel,38,5,15,33.3,4,13,30.8,1,2,50,3,4,75,2,9,11,11,1,2,2,0,14
441388,499_14_48,ISRAEL,1023,8,lior eliyahu,21,3,5,60,3,5,60,0,0,0,0,0,0,0,3,3,1,0,1,1,1,6
441389,499_14_48,ISRAEL,1933,9,omri casspi,32,6,9,66.7,6,8,75,0,1,0,5,8,62.5,2,6,8,1,3,2,0,1,17
441390,499_14_48,ISRAEL,10164,10,guy pnini,27,4,7,57.1,3,4,75,1,3,33.3,3,4,75,0,0,0,3,1,1,0,0,12
441391,499_14_48,ISRAEL,1019,12,yotam halperin,25,1,6,16.7,0,4,0,1,2,50,0,0,0,0,2,2,5,2,0,1,0,3
441392,499_14_48,ISRAEL,5780,13,elishay kadir,11,4,4,100,4,4,100,0,0,0,0,0,0,2,0,2,0,3,1,0,0,8
441393,499_14_48,ISRAEL,4620,14,yaniv green,4,1,2,50,1,2,50,0,0,0,1,1,100,1,3,4,0,0,0,0,0,3
441394,499_14_48,ISRAEL,29526,15,dor anthony naheem fischer,24,6,7,85.7,6,7,85.7,0,0,0,0,0,0,1,3,4,1,2,0,0,1,12
441395,499_14_48,ISRAEL,24229,21,dagan yivzori,1,0,0,0,0,0,0,0,0,0,0,0,0,0,0,0,0,0,0,0,0,0
441396,499_14_48,ISRAEL,0,TOTALS,ISRAEL,200,32,58,55.2,28,49,57.1,4,9,44.4,12,17,70.6,9,30,39,24,15,9,4,3,80
441397,499_14_49,GERMANY,8244,7,akeem vargas,1,0,0,0,0,0,0,0,0,0,0,0,0,0,0,0,0,1,2,0,0,0
441398,499_14_49,GERMANY,15385,8,heiko schaffartzik,24,2,7,28.6,0,1,0,2,6,33.3,1,2,50,1,2,3,2,4,2,0,0,7
441399,499_14_49,GERMANY,10446,9,karsten tadda,37,3,7,42.9,1,2,50,2,5,40,0,0,0,0,3,3,5,0,1,3,0,8
441400,499_14_49,GERMANY,5747,10,lucca staiger,14,1,8,12.5,0,2,0,1,6,16.7,1,2,50,0,1,1,1,4,1,0,0,4
441401,499_14_49,GERMANY,6326,12,robin benzing,26,5,8,62.5,2,2,100,3,6,50,1,2,50,2,3,5,1,3,4,0,1,14
441402,499_14_49,GERMANY,15492,13,bastian doreth,3,0,0,0,0,0,0,0,0,0,0,0,0,0,0,0,0,1,0,0,0,0
441403,499_14_49,GERMANY,15493,14,andreas seiferth,0,0,0,0,0,0,0,0,0,0,0,0,0,0,0,0,0,0,0,0,0,0
441404,499_14_49,GERMANY,19866,21,daniel theis,25,3,4,75,3,4,75,0,0,0,4,5,80,2,2,4,1,3,3,1,1,10
441405,499_14_49,GERMANY,19990,22,dennis schroder,26,6,9,66.7,4,4,100,2,5,40,10,10,100,0,3,3,6,3,1,3,0,24
441406,499_14_49,GERMANY,29529,24,maximilian kleber,28,5,6,83.3,3,4,75,2,2,100,3,5,60,2,3,5,2,1,0,1,1,15
441407,499_14_49,GERMANY,19867,25,johannes voigtmann,0,0,0,0,0,0,0,0,0,0,0,0,0,0,0,0,0,0,0,0,0,0
441408,499_14_49,GERMANY,12608,33,maik hendrik zirbes,15,3,4,75,3,4,75,0,0,0,0,0,0,1,2,3,0,4,3,0,1,6
441409,499_14_49,GERMANY,0,TOTALS,GERMANY,200,28,53,52.8,16,23,69.6,12,30,40,20,26,76.9,11,20,31,18,24,17,8,4,88
441410,499_14_49,AUSTRIA,2103,5,thomas schreiner,30,3,8,37.5,0,0,0,3,8,37.5,2,2,100,0,1,1,7,1,3,2,0,11
441411,499_14_49,AUSTRIA,29530,8,enis murati,18,1,5,20,1,5,20,0,0,0,0,0,0,2,0,2,1,0,3,1,0,2
441412,499_14_49,AUSTRIA,16191,14,jozo rados,15,5,7,71.4,5,7,71.4,0,0,0,2,5,40,3,3,6,1,0,1,2,0,12
441413,499_14_49,AUSTRIA,8395,15,david hasenburger,12,2,3,66.7,1,2,50,1,1,100,0,0,0,0,0,0,1,5,1,0,0,5
441414,499_14_49,AUSTRIA,8392,20,romed vieider,5,0,0,0,0,0,0,0,0,0,0,0,0,0,0,0,0,1,0,0,0,0
441415,499_14_49,AUSTRIA,8396,24,rasid mahalbasic,29,7,13,53.8,6,10,60,1,3,33.3,2,2,100,2,3,5,1,3,3,1,0,17
441416,499_14_49,AUSTRIA,8386,25,jesse nii l. seilern und aspang,0,0,0,0,0,0,0,0,0,0,0,0,0,0,0,0,0,0,0,0,0,0
441417,499_14_49,AUSTRIA,6415,34,moritz lanegger,22,2,4,50,1,2,50,1,2,50,0,0,0,1,4,5,2,3,2,0,0,5
441418,499_14_49,AUSTRIA,12529,35,sebastian koch,6,0,2,0,0,1,0,0,1,0,0,0,0,0,0,0,0,1,0,0,0,0
441419,499_14_49,AUSTRIA,13271,41,maximilian hopfgartner,17,2,4,50,1,1,100,1,3,33.3,0,0,0,1,1,2,0,1,2,0,0,5
441420,499_14_49,AUSTRIA,11250,42,thomas klepeisz,22,1,4,25,1,1,100,0,3,0,2,2,100,2,0,2,2,4,3,0,0,4
441421,499_14_49,AUSTRIA,15717,43,anton maresch,24,2,7,28.6,1,3,33.3,1,4,25,3,6,50,0,2,2,0,3,1,0,0,8
441422,499_14_49,AUSTRIA,0,TOTALS,AUSTRIA,200,25,57,43.9,17,32,53.1,8,25,32,11,17,64.7,13,15,28,15,22,19,6,0,69
441423,499_14_50,PORTUGAL,2730,4,jose silva,27,2,7,28.6,1,3,33.3,1,4,25,0,0,0,1,0,1,0,3,0,0,0,5
441424,499_14_50,PORTUGAL,8199,5,joao soares,16,3,6,50,3,4,75,0,2,0,0,0,0,0,2,2,0,2,2,0,0,6
441425,499_14_50,PORTUGAL,8195,6,jose barbosa,0,0,0,0,0,0,0,0,0,0,0,0,0,0,0,0,0,0,0,0,0,0
441426,499_14_50,PORTUGAL,15697,7,carlos diogo serra ferreirinho,0,0,0,0,0,0,0,0,0,0,0,0,0,0,0,0,0,0,0,0,0,0
441427,499_14_50,PORTUGAL,10266,8,mario fernandes,24,4,11,36.4,1,3,33.3,3,8,37.5,0,1,0,0,2,2,3,3,3,2,0,11
441428,499_14_50,PORTUGAL,2736,10,fabio lima,15,1,2,50,0,0,0,1,2,50,0,0,0,1,2,3,0,1,0,1,0,3
441429,499_14_50,PORTUGAL,10956,11,miguel queiroz,4,0,1,0,0,0,0,0,1,0,0,0,0,0,0,0,0,0,0,0,0,0
441430,499_14_50,PORTUGAL,8200,12,joao guerreiro,21,3,5,60,3,5,60,0,0,0,0,0,0,1,2,3,0,3,3,0,0,6
441431,499_14_50,PORTUGAL,7851,13,joao balseiro,22,0,3,0,0,0,0,0,3,0,0,2,0,1,3,4,0,1,2,1,0,0
441432,499_14_50,PORTUGAL,2732,14,pedro pinto,16,1,5,20,1,3,33.3,0,2,0,0,0,0,0,0,0,3,3,2,0,0,2
441433,499_14_50,PORTUGAL,2918,21,claudio fonseca,36,9,18,50,9,18,50,0,0,0,4,11,36.4,3,7,10,0,4,1,0,2,22
441434,499_14_50,PORTUGAL,29527,22,arnette hallman,19,1,2,50,0,0,0,1,2,50,3,4,75,1,1,2,1,0,1,0,0,6
441435,499_14_50,PORTUGAL,0,TOTALS,PORTUGAL,200,24,60,40,18,36,50,6,24,25,7,18,38.9,9,21,30,7,20,15,4,2,61
441436,499_14_50,CZECH REPUBLIC,29502,4,patrik auda,18,3,7,42.9,3,7,42.9,0,0,0,5,6,83.3,0,2,2,0,4,2,2,0,11
441437,499_14_50,CZECH REPUBLIC,12522,5,tomas pomikalek,0,0,0,0,0,0,0,0,0,0,0,0,0,0,0,0,0,0,0,0,0,0
441438,499_14_50,CZECH REPUBLIC,5478,6,pavel pumprla,35,4,5,80,4,5,80,0,0,0,1,2,50,2,9,11,2,1,1,0,0,9
441439,499_14_50,CZECH REPUBLIC,10700,7,vojtech hruban,13,2,2,100,2,2,100,0,0,0,0,0,0,0,0,0,0,3,1,1,0,4
441440,499_14_50,CZECH REPUBLIC,8325,8,tomas satoransky,30,7,12,58.3,6,9,66.7,1,3,33.3,3,3,100,3,4,7,5,2,2,1,0,18
441441,499_14_50,CZECH REPUBLIC,4774,9,jiri welsch,25,1,6,16.7,1,5,20,0,1,0,1,2,50,2,3,5,3,3,3,0,0,3
441442,499_14_50,CZECH REPUBLIC,10702,10,lukas palyza,6,1,3,33.3,0,0,0,1,3,33.3,1,2,50,0,0,0,0,0,0,0,0,4
441443,499_14_50,CZECH REPUBLIC,4775,11,lubos barton,22,3,9,33.3,3,4,75,0,5,0,0,0,0,0,3,3,1,1,3,2,0,6
441444,499_14_50,CZECH REPUBLIC,12850,12,ondrej balvin,24,6,9,66.7,6,9,66.7,0,0,0,1,2,50,3,6,9,2,4,2,1,1,13
441445,499_14_50,CZECH REPUBLIC,10484,13,jakub sirina,10,0,0,0,0,0,0,0,0,0,0,0,0,0,0,0,1,2,0,1,0,0
441446,499_14_50,CZECH REPUBLIC,7823,14,kamil svrdlik,0,0,0,0,0,0,0,0,0,0,0,0,0,0,0,0,0,0,0,0,0,0
441447,499_14_50,CZECH REPUBLIC,1096,22,pavel houska,16,3,6,50,3,4,75,0,2,0,1,2,50,2,2,4,2,1,0,0,0,7
441448,499_14_50,CZECH REPUBLIC,0,TOTALS,CZECH REPUBLIC,200,30,59,50.8,28,45,62.2,2,14,14.3,13,19,68.4,13,29,42,16,21,14,8,1,75
441449,499_14_51,BELARUS,1646,4,kanstantsin yafremau,10,0,1,0,0,1,0,0,0,0,0,2,0,1,1,2,0,1,0,0,0,0
441450,499_14_51,BELARUS,15346,5,siarhei charykau,23,1,3,33.3,1,3,33.3,0,0,0,4,4,100,0,0,0,3,1,2,0,0,6
441451,499_14_51,BELARUS,16119,6,aliaksandr semianiuk,16,1,5,20,1,5,20,0,0,0,1,2,50,0,2,2,0,0,0,1,0,3
441452,499_14_51,BELARUS,29521,7,kiryl sitnik,20,1,6,16.7,1,5,20,0,1,0,0,0,0,0,3,3,1,2,2,0,0,2
441453,499_14_51,BELARUS,2847,8,mikita meshcharakou,15,1,5,20,1,5,20,0,0,0,0,0,0,4,2,6,0,3,1,0,0,2
441454,499_14_51,BELARUS,4916,9,mikalai aliakseyeu,0,0,0,0,0,0,0,0,0,0,0,0,0,0,0,0,0,0,0,0,0,0
441455,499_14_51,BELARUS,13157,10,vitali liutych,29,7,14,50,5,10,50,2,4,50,3,4,75,0,5,5,3,1,2,2,0,19
441456,499_14_51,BELARUS,997,11,dzmitry paliashchuk,13,2,7,28.6,2,5,40,0,2,0,0,0,0,2,3,5,0,2,3,1,0,4
441457,499_14_51,BELARUS,998,12,aliaksandr pustahvar,25,6,10,60,2,3,66.7,4,7,57.1,0,1,0,3,0,3,1,4,5,0,0,16
441458,499_14_51,BELARUS,5476,13,valery gandlin,0,0,0,0,0,0,0,0,0,0,0,0,0,0,0,0,0,0,0,0,0,0
441459,499_14_51,BELARUS,4915,14,aliaksandr kudrautsau,32,6,7,85.7,5,6,83.3,1,1,100,7,9,77.8,0,1,1,3,4,3,4,0,20
441460,499_14_51,BELARUS,1645,15,aliaksei trastsinetski,17,0,2,0,0,2,0,0,0,0,1,2,50,2,0,2,1,1,3,0,0,1
441461,499_14_51,BELARUS,0,TOTALS,BELARUS,200,25,60,41.7,18,45,40,7,15,46.7,16,24,66.7,18,18,36,12,19,21,8,0,73
441462,499_14_51,BELGIUM,10156,4,lionel georges m bosco,30,4,11,36.4,2,3,66.7,2,8,25,0,0,0,1,5,6,9,2,2,3,0,10
441463,499_14_51,BELGIUM,19894,6,kevin tumba,12,2,3,66.7,2,3,66.7,0,0,0,1,4,25,4,1,5,0,1,0,0,3,5
441464,499_14_51,BELGIUM,4548,7,axel hervelle,28,5,11,45.5,4,5,80,1,6,16.7,5,7,71.4,3,2,5,8,0,2,3,1,16
441465,499_14_51,BELGIUM,6157,8,jean-marc mwema,11,2,2,100,2,2,100,0,0,0,0,0,0,0,1,1,2,4,0,1,1,4
441466,499_14_51,BELGIUM,10706,9,olivier troisfontaines,5,2,3,66.7,1,1,100,1,2,50,0,0,0,0,0,0,1,0,0,0,0,5
441467,499_14_51,BELGIUM,13030,10,loic robin b. schwartz,7,0,4,0,0,1,0,0,3,0,0,0,0,1,0,1,0,0,1,0,0,0
441468,499_14_51,BELGIUM,19709,11,guy muya,19,3,4,75,3,4,75,0,0,0,0,0,0,1,1,2,4,3,3,2,0,6
441469,499_14_51,BELGIUM,24196,12,wen-boss mukubu,20,6,10,60,4,5,80,2,5,40,0,0,0,0,5,5,3,3,1,0,0,14
441470,499_14_51,BELGIUM,11181,13,pierre-antoine gillet,24,2,3,66.7,1,2,50,1,1,100,0,0,0,1,2,3,2,4,1,1,0,5
441471,499_14_51,BELGIUM,10498,14,maxime de zeeuw,14,2,4,50,1,2,50,1,2,50,1,1,100,1,0,1,0,1,0,0,1,6
441472,499_14_51,BELGIUM,29508,24,matt lojeski,29,10,14,71.4,6,7,85.7,4,7,57.1,4,4,100,0,2,2,2,3,1,2,0,28
441473,499_14_51,BELGIUM,0,TOTALS,BELGIUM,200,38,69,55.1,26,35,74.3,12,34,35.3,11,16,68.8,13,20,33,31,21,11,12,6,99
441474,499_14_52,SWEDEN,20455,4,ludvig hakanson,23,5,9,55.6,1,2,50,4,7,57.1,6,8,75,0,2,2,3,4,2,3,0,20
441475,499_14_52,SWEDEN,16053,5,tobias borg,18,0,4,0,0,3,0,0,1,0,0,0,0,1,0,1,1,1,1,0,0,0
441476,499_14_52,SWEDEN,4748,6,joakim kjellbom,28,7,9,77.8,7,9,77.8,0,0,0,6,7,85.7,4,7,11,2,3,0,0,0,20
441477,499_14_52,SWEDEN,10481,7,dino pita,18,3,6,50,2,3,66.7,1,3,33.3,1,2,50,0,1,1,0,2,0,1,0,8
441478,499_14_52,SWEDEN,10740,8,john gaddefors,23,5,9,55.6,3,4,75,2,5,40,2,3,66.7,0,0,0,0,1,2,2,0,14
441479,499_14_52,SWEDEN,1176,9,thomas massamba,13,1,3,33.3,1,2,50,0,1,0,0,0,0,0,3,3,3,1,0,0,0,2
441480,499_14_52,SWEDEN,1972,10,martin pahlmblad,16,0,7,0,0,2,0,0,5,0,0,0,0,1,0,1,0,2,0,0,0,0
441481,499_14_52,SWEDEN,5844,11,tom liden,12,2,6,33.3,1,4,25,1,2,50,0,0,0,2,0,2,2,0,0,2,0,5
441482,499_14_52,SWEDEN,2702,12,brice massamba,12,1,1,100,1,1,100,0,0,0,0,0,0,2,0,2,1,4,1,0,0,2
441483,499_14_52,SWEDEN,11099,14,alexander lindqvist,10,1,3,33.3,0,1,0,1,2,50,0,0,0,0,0,0,0,2,1,0,0,3
441484,499_14_52,SWEDEN,13061,15,jonathan person,27,4,7,57.1,3,5,60,1,2,50,3,4,75,1,1,2,3,5,1,1,0,12
441485,499_14_52,SWEDEN,15688,40,carl engstrom,0,0,0,0,0,0,0,0,0,0,0,0,0,0,0,0,0,0,0,0,0,0
441486,499_14_52,SWEDEN,0,TOTALS,SWEDEN,200,29,64,45.3,19,36,52.8,10,28,35.7,18,24,75,13,15,28,15,25,9,9,0,86
441487,499_14_52,ROMANIA,2115,4,andrei mandache,34,3,8,37.5,2,3,66.7,1,5,20,2,2,100,2,4,6,3,2,2,1,0,9
441488,499_14_52,ROMANIA,10239,5,mihail-octavian paul,22,4,5,80,3,3,100,1,2,50,3,3,100,0,4,4,2,2,2,1,0,12
441489,499_14_52,ROMANIA,5015,6,levente szijarto,9,1,1,100,1,1,100,0,0,0,0,0,0,0,0,0,1,1,0,0,0,2
441490,499_14_52,ROMANIA,2900,9,vlad moldoveanu,32,7,12,58.3,4,7,57.1,3,5,60,5,6,83.3,0,1,1,3,4,2,0,0,22
441491,499_14_52,ROMANIA,2915,10,catalin baciu,21,4,5,80,4,5,80,0,0,0,6,6,100,1,8,9,1,3,1,1,2,14
441492,499_14_52,ROMANIA,15354,11,octavian calota-popa,0,0,0,0,0,0,0,0,0,0,0,0,0,0,0,0,0,0,0,0,0,0
441493,499_14_52,ROMANIA,11102,12,bogdan tibirna,0,0,0,0,0,0,0,0,0,0,0,0,0,0,0,0,0,0,0,0,0,0
441494,499_14_52,ROMANIA,15358,13,teodor gabriel jucan,2,0,0,0,0,0,0,0,0,0,0,0,0,0,0,0,0,0,1,0,0,0
441495,499_14_52,ROMANIA,2125,14,titus nicoara,4,1,1,100,1,1,100,0,0,0,0,0,0,2,0,2,0,1,0,0,0,2
441496,499_14_52,ROMANIA,4965,15,mihai vlad silvasan,23,3,5,60,0,1,0,3,4,75,0,0,0,0,1,1,3,5,4,0,0,9
441497,499_14_52,ROMANIA,5016,21,adrian tudor,18,1,4,25,0,3,0,1,1,100,0,0,0,1,0,1,0,3,2,0,0,3
441498,499_14_52,ROMANIA,12712,44,adrian gutoaia,34,3,7,42.9,3,5,60,0,2,0,9,10,90,1,5,6,3,2,2,3,0,15
441499,499_14_52,ROMANIA,0,TOTALS,ROMANIA,200,27,48,56.2,18,29,62.1,9,19,47.4,25,27,92.6,7,25,32,16,23,17,6,2,88
441500,499_14_53,SLOVAK REPUBLIC,15367,4,marek kozlik,20,1,2,50,0,0,0,1,2,50,0,0,0,1,2,3,1,3,3,3,0,3
441501,499_14_53,SLOVAK REPUBLIC,6339,5,peter dorazil,15,2,4,50,2,4,50,0,0,0,0,0,0,0,1,1,1,4,1,1,0,4
441502,499_14_53,SLOVAK REPUBLIC,1154,6,peter sedmak,34,8,19,42.1,8,15,53.3,0,4,0,7,7,100,0,6,6,0,5,1,0,0,23
441503,499_14_53,SLOVAK REPUBLIC,11264,7,tomas mrvis,21,0,4,0,0,3,0,0,1,0,0,0,0,1,4,5,1,1,0,3,0,0
441504,499_14_53,SLOVAK REPUBLIC,10469,8,milan ziak,24,6,8,75,5,6,83.3,1,2,50,2,3,66.7,0,0,0,1,1,4,0,0,15
441505,499_14_53,SLOVAK REPUBLIC,5862,9,martin bilik,16,0,3,0,0,1,0,0,2,0,0,0,0,0,0,0,0,1,0,0,0,0
441506,499_14_53,SLOVAK REPUBLIC,29524,10,nenad milosevic,26,2,11,18.2,1,4,25,1,7,14.3,4,4,100,0,3,3,7,2,4,1,0,9
441507,499_14_53,SLOVAK REPUBLIC,6335,11,stanislav baldovsky,3,0,1,0,0,1,0,0,0,0,0,0,0,0,0,0,1,4,1,0,0,0
441508,499_14_53,SLOVAK REPUBLIC,13095,12,maurizio galata,8,0,0,0,0,0,0,0,0,0,0,0,0,0,1,1,0,0,1,0,0,0
441509,499_14_53,SLOVAK REPUBLIC,12668,13,andrej kuffa,22,4,7,57.1,3,4,75,1,3,33.3,0,0,0,0,4,4,1,2,0,0,2,9
441510,499_14_53,SLOVAK REPUBLIC,8444,15,marek jass,12,1,2,50,1,1,100,0,1,0,0,0,0,0,0,0,0,1,0,0,0,2
441511,499_14_53,SLOVAK REPUBLIC,0,TOTALS,SLOVAK REPUBLIC,200,24,61,39.3,20,39,51.3,4,22,18.2,13,14,92.9,3,23,26,13,24,17,8,2,65
441512,499_14_53,LATVIA,19994,4,ingus jakovics,7,1,1,100,0,0,0,1,1,100,3,4,75,0,0,0,0,1,2,1,1,6
441513,499_14_53,LATVIA,19755,5,mareks mejeris,18,2,4,50,1,2,50,1,2,50,1,2,50,1,4,5,1,1,1,0,0,6
441514,499_14_53,LATVIA,2539,6,rolands freimanis,13,2,5,40,2,3,66.7,0,2,0,2,2,100,0,1,1,1,3,1,2,0,6
441515,499_14_53,LATVIA,5029,7,janis blums,20,5,9,55.6,2,2,100,3,7,42.9,0,0,0,0,3,3,1,1,0,0,0,13
441516,499_14_53,LATVIA,6271,9,dairis bertans,17,4,6,66.7,2,2,100,2,4,50,1,1,100,1,2,3,3,2,2,1,0,11
441517,499_14_53,LATVIA,20350,11,rolands smits,20,3,4,75,3,4,75,0,0,0,1,1,100,2,6,8,1,4,1,0,0,7
441518,499_14_53,LATVIA,4604,12,kristaps janicenoks,30,5,8,62.5,2,4,50,3,4,75,0,0,0,1,4,5,3,1,2,1,0,13
441519,499_14_53,LATVIA,10585,13,janis strelnieks,24,3,7,42.9,1,2,50,2,5,40,1,1,100,1,2,3,2,0,0,2,0,9
441520,499_14_53,LATVIA,1002,14,kaspars berzins,23,1,4,25,1,3,33.3,0,1,0,2,2,100,1,5,6,1,4,4,1,2,4
441521,499_14_53,LATVIA,29525,21,aigars skele,11,0,4,0,0,3,0,0,1,0,3,4,75,0,2,2,2,0,3,0,0,3
441522,499_14_53,LATVIA,5721,30,ronalds zakis,5,0,2,0,0,2,0,0,0,0,4,4,100,0,1,1,0,0,0,0,0,4
441523,499_14_53,LATVIA,15602,33,martins meiers,11,3,4,75,3,4,75,0,0,0,1,4,25,1,2,3,2,2,3,0,2,7
441524,499_14_53,LATVIA,0,TOTALS,LATVIA,200,29,58,50,17,31,54.8,12,27,44.4,19,25,76,8,35,43,17,19,20,8,5,89
441525,499_14_54,ISRAEL,1680,4,nitzan yehuda hanochi,4,0,1,0,0,1,0,0,0,0,0,0,0,0,0,0,0,1,0,0,0,0
441526,499_14_54,ISRAEL,1022,6,raviv guy limonad,26,6,11,54.5,6,10,60,0,1,0,2,2,100,0,0,0,1,2,0,1,0,14
441527,499_14_54,ISRAEL,2522,7,gal mekel,33,7,10,70,6,8,75,1,2,50,1,2,50,2,3,5,6,2,0,0,0,16
441528,499_14_54,ISRAEL,1023,8,lior eliyahu,25,4,9,44.4,4,9,44.4,0,0,0,0,0,0,4,2,6,4,1,0,2,0,8
441529,499_14_54,ISRAEL,1933,9,omri casspi,32,6,8,75,2,2,100,4,6,66.7,6,8,75,0,8,8,4,4,4,2,1,22
441530,499_14_54,ISRAEL,10164,10,guy pnini,25,2,6,33.3,1,2,50,1,4,25,0,0,0,0,3,3,6,2,4,1,0,5
441531,499_14_54,ISRAEL,1019,12,yotam halperin,28,3,7,42.9,1,3,33.3,2,4,50,4,4,100,0,1,1,3,4,3,3,0,12
441532,499_14_54,ISRAEL,5780,13,elishay kadir,6,1,2,50,1,2,50,0,0,0,0,0,0,0,1,1,0,0,1,0,0,2
441533,499_14_54,ISRAEL,4620,14,yaniv green,10,0,0,0,0,0,0,0,0,0,0,0,0,0,2,2,0,0,1,0,1,0
441534,499_14_54,ISRAEL,29526,15,dor anthony naheem fischer,11,1,3,33.3,1,3,33.3,0,0,0,2,2,100,0,1,1,0,3,0,1,0,4
441535,499_14_54,ISRAEL,15384,20,yuval naimy,0,0,0,0,0,0,0,0,0,0,0,0,0,0,0,0,0,0,0,0,0,0
441536,499_14_54,ISRAEL,24229,21,dagan yivzori,1,0,0,0,0,0,0,0,0,0,0,0,0,0,0,0,0,0,0,0,0,0
441537,499_14_54,ISRAEL,0,TOTALS,ISRAEL,200,30,57,52.6,22,40,55,8,17,47.1,15,18,83.3,6,23,29,24,19,14,10,2,83
441538,499_14_54,NETHERLANDS,10202,4,arvin slagter,16,2,6,33.3,0,2,0,2,4,50,0,0,0,0,0,0,1,1,2,0,0,6
441539,499_14_54,NETHERLANDS,15661,5,leon williams,30,3,10,30,3,9,33.3,0,1,0,1,1,100,3,0,3,4,3,0,0,0,7
441540,499_14_54,NETHERLANDS,24213,6,worthy de jong,22,5,13,38.5,3,10,30,2,3,66.7,3,7,42.9,2,3,5,0,0,6,2,1,15
441541,499_14_54,NETHERLANDS,22012,7,julius clay van sauers,11,0,2,0,0,1,0,0,1,0,0,0,0,2,1,3,0,1,0,0,0,0
441542,499_14_54,NETHERLANDS,13250,8,dexter cornelis hope,20,3,6,50,1,3,33.3,2,3,66.7,1,1,100,1,1,2,0,2,2,1,0,9
441543,499_14_54,NETHERLANDS,10671,9,mohamed kherrazi,23,2,5,40,2,4,50,0,1,0,0,0,0,2,3,5,1,4,3,2,0,4
441544,499_14_54,NETHERLANDS,12501,10,ralf de pagter,28,3,5,60,3,5,60,0,0,0,2,4,50,0,2,2,2,4,2,3,0,8
441545,499_14_54,NETHERLANDS,6397,11,thomas koenis,0,0,0,0,0,0,0,0,0,0,0,0,0,0,0,0,0,0,0,0,0,0
441546,499_14_54,NETHERLANDS,20078,13,kevin bleeker,21,0,1,0,0,1,0,0,0,0,0,2,0,1,5,6,1,0,1,1,1,0
441547,499_14_54,NETHERLANDS,5812,14,nick oudendag,23,5,7,71.4,5,7,71.4,0,0,0,1,5,20,3,6,9,0,3,6,0,0,11
441548,499_14_54,NETHERLANDS,2871,21,roeland schaftenaar,5,0,0,0,0,0,0,0,0,0,0,0,0,0,1,1,0,0,1,0,0,0
441549,499_14_54,NETHERLANDS,0,TOTALS,NETHERLANDS,200,23,55,41.8,17,42,40.5,6,13,46.2,8,20,40,15,23,38,9,19,24,9,2,60
441550,499_14_55,GEORGIA,8378,4,nika metreveli,11,1,3,33.3,1,3,33.3,0,0,0,1,1,100,1,1,2,1,4,0,0,0,3
441551,499_14_55,GEORGIA,16023,5,otar pkhakadze,5,0,1,0,0,1,0,0,0,0,0,0,0,0,1,1,0,0,0,0,0,0
441552,499_14_55,GEORGIA,4919,7,zaza pachulia,31,6,11,54.5,6,11,54.5,0,0,0,5,6,83.3,3,4,7,5,3,5,3,0,17
441553,499_14_55,GEORGIA,1690,8,george tsintsadze,35,0,7,0,0,3,0,0,4,0,2,2,100,0,1,1,10,0,2,0,0,2
441554,499_14_55,GEORGIA,15684,10,duda sanadze,25,4,5,80,0,0,0,4,5,80,0,0,0,1,2,3,5,3,1,0,0,12
441555,499_14_55,GEORGIA,12467,12,levan patsatsia,16,1,3,33.3,0,1,0,1,2,50,0,0,0,0,1,1,3,1,0,0,0,3
441556,499_14_55,GEORGIA,1699,13,viktor sanikidze,30,5,7,71.4,5,7,71.4,0,0,0,1,4,25,4,5,9,2,3,4,0,1,11
441557,499_14_55,GEORGIA,16022,15,beka burjanadze,9,1,3,33.3,1,2,50,0,1,0,0,0,0,1,3,4,1,1,0,0,0,2
441558,499_14_55,GEORGIA,8382,22,george sharabidze,0,0,0,0,0,0,0,0,0,0,0,0,0,0,0,0,0,0,0,0,0,0
441559,499_14_55,GEORGIA,11036,23,tornike shengelia,29,11,16,68.8,9,14,64.3,2,2,100,2,3,66.7,3,5,8,2,2,1,2,1,26
441560,499_14_55,GEORGIA,1693,25,besik lezhava,9,1,2,50,0,0,0,1,2,50,0,0,0,0,0,0,0,2,1,0,0,3
441561,499_14_55,GEORGIA,2604,31,beka tsivtsivadze,0,0,0,0,0,0,0,0,0,0,0,0,0,0,0,0,0,0,0,0,0,0
441562,499_14_55,GEORGIA,0,TOTALS,GEORGIA,200,30,58,51.7,22,42,52.4,8,16,50,11,16,68.8,13,26,39,29,19,14,5,2,79
441563,499_14_55,HUNGARY,4537,5,gabor denes,6,0,0,0,0,0,0,0,0,0,0,0,0,0,0,0,0,1,1,0,0,0
441564,499_14_55,HUNGARY,12503,6,akos keller,23,3,4,75,3,4,75,0,0,0,0,2,0,1,5,6,0,4,2,0,1,6
441565,499_14_55,HUNGARY,1125,7,krisztian wittmann,33,6,13,46.2,4,7,57.1,2,6,33.3,0,0,0,0,1,1,3,3,0,1,0,14
441566,499_14_55,HUNGARY,8415,9,david vojvoda,33,5,16,31.2,4,11,36.4,1,5,20,2,2,100,1,1,2,7,3,2,3,0,13
441567,499_14_55,HUNGARY,2743,10,zoltan supola,2,0,1,0,0,1,0,0,0,0,0,0,0,1,0,1,0,0,0,0,0,0
441568,499_14_55,HUNGARY,1942,11,norbert toth,20,2,3,66.7,1,2,50,1,1,100,0,0,0,1,0,1,0,2,1,0,1,5
441569,499_14_55,HUNGARY,2750,12,milan csorvasi,3,0,0,0,0,0,0,0,0,0,0,0,0,0,0,0,0,1,0,0,1,0
441570,499_14_55,HUNGARY,2751,13,adam toth,13,0,2,0,0,2,0,0,0,0,0,0,0,1,1,2,1,3,0,0,1,0
441571,499_14_55,HUNGARY,29528,14,jermaine dontay thomas,30,4,11,36.4,2,4,50,2,7,28.6,2,2,100,0,3,3,3,0,4,2,0,12
441572,499_14_55,HUNGARY,1123,15,csaba ferencz,17,1,2,50,1,1,100,0,1,0,0,0,0,0,2,2,0,3,0,1,0,2
441573,499_14_55,HUNGARY,8051,21,andras rujak,5,0,2,0,0,0,0,0,2,0,0,0,0,0,0,0,0,1,0,0,0,0
441574,499_14_55,HUNGARY,11148,22,janos eilingsfeld,16,2,4,50,1,1,100,1,3,33.3,2,2,100,1,2,3,0,1,0,0,0,7
441575,499_14_55,HUNGARY,0,TOTALS,HUNGARY,200,23,58,39.7,16,33,48.5,7,25,28,6,8,75,7,15,22,14,22,11,7,4,59
441576,499_14_56,BOSNIA AND HERZEGOVINA,5859,4,muhamed pasalic,10,0,2,0,0,0,0,0,2,0,0,0,0,1,0,1,3,1,2,0,0,0
441577,499_14_56,BOSNIA AND HERZEGOVINA,20566,5,nedim buza,0,0,0,0,0,0,0,0,0,0,0,0,0,0,0,0,0,0,0,0,0,0
441578,499_14_56,BOSNIA AND HERZEGOVINA,7780,6,andrija stipanovic,29,2,6,33.3,2,6,33.3,0,0,0,1,2,50,2,7,9,2,5,3,1,1,5
441579,499_14_56,BOSNIA AND HERZEGOVINA,24189,7,marko sutalo,26,5,5,100,1,1,100,4,4,100,0,0,0,0,0,0,1,4,0,0,0,14
441580,499_14_56,BOSNIA AND HERZEGOVINA,2887,10,nemanja gordic,30,3,3,100,3,3,100,0,0,0,1,4,25,0,1,1,7,3,3,2,0,7
441581,499_14_56,BOSNIA AND HERZEGOVINA,2891,11,elmedin kikanovic,24,5,9,55.6,5,9,55.6,0,0,0,2,3,66.7,1,3,4,0,1,0,2,0,12
441582,499_14_56,BOSNIA AND HERZEGOVINA,4561,12,mirza teletovic,29,8,21,38.1,5,10,50,3,11,27.3,6,8,75,0,2,2,3,3,1,0,0,25
441583,499_14_56,BOSNIA AND HERZEGOVINA,11206,13,miralem halilovic,0,0,0,0,0,0,0,0,0,0,0,0,0,0,0,0,0,0,0,0,0,0
441584,499_14_56,BOSNIA AND HERZEGOVINA,24216,14,nemanja mitrovic,20,3,4,75,0,1,0,3,3,100,0,0,0,0,0,0,0,1,1,0,0,9
441585,499_14_56,BOSNIA AND HERZEGOVINA,15282,15,milan milosevic,28,1,3,33.3,1,1,100,0,2,0,0,0,0,3,7,10,3,3,1,1,0,2
441586,499_14_56,BOSNIA AND HERZEGOVINA,17436,22,adin vrabac,4,0,0,0,0,0,0,0,0,0,0,2,0,0,1,1,0,0,0,0,0,0
441587,499_14_56,BOSNIA AND HERZEGOVINA,29498,23,drasko albijanic,0,0,0,0,0,0,0,0,0,0,0,0,0,0,0,0,0,0,0,0,0,0
441588,499_14_56,BOSNIA AND HERZEGOVINA,0,TOTALS,BOSNIA AND HERZEGOVINA,200,27,53,50.9,17,31,54.8,10,22,45.5,10,19,52.6,9,24,33,19,21,12,6,1,74
441589,499_14_56,GREAT BRITAIN,805,4,kieron achara,26,5,6,83.3,4,5,80,1,1,100,2,2,100,2,2,4,2,4,0,0,1,13
441590,499_14_56,GREAT BRITAIN,5821,5,ashley hamilton,0,0,0,0,0,0,0,0,0,0,0,0,0,0,0,0,0,0,0,0,0,0
441591,499_14_56,GREAT BRITAIN,6383,6,devan bailey,23,1,4,25,1,3,33.3,0,1,0,0,0,0,0,1,1,3,4,0,0,0,2
441592,499_14_56,GREAT BRITAIN,13115,7,devon van oostrum,0,0,0,0,0,0,0,0,0,0,0,0,0,0,0,0,0,0,0,0,0,0
441593,499_14_56,GREAT BRITAIN,10185,8,andrew sullivan,27,3,7,42.9,1,3,33.3,2,4,50,0,0,0,1,0,1,4,3,1,2,0,8
441594,499_14_56,GREAT BRITAIN,12429,9,gareth murray,5,0,1,0,0,1,0,0,0,0,0,0,0,0,1,1,0,0,0,0,0,0
441595,499_14_56,GREAT BRITAIN,1984,10,dan clark,26,0,3,0,0,2,0,0,1,0,0,2,0,2,5,7,2,3,2,2,0,0
441596,499_14_56,GREAT BRITAIN,15538,12,myles edward sinclair hesson,11,1,2,50,1,1,100,0,1,0,1,1,100,0,1,1,0,3,1,0,0,3
441597,499_14_56,GREAT BRITAIN,2833,13,matt bryan-amaning,0,0,0,0,0,0,0,0,0,0,0,0,0,0,0,0,0,0,0,0,0,0
441598,499_14_56,GREAT BRITAIN,10192,14,eric boateng,24,5,7,71.4,5,7,71.4,0,0,0,1,3,33.3,1,4,5,1,2,3,1,0,11
441599,499_14_56,GREAT BRITAIN,19759,15,kyle johnson,31,4,16,25,2,9,22.2,2,7,28.6,2,3,66.7,3,2,5,1,1,1,0,0,12
441600,499_14_56,GREAT BRITAIN,12534,24,ben mockford,27,7,13,53.8,2,5,40,5,8,62.5,0,0,0,1,2,3,3,0,1,2,0,19
441601,499_14_56,GREAT BRITAIN,0,TOTALS,GREAT BRITAIN,200,26,59,44.1,16,36,44.4,10,23,43.5,6,11,54.5,10,21,31,16,20,12,7,1,68
441602,499_14_57,POLAND,5694,5,aaron cel,18,4,5,80,4,5,80,0,0,0,2,2,100,0,5,5,2,1,2,1,0,10
441603,499_14_57,POLAND,4799,6,robert jozef skibniewski,17,2,3,66.7,2,3,66.7,0,0,0,0,0,0,0,2,2,3,1,3,0,0,4
441604,499_14_57,POLAND,7833,7,damian kulig,15,5,7,71.4,5,7,71.4,0,0,0,2,2,100,5,8,13,1,2,1,1,0,12
441605,499_14_57,POLAND,24194,8,przemyslaw zamojski,16,2,7,28.6,0,1,0,2,6,33.3,0,0,0,1,1,2,3,2,1,0,0,6
441606,499_14_57,POLAND,15981,9,mateusz ponitka,14,3,7,42.9,3,5,60,0,2,0,0,0,0,1,1,2,3,0,0,1,0,6
441607,499_14_57,POLAND,4804,10,szymon pawel szewczyk,22,7,9,77.8,7,8,87.5,0,1,0,3,4,75,0,5,5,2,0,1,1,0,17
441608,499_14_57,POLAND,12920,11,przemyslaw karnowski,12,4,4,100,4,4,100,0,0,0,0,2,0,0,3,3,2,3,1,0,0,8
441609,499_14_57,POLAND,8034,12,adam waczynski,19,4,7,57.1,1,1,100,3,6,50,2,2,100,1,1,2,4,0,2,4,0,13
441610,499_14_57,POLAND,19694,14,adam hrycaniuk,11,2,2,100,2,2,100,0,0,0,0,0,0,0,1,1,0,1,2,0,0,4
441611,499_14_57,POLAND,6190,15,kamil jacek laczynski,23,2,4,50,1,1,100,1,3,33.3,0,0,0,0,1,1,10,3,3,2,0,5
441612,499_14_57,POLAND,15983,21,tomasz gielo,18,1,4,25,1,2,50,0,2,0,3,3,100,0,3,3,1,1,2,1,0,5
441613,499_14_57,POLAND,15977,23,michal michalak,15,4,7,57.1,2,4,50,2,3,66.7,0,0,0,0,3,3,2,1,3,1,0,10
441614,499_14_57,POLAND,0,TOTALS,POLAND,200,40,66,60.6,32,43,74.4,8,23,34.8,12,15,80,10,35,45,33,15,21,12,0,100
441615,499_14_57,LUXEMBOURG,5011,4,tom schumacher,28,2,10,20,2,5,40,0,5,0,0,0,0,0,1,1,3,2,2,2,0,4
441616,499_14_57,LUXEMBOURG,5918,5,pitt koster,7,1,3,33.3,1,3,33.3,0,0,0,0,0,0,0,0,0,1,0,4,0,0,2
441617,499_14_57,LUXEMBOURG,2966,6,raul leandro birenbaum,24,3,6,50,2,2,100,1,4,25,0,0,0,0,2,2,1,2,1,0,0,7
441618,499_14_57,LUXEMBOURG,8344,8,christopher c. g. jones,25,5,11,45.5,4,6,66.7,1,5,20,2,2,100,1,4,5,5,0,7,4,0,13
441619,499_14_57,LUXEMBOURG,19727,10,patrick arbaut,14,2,4,50,2,3,66.7,0,1,0,0,1,0,0,2,2,0,1,1,1,0,4
441620,499_14_57,LUXEMBOURG,13285,11,bob melcher,0,0,0,0,0,0,0,0,0,0,0,0,0,0,0,0,0,0,0,0,0,0
441621,499_14_57,LUXEMBOURG,19728,12,alexandre rodenbourg,28,5,9,55.6,3,7,42.9,2,2,100,2,2,100,1,1,2,2,1,1,1,0,14
441622,499_14_57,LUXEMBOURG,8340,22,jean nicolas c. kox,16,0,2,0,0,1,0,0,1,0,0,0,0,1,2,3,2,1,0,0,0,0
441623,499_14_57,LUXEMBOURG,1283,23,jairo emanuel delgado ferreira,27,2,6,33.3,1,1,100,1,5,20,0,0,0,1,1,2,1,3,2,1,0,5
441624,499_14_57,LUXEMBOURG,17901,24,thomas grun,7,1,2,50,1,2,50,0,0,0,0,0,0,0,0,0,0,1,1,0,0,2
441625,499_14_57,LUXEMBOURG,29517,30,dominique benseghir,2,0,1,0,0,0,0,0,1,0,0,0,0,0,0,0,0,0,0,0,0,0
441626,499_14_57,LUXEMBOURG,13176,31,alex laurent,21,5,10,50,3,6,50,2,4,50,1,1,100,0,1,1,1,2,3,2,0,13
441627,499_14_57,LUXEMBOURG,0,TOTALS,LUXEMBOURG,200,26,64,40.6,19,36,52.8,7,28,25,5,6,83.3,4,17,21,16,13,22,11,0,64
441628,499_14_58,BULGARIA,12491,6,simeon iliev,1,0,0,0,0,0,0,0,0,0,0,0,0,0,0,0,0,0,0,0,0,0
441629,499_14_58,BULGARIA,8350,7,hristo zahariev,17,2,4,50,1,3,33.3,1,1,100,0,2,0,1,0,1,0,1,1,0,0,5
441630,499_14_58,BULGARIA,8347,10,bozhidar avramov,37,5,12,41.7,5,9,55.6,0,3,0,5,6,83.3,0,4,4,4,3,1,3,0,15
441631,499_14_58,BULGARIA,1675,13,asen velikov,27,4,9,44.4,3,5,60,1,4,25,0,0,0,2,3,5,3,4,1,1,0,9
441632,499_14_58,BULGARIA,10589,15,stanislav vaklinov,1,0,0,0,0,0,0,0,0,0,0,0,0,0,0,0,0,0,0,0,0,0
441633,499_14_58,BULGARIA,5588,21,nikolay varbanov,32,2,7,28.6,2,7,28.6,0,0,0,3,4,75,2,2,4,0,3,3,0,2,7
441634,499_14_58,BULGARIA,13084,22,pavlin ivanov,26,6,12,50,2,4,50,4,8,50,0,0,0,1,0,1,1,0,1,3,0,16
441635,499_14_58,BULGARIA,15604,23,stanimir marinov,13,1,4,25,1,2,50,0,2,0,0,1,0,0,2,2,1,3,4,1,0,2
441636,499_14_58,BULGARIA,7959,24,kostadin marshavelski,6,0,2,0,0,2,0,0,0,0,0,0,0,1,3,4,0,2,1,0,0,0
441637,499_14_58,BULGARIA,17555,41,aleksandar vezenkov,36,5,13,38.5,4,8,50,1,5,20,6,7,85.7,4,3,7,1,3,1,2,0,17
441638,499_14_58,BULGARIA,13088,50,dimitar dimitrov,4,0,1,0,0,0,0,0,1,0,2,2,100,0,3,3,0,2,0,0,0,2
441639,499_14_58,BULGARIA,0,TOTALS,BULGARIA,200,25,64,39.1,18,40,45,7,24,29.2,16,22,72.7,11,23,34,10,21,13,10,2,73
441640,499_14_58,MONTENEGRO,12640,5,vladimir mihailovic,8,1,1,100,1,1,100,0,0,0,0,4,0,1,0,1,0,0,2,0,0,2
441641,499_14_58,MONTENEGRO,10453,6,suad sehovic,16,2,2,100,2,2,100,0,0,0,0,0,0,2,4,6,1,0,1,1,0,4
441642,499_14_58,MONTENEGRO,19707,7,vladimir dragicevic,17,5,11,45.5,5,10,50,0,1,0,0,0,0,1,2,3,1,3,0,3,2,10
441643,499_14_58,MONTENEGRO,10457,8,sead sehovic,28,5,9,55.6,2,3,66.7,3,6,50,2,2,100,0,2,2,2,4,1,0,0,15
441644,499_14_58,MONTENEGRO,1863,9,vladimir golubovic,21,7,11,63.6,7,11,63.6,0,0,0,1,1,100,2,8,10,0,2,1,1,1,15
441645,499_14_58,MONTENEGRO,24211,10,taylor campbell rochestie,28,6,11,54.5,5,8,62.5,1,3,33.3,4,4,100,1,1,2,2,3,2,2,0,17
441646,499_14_58,MONTENEGRO,11120,12,nemanja radovic,24,1,4,25,1,3,33.3,0,1,0,0,0,0,3,3,6,3,2,0,0,0,2
441647,499_14_58,MONTENEGRO,11117,13,nemanja djurisic,0,0,0,0,0,0,0,0,0,0,0,0,0,0,0,0,0,0,0,0,0,0
441648,499_14_58,MONTENEGRO,1723,14,ivan maras,2,0,0,0,0,0,0,0,0,0,1,2,50,0,0,0,0,2,0,0,0,1
441649,499_14_58,MONTENEGRO,10455,15,aleksa popovic,28,5,10,50,4,7,57.1,1,3,33.3,0,0,0,2,3,5,1,1,2,0,0,11
441650,499_14_58,MONTENEGRO,15868,20,nikola ivanovic,12,1,4,25,1,2,50,0,2,0,0,0,0,0,2,2,6,1,3,1,0,2
441651,499_14_58,MONTENEGRO,15355,22,milos borisov,16,2,5,40,1,2,50,1,3,33.3,0,0,0,0,4,4,1,2,0,0,0,5
441652,499_14_58,MONTENEGRO,0,TOTALS,MONTENEGRO,200,35,68,51.5,29,49,59.2,6,19,31.6,8,13,61.5,12,31,43,17,21,13,8,3,84
441653,499_14_59,MKD,6304,4,ivica dimchevski,5,1,2,50,1,1,100,0,1,0,0,0,0,1,0,1,0,1,0,0,0,2
441654,499_14_59,MKD,22445,5,andrej magdevski,17,2,4,50,0,1,0,2,3,66.7,0,0,0,0,2,2,3,2,0,1,0,6
441655,499_14_59,MKD,7810,6,darko sokolov,21,3,8,37.5,2,5,40,1,3,33.3,2,2,100,3,0,3,3,2,0,3,0,9
441656,499_14_59,MKD,2709,7,aleksandar kostoski,19,2,5,40,0,0,0,2,5,40,0,0,0,1,1,2,2,1,0,1,0,6
441657,499_14_59,MKD,5892,8,vojdan stojanovski,18,1,5,20,1,4,25,0,1,0,0,0,0,0,2,2,2,2,2,0,0,2
441658,499_14_59,MKD,5892,9,damjan stojanovski,21,3,8,37.5,1,2,50,2,6,33.3,2,2,100,1,1,2,4,4,0,2,0,10
441659,499_14_59,MKD,6300,10,marko simonovski,20,4,8,50,2,3,66.7,2,5,40,0,0,0,2,3,5,1,0,1,0,1,10
441660,499_14_59,MKD,6306,11,vladimir brckov,5,0,0,0,0,0,0,0,0,0,0,0,0,0,1,1,0,0,0,1,0,0
441661,499_14_59,MKD,2714,12,bojan trajkovski,25,5,12,41.7,5,7,71.4,0,5,0,0,0,0,2,2,4,4,4,1,0,0,10
441662,499_14_59,MKD,11275,13,stojan gjuroski,18,4,10,40,4,8,50,0,2,0,0,1,0,0,2,2,0,1,1,0,0,8
441663,499_14_59,MKD,2715,14,marjan janeski,2,1,1,100,1,1,100,0,0,0,0,0,0,1,1,2,0,0,0,0,0,2
441664,499_14_59,MKD,29507,15,venard richard hendriks,29,6,8,75,6,7,85.7,0,1,0,3,3,100,4,8,12,3,0,0,0,3,15
441665,499_14_59,MKD,0,TOTALS,MKD,200,32,71,45.1,23,39,59,9,32,28.1,7,8,87.5,15,27,42,22,17,6,8,4,80
441666,499_14_59,DENMARK,29522,4,darko jukic,19,3,7,42.9,3,5,60,0,2,0,3,4,75,0,5,5,0,1,0,2,0,9
441667,499_14_59,DENMARK,16165,5,frederik rungby,21,0,2,0,0,2,0,0,0,0,0,0,0,0,4,4,0,3,0,1,0,0
441668,499_14_59,DENMARK,24492,6,tobias reinholt,15,2,4,50,2,4,50,0,0,0,0,0,0,1,3,4,0,2,0,0,1,4
441669,499_14_59,DENMARK,16162,7,esben reinholt,28,3,10,30,2,7,28.6,1,3,33.3,1,3,33.3,0,4,4,1,0,1,0,1,8
441670,499_14_59,DENMARK,21908,8,gabriel lundberg,21,0,3,0,0,1,0,0,2,0,0,0,0,1,0,1,0,0,1,0,0,0
441671,499_14_59,DENMARK,12662,9,alexander heidenheim bak,25,1,5,20,1,4,25,0,1,0,0,0,0,0,1,1,1,3,3,1,0,2
441672,499_14_59,DENMARK,10649,10,mathias seilund,26,1,6,16.7,1,3,33.3,0,3,0,0,0,0,1,3,4,0,1,1,0,1,2
441673,499_14_59,DENMARK,15650,11,thomas sebastian laerke,20,2,8,25,1,5,20,1,3,33.3,0,0,0,1,0,1,0,4,1,0,0,5
441674,499_14_59,DENMARK,12663,15,jonas zohore bergstedt,25,6,11,54.5,6,10,60,0,1,0,4,4,100,2,3,5,0,1,5,0,0,16
441675,499_14_59,DENMARK,0,TOTALS,DENMARK,200,18,56,32.1,16,41,39,2,15,13.3,8,11,72.7,9,25,34,2,15,12,4,3,46
441676,499_14_60,ITALY,12988,5,alessandro gentile,33,2,12,16.7,2,7,28.6,0,5,0,19,21,90.5,1,2,3,2,3,5,1,1,23
441677,499_14_60,ITALY,1705,7,luca vitali,11,1,1,100,0,0,0,1,1,100,0,0,0,1,0,1,0,2,1,0,0,3
441678,499_14_60,ITALY,15319,12,marco cusin,27,4,6,66.7,4,6,66.7,0,0,0,4,4,100,1,4,5,1,2,1,0,4,12
441679,499_14_60,ITALY,1861,13,luigi datome,28,4,12,33.3,2,7,28.6,2,5,40,5,5,100,2,4,6,2,5,3,0,0,15
441680,499_14_60,ITALY,19847,14,riccardo cervi,13,0,0,0,0,0,0,0,0,0,0,0,0,1,1,2,0,1,0,1,5,0
441681,499_14_60,ITALY,24206,18,daniele magro,0,0,0,0,0,0,0,0,0,0,0,0,0,0,0,0,0,0,0,0,0,0
441682,499_14_60,ITALY,19752,20,andrea cinciarini,30,1,6,16.7,0,5,0,1,1,100,0,0,0,0,2,2,1,3,2,0,0,3
441683,499_14_60,ITALY,10579,22,stefano gentile,13,1,5,20,0,2,0,1,3,33.3,0,0,0,0,2,2,1,3,0,0,0,3
441684,499_14_60,ITALY,17241,27,davide pascolo,0,0,0,0,0,0,0,0,0,0,0,0,0,0,0,0,0,0,0,0,0,0
441685,499_14_60,ITALY,20021,32,amedeo della valle,0,0,0,0,0,0,0,0,0,0,0,0,0,0,0,0,0,0,0,0,0,0
441686,499_14_60,ITALY,7944,33,pietro aradori,36,4,12,33.3,4,9,44.4,0,3,0,1,1,100,0,6,6,2,2,1,0,0,9
441687,499_14_60,ITALY,15644,34,achille polonara,9,0,0,0,0,0,0,0,0,0,0,0,0,0,1,1,0,0,0,0,0,0
441688,499_14_60,ITALY,0,TOTALS,ITALY,200,17,54,31.5,12,36,33.3,5,18,27.8,29,31,93.5,8,22,30,9,21,13,2,10,68
441689,499_14_60,RUSSIA,1809,5,nikita kurbanov,30,2,6,33.3,2,5,40,0,1,0,2,6,33.3,1,6,7,2,0,1,2,0,6
441690,499_14_60,RUSSIA,29520,8,pavel korobkov,1,0,1,0,0,1,0,0,0,0,0,0,0,0,0,0,0,0,0,0,0,0
441691,499_14_60,RUSSIA,1083,9,egor vyaltsev,18,2,7,28.6,1,5,20,1,2,50,1,2,50,0,3,3,0,1,2,0,0,6
441692,499_14_60,RUSSIA,1079,10,dmitry sokolov,7,0,1,0,0,1,0,0,0,0,0,2,0,2,1,3,0,2,1,0,0,0
441693,499_14_60,RUSSIA,19857,12,andrey zubkov,26,3,5,60,2,4,50,1,1,100,2,4,50,0,2,2,2,1,0,1,0,9
441694,499_14_60,RUSSIA,2554,13,dmitry khvostov,9,1,4,25,1,2,50,0,2,0,0,0,0,0,2,2,2,1,1,0,2,2
441695,499_14_60,RUSSIA,1808,14,anton ponkrashov,31,8,15,53.3,6,11,54.5,2,4,50,4,6,66.7,0,3,3,8,4,4,1,1,22
441696,499_14_60,RUSSIA,15377,15,timofey mozgov,32,9,13,69.2,9,13,69.2,0,0,0,2,3,66.7,4,3,7,0,3,2,1,0,20
441697,499_14_60,RUSSIA,15956,22,sergey karasev,6,0,0,0,0,0,0,0,0,0,0,0,0,0,1,1,1,4,2,0,0,0
441698,499_14_60,RUSSIA,10610,23,semen antonov,14,2,2,100,1,1,100,1,1,100,0,0,0,0,0,0,1,5,1,0,0,5
441699,499_14_60,RUSSIA,1810,24,evgeny voronov,27,1,4,25,1,4,25,0,0,0,0,0,0,2,5,7,0,5,1,0,0,2
441700,499_14_60,RUSSIA,0,TOTALS,RUSSIA,200,28,58,48.3,23,47,48.9,5,11,45.5,11,23,47.8,12,28,40,16,26,16,5,3,72
441701,499_14_61,HUNGARY,4537,5,gabor denes,17,3,4,75,2,2,100,1,2,50,1,2,50,1,6,7,1,3,1,0,0,8
441702,499_14_61,HUNGARY,12503,6,akos keller,27,5,7,71.4,5,7,71.4,0,0,0,3,7,42.9,3,8,11,0,1,0,0,1,13
441703,499_14_61,HUNGARY,1125,7,krisztian wittmann,25,1,7,14.3,0,3,0,1,4,25,0,0,0,0,1,1,7,4,0,1,0,3
441704,499_14_61,HUNGARY,8415,9,david vojvoda,34,6,20,30,5,13,38.5,1,7,14.3,7,7,100,1,5,6,4,4,2,2,0,20
441705,499_14_61,HUNGARY,2743,10,zoltan supola,0,0,0,0,0,0,0,0,0,0,0,0,0,0,0,0,0,0,0,0,0,0
441706,499_14_61,HUNGARY,1942,11,norbert toth,23,3,6,50,0,3,0,3,3,100,2,2,100,2,2,4,1,1,2,1,1,11
441707,499_14_61,HUNGARY,2750,12,milan csorvasi,1,0,1,0,0,1,0,0,0,0,0,0,0,0,1,1,0,1,0,0,0,0
441708,499_14_61,HUNGARY,2751,13,adam toth,12,1,1,100,1,1,100,0,0,0,0,0,0,0,1,1,0,5,2,0,0,2
441709,499_14_61,HUNGARY,29528,14,jermaine dontay thomas,26,5,7,71.4,3,3,100,2,4,50,2,4,50,0,3,3,5,4,2,1,0,14
441710,499_14_61,HUNGARY,1123,15,csaba ferencz,25,1,4,25,0,2,0,1,2,50,0,0,0,0,2,2,0,2,0,1,0,3
441711,499_14_61,HUNGARY,8051,21,andras rujak,10,4,7,57.1,3,5,60,1,2,50,0,0,0,1,2,3,1,3,1,1,0,9
441712,499_14_61,HUNGARY,11148,22,janos eilingsfeld,1,0,0,0,0,0,0,0,0,0,0,0,0,0,0,0,0,0,0,0,0,0
441713,499_14_61,HUNGARY,0,TOTALS,HUNGARY,200,29,64,45.3,19,40,47.5,10,24,41.7,15,22,68.2,11,31,42,19,28,11,7,2,83
441714,499_14_61,CZECH REPUBLIC,29502,4,patrik auda,10,0,0,0,0,0,0,0,0,0,0,0,0,0,0,0,0,1,3,0,0,0
441715,499_14_61,CZECH REPUBLIC,12522,5,tomas pomikalek,1,0,0,0,0,0,0,0,0,0,0,0,0,0,0,0,0,0,0,0,0,0
441716,499_14_61,CZECH REPUBLIC,5478,6,pavel pumprla,35,2,4,50,2,3,66.7,0,1,0,5,6,83.3,1,5,6,1,3,0,1,2,9
441717,499_14_61,CZECH REPUBLIC,10700,7,vojtech hruban,5,0,1,0,0,0,0,0,1,0,0,0,0,1,0,1,0,1,1,0,1,0
441718,499_14_61,CZECH REPUBLIC,8325,8,tomas satoransky,36,2,7,28.6,1,2,50,1,5,20,13,17,76.5,1,5,6,5,3,2,2,0,18
441719,499_14_61,CZECH REPUBLIC,4774,9,jiri welsch,29,3,7,42.9,3,5,60,0,2,0,1,4,25,1,3,4,6,3,2,4,0,7
441720,499_14_61,CZECH REPUBLIC,10702,10,lukas palyza,11,2,8,25,1,3,33.3,1,5,20,2,2,100,0,1,1,1,0,0,0,0,7
441721,499_14_61,CZECH REPUBLIC,4775,11,lubos barton,17,1,8,12.5,1,2,50,0,6,0,0,0,0,2,1,3,1,4,0,0,0,2
441722,499_14_61,CZECH REPUBLIC,12850,12,ondrej balvin,24,3,6,50,3,6,50,0,0,0,1,1,100,3,5,8,0,2,3,0,1,7
441723,499_14_61,CZECH REPUBLIC,10484,13,jakub sirina,4,0,1,0,0,0,0,0,1,0,0,0,0,0,0,0,0,1,0,0,0,0
441724,499_14_61,CZECH REPUBLIC,7823,14,kamil svrdlik,0,0,0,0,0,0,0,0,0,0,0,0,0,0,0,0,0,0,0,0,0,0
441725,499_14_61,CZECH REPUBLIC,1096,22,pavel houska,29,8,12,66.7,8,10,80,0,2,0,2,2,100,0,3,3,1,3,2,0,1,18
441726,499_14_61,CZECH REPUBLIC,0,TOTALS,CZECH REPUBLIC,200,21,54,38.9,19,31,61.3,2,23,8.7,24,32,75,9,27,36,15,21,13,7,5,68
441727,499_14_62,ISRAEL,1680,4,nitzan yehuda hanochi,1,0,0,0,0,0,0,0,0,0,0,0,0,0,0,0,0,0,0,0,0,0
441728,499_14_62,ISRAEL,4794,5,afik nissim,0,0,0,0,0,0,0,0,0,0,0,0,0,0,0,0,0,0,0,0,0,0
441729,499_14_62,ISRAEL,1022,6,raviv guy limonad,22,1,4,25,1,3,33.3,0,1,0,1,2,50,0,1,1,1,0,3,1,0,3
441730,499_14_62,ISRAEL,2522,7,gal mekel,26,3,6,50,3,5,60,0,1,0,1,3,33.3,0,5,5,4,1,4,1,0,7
441731,499_14_62,ISRAEL,1023,8,lior eliyahu,27,8,11,72.7,8,11,72.7,0,0,0,0,0,0,2,5,7,1,3,3,0,0,16
441732,499_14_62,ISRAEL,10164,10,guy pnini,37,3,9,33.3,3,4,75,0,5,0,0,0,0,0,4,4,6,3,1,2,0,6
441733,499_14_62,ISRAEL,1019,12,yotam halperin,32,2,5,40,0,0,0,2,5,40,0,0,0,0,5,5,2,1,2,1,0,6
441734,499_14_62,ISRAEL,5780,13,elishay kadir,8,2,6,33.3,2,6,33.3,0,0,0,1,2,50,0,1,1,0,1,1,0,0,5
441735,499_14_62,ISRAEL,4620,14,yaniv green,16,2,4,50,2,4,50,0,0,0,0,2,0,1,2,3,0,0,2,0,1,4
441736,499_14_62,ISRAEL,17258,15,jacob greer cohen,13,4,6,66.7,3,5,60,1,1,100,2,2,100,3,2,5,1,4,0,0,1,11
441737,499_14_62,ISRAEL,15384,20,yuval naimy,0,0,0,0,0,0,0,0,0,0,0,0,0,0,0,0,0,0,0,0,0,0
441738,499_14_62,ISRAEL,24229,21,dagan yivzori,18,1,3,33.3,0,1,0,1,2,50,0,0,0,1,2,3,4,4,1,4,0,3
441739,499_14_62,ISRAEL,0,TOTALS,ISRAEL,200,26,54,48.1,22,39,56.4,4,15,26.7,5,11,45.5,7,27,34,19,18,18,9,2,61
441740,499_14_62,BULGARIA,12491,6,simeon iliev,0,0,0,0,0,0,0,0,0,0,0,0,0,0,0,0,0,0,0,0,0,0
441741,499_14_62,BULGARIA,8350,7,hristo zahariev,22,5,7,71.4,4,5,80,1,2,50,1,1,100,0,3,3,2,0,1,2,0,12
441742,499_14_62,BULGARIA,8347,10,bozhidar avramov,39,4,13,30.8,1,10,10,3,3,100,3,6,50,1,1,2,4,2,4,1,0,14
441743,499_14_62,BULGARIA,1675,13,asen velikov,11,1,2,50,1,2,50,0,0,0,0,0,0,1,0,1,2,3,2,1,0,2
441744,499_14_62,BULGARIA,10589,15,stanislav vaklinov,2,0,0,0,0,0,0,0,0,0,0,0,0,0,0,0,0,0,0,0,0,0
441745,499_14_62,BULGARIA,5588,21,nikolay varbanov,27,4,8,50,4,8,50,0,0,0,1,1,100,2,2,4,0,3,4,0,2,9
441746,499_14_62,BULGARIA,2851,22,pavel ivanov,19,0,5,0,0,3,0,0,2,0,0,0,0,0,3,3,0,0,2,0,0,0
441747,499_14_62,BULGARIA,15604,23,stanimir marinov,29,3,8,37.5,2,4,50,1,4,25,0,0,0,0,1,1,1,2,0,2,1,7
441748,499_14_62,BULGARIA,7959,24,kostadin marshavelski,1,0,0,0,0,0,0,0,0,0,0,0,0,0,0,0,0,0,0,0,0,0
441749,499_14_62,BULGARIA,17555,41,aleksandar vezenkov,31,8,13,61.5,6,9,66.7,2,4,50,2,5,40,2,6,8,0,3,1,0,0,20
441750,499_14_62,BULGARIA,13088,50,dimitar dimitrov,19,2,4,50,2,4,50,0,0,0,1,2,50,1,3,4,1,1,2,1,0,5
441751,499_14_62,BULGARIA,0,TOTALS,BULGARIA,200,27,60,45,20,45,44.4,7,15,46.7,8,15,53.3,9,23,32,10,14,16,7,3,69
441752,499_14_63,ROMANIA,2115,4,andrei mandache,28,1,5,20,0,3,0,1,2,50,1,2,50,1,2,3,0,1,2,0,1,4
441753,499_14_63,ROMANIA,10239,5,mihail-octavian paul,21,3,8,37.5,2,4,50,1,4,25,1,2,50,1,0,1,5,4,0,2,0,8
441754,499_14_63,ROMANIA,5015,6,levente szijarto,15,0,0,0,0,0,0,0,0,0,0,0,0,1,0,1,0,0,1,1,0,0
441755,499_14_63,ROMANIA,2900,9,vlad moldoveanu,28,5,11,45.5,5,9,55.6,0,2,0,8,9,88.9,2,3,5,2,5,1,0,0,18
441756,499_14_63,ROMANIA,2915,10,catalin baciu,11,2,2,100,2,2,100,0,0,0,3,3,100,0,0,0,0,1,0,0,0,7
441757,499_14_63,ROMANIA,15354,11,octavian calota-popa,0,0,0,0,0,0,0,0,0,0,0,0,0,0,0,0,0,0,0,0,0,0
441758,499_14_63,ROMANIA,11102,12,bogdan tibirna,0,0,0,0,0,0,0,0,0,0,0,0,0,0,0,0,0,0,0,0,0,0
441759,499_14_63,ROMANIA,15358,13,teodor gabriel jucan,14,0,1,0,0,1,0,0,0,0,0,0,0,2,1,3,0,1,0,1,0,0
441760,499_14_63,ROMANIA,2125,14,titus nicoara,20,2,5,40,2,4,50,0,1,0,1,4,25,3,3,6,2,2,0,1,0,5
441761,499_14_63,ROMANIA,4965,15,mihai vlad silvasan,21,7,15,46.7,4,7,57.1,3,8,37.5,1,3,33.3,1,1,2,0,3,1,0,0,18
441762,499_14_63,ROMANIA,5016,21,adrian tudor,23,0,2,0,0,1,0,0,1,0,2,2,100,0,1,1,2,4,5,1,0,2
441763,499_14_63,ROMANIA,12712,44,adrian gutoaia,19,1,5,20,1,3,33.3,0,2,0,6,6,100,0,3,3,1,3,1,1,0,8
441764,499_14_63,ROMANIA,0,TOTALS,ROMANIA,200,21,54,38.9,16,34,47.1,5,20,25,23,31,74.2,11,18,29,12,24,13,7,1,70
441765,499_14_63,LATVIA,19994,4,ingus jakovics,2,0,0,0,0,0,0,0,0,0,0,0,0,0,0,0,0,0,1,0,0,0
441766,499_14_63,LATVIA,19755,5,mareks mejeris,17,2,2,100,2,2,100,0,0,0,1,2,50,0,1,1,0,1,2,0,0,5
441767,499_14_63,LATVIA,2539,6,rolands freimanis,25,3,5,60,3,5,60,0,0,0,1,1,100,1,9,10,2,4,3,0,0,7
441768,499_14_63,LATVIA,5029,7,janis blums,23,5,10,50,0,2,0,5,8,62.5,0,0,0,0,4,4,0,2,0,1,0,15
441769,499_14_63,LATVIA,6271,9,dairis bertans,25,5,8,62.5,4,5,80,1,3,33.3,2,2,100,0,2,2,3,1,1,0,0,13
441770,499_14_63,LATVIA,20350,11,rolands smits,8,1,3,33.3,1,1,100,0,2,0,1,1,100,0,2,2,1,2,1,0,0,3
441771,499_14_63,LATVIA,4604,12,kristaps janicenoks,31,4,9,44.4,1,2,50,3,7,42.9,0,0,0,0,0,0,5,2,1,1,0,11
441772,499_14_63,LATVIA,10585,13,janis strelnieks,28,4,7,57.1,3,6,50,1,1,100,4,4,100,1,3,4,3,2,3,2,0,13
441773,499_14_63,LATVIA,1002,14,kaspars berzins,23,3,6,50,3,3,100,0,3,0,3,5,60,2,3,5,1,5,0,2,2,9
441774,499_14_63,LATVIA,29525,21,aigars skele,6,0,0,0,0,0,0,0,0,0,2,2,100,1,0,1,0,1,3,0,0,2
441775,499_14_63,LATVIA,5721,30,ronalds zakis,9,1,2,50,1,2,50,0,0,0,0,0,0,0,2,2,1,2,0,1,0,2
441776,499_14_63,LATVIA,15602,33,martins meiers,3,0,0,0,0,0,0,0,0,0,2,2,100,0,1,1,0,2,0,1,0,2
441777,499_14_63,LATVIA,0,TOTALS,LATVIA,200,28,52,53.8,18,28,64.3,10,24,41.7,16,19,84.2,5,27,32,16,24,17,8,2,82
441778,499_14_64,GEORGIA,8378,4,nika metreveli,8,2,2,100,2,2,100,0,0,0,0,0,0,1,2,3,0,2,0,0,0,4
441779,499_14_64,GEORGIA,16023,5,otar pkhakadze,7,0,1,0,0,0,0,0,1,0,0,0,0,0,0,0,1,1,0,1,0,0
441780,499_14_64,GEORGIA,4919,7,zaza pachulia,32,6,14,42.9,6,14,42.9,0,0,0,3,4,75,4,6,10,9,5,3,3,1,15
441781,499_14_64,GEORGIA,1690,8,george tsintsadze,35,1,9,11.1,1,3,33.3,0,6,0,0,0,0,0,3,3,6,2,3,1,0,2
441782,499_14_64,GEORGIA,15684,10,duda sanadze,29,5,8,62.5,2,2,100,3,6,50,1,2,50,1,4,5,1,4,0,0,0,14
441783,499_14_64,GEORGIA,12467,12,levan patsatsia,21,2,4,50,2,3,66.7,0,1,0,0,0,0,4,1,5,3,3,1,0,0,4
441784,499_14_64,GEORGIA,1699,13,viktor sanikidze,34,8,15,53.3,6,9,66.7,2,6,33.3,2,2,100,3,5,8,2,2,2,2,1,20
441785,499_14_64,GEORGIA,16022,15,beka burjanadze,20,3,5,60,3,4,75,0,1,0,2,2,100,0,2,2,0,1,1,0,1,8
441786,499_14_64,GEORGIA,8382,22,george sharabidze,0,0,0,0,0,0,0,0,0,0,0,0,0,0,0,0,0,0,0,0,0,0
441787,499_14_64,GEORGIA,7836,24,mikhail berishvili,0,0,0,0,0,0,0,0,0,0,0,0,0,0,0,0,0,0,0,0,0,0
441788,499_14_64,GEORGIA,1693,25,besik lezhava,15,0,4,0,0,2,0,0,2,0,4,6,66.7,3,0,3,0,2,0,1,0,4
441789,499_14_64,GEORGIA,2604,31,beka tsivtsivadze,0,0,0,0,0,0,0,0,0,0,0,0,0,0,0,0,0,0,0,0,0,0
441790,499_14_64,GEORGIA,0,TOTALS,GEORGIA,200,27,62,43.5,22,39,56.4,5,23,21.7,12,16,75,16,27,43,22,22,10,8,3,71
441791,499_14_64,PORTUGAL,2730,4,jose silva,32,5,14,35.7,3,9,33.3,2,5,40,0,0,0,1,0,1,0,2,1,0,1,12
441792,499_14_64,PORTUGAL,8199,5,joao soares,22,4,6,66.7,2,2,100,2,4,50,0,0,0,0,3,3,1,2,2,0,0,10
441793,499_14_64,PORTUGAL,8195,6,jose barbosa,0,0,0,0,0,0,0,0,0,0,0,0,0,0,0,0,0,0,0,0,0,0
441794,499_14_64,PORTUGAL,15697,7,carlos diogo serra ferreirinho,0,0,0,0,0,0,0,0,0,0,0,0,0,0,0,0,0,0,0,0,0,0
441795,499_14_64,PORTUGAL,10266,8,mario fernandes,33,2,8,25,0,4,0,2,4,50,3,4,75,0,3,3,10,3,3,2,0,9
441796,499_14_64,PORTUGAL,2736,10,fabio lima,24,1,4,25,1,3,33.3,0,1,0,0,0,0,1,2,3,2,0,0,1,0,2
441797,499_14_64,PORTUGAL,10956,11,miguel queiroz,23,2,4,50,1,2,50,1,2,50,0,0,0,3,3,6,2,3,1,0,0,5
441798,499_14_64,PORTUGAL,8200,12,joao guerreiro,8,0,3,0,0,2,0,0,1,0,0,0,0,0,2,2,0,0,0,0,0,0
441799,499_14_64,PORTUGAL,7851,13,joao balseiro,11,1,2,50,0,1,0,1,1,100,1,5,20,0,1,1,0,1,1,0,0,4
441800,499_14_64,PORTUGAL,2732,14,pedro pinto,7,0,2,0,0,0,0,0,2,0,0,0,0,0,0,0,3,2,2,0,0,0
441801,499_14_64,PORTUGAL,2918,21,claudio fonseca,30,8,13,61.5,8,13,61.5,0,0,0,1,4,25,2,2,4,0,5,1,3,1,17
441802,499_14_64,PORTUGAL,29527,22,arnette hallman,10,0,2,0,0,1,0,0,1,0,0,2,0,0,1,1,1,0,1,0,0,0
441803,499_14_64,PORTUGAL,0,TOTALS,PORTUGAL,200,23,58,39.7,15,37,40.5,8,21,38.1,5,15,33.3,10,19,29,19,18,12,6,2,59
441804,499_14_65,SWEDEN,20455,4,ludvig hakanson,28,2,9,22.2,2,6,33.3,0,3,0,4,4,100,0,3,3,1,2,0,2,1,8
441805,499_14_65,SWEDEN,16053,5,tobias borg,0,0,0,0,0,0,0,0,0,0,0,0,0,0,0,0,0,0,0,0,0,0
441806,499_14_65,SWEDEN,4748,6,joakim kjellbom,33,5,13,38.5,5,13,38.5,0,0,0,3,3,100,3,6,9,2,2,0,1,1,13
441807,499_14_65,SWEDEN,10481,7,dino pita,9,1,3,33.3,1,2,50,0,1,0,2,2,100,1,1,2,0,3,1,0,0,4
441808,499_14_65,SWEDEN,10740,8,john gaddefors,29,6,12,50,2,4,50,4,8,50,2,2,100,2,4,6,3,4,1,1,1,18
441809,499_14_65,SWEDEN,1176,9,thomas massamba,30,5,8,62.5,2,4,50,3,4,75,8,8,100,0,2,2,5,4,3,0,0,21
441810,499_14_65,SWEDEN,1972,10,martin pahlmblad,17,1,4,25,0,2,0,1,2,50,2,2,100,1,0,1,0,0,1,1,0,5
441811,499_14_65,SWEDEN,5844,11,tom liden,7,1,2,50,1,1,100,0,1,0,0,0,0,1,0,1,0,2,0,0,0,2
441812,499_14_65,SWEDEN,2702,12,brice massamba,7,1,1,100,1,1,100,0,0,0,0,0,0,1,0,1,0,0,0,0,1,2
441813,499_14_65,SWEDEN,11099,14,alexander lindqvist,15,2,3,66.7,2,3,66.7,0,0,0,2,2,100,2,4,6,0,2,0,2,0,6
441814,499_14_65,SWEDEN,13061,15,jonathan person,24,1,6,16.7,1,4,25,0,2,0,2,2,100,0,0,0,1,2,0,0,0,4
441815,499_14_65,SWEDEN,15688,40,carl engstrom,1,0,0,0,0,0,0,0,0,0,0,0,0,0,0,0,0,0,0,0,0,0
441816,499_14_65,SWEDEN,0,TOTALS,SWEDEN,200,25,61,41,17,40,42.5,8,21,38.1,25,25,100,12,20,32,12,21,6,7,4,83
441817,499_14_65,SLOVAK REPUBLIC,15367,4,marek kozlik,13,0,1,0,0,1,0,0,0,0,1,2,50,1,2,3,1,0,1,0,0,1
441818,499_14_65,SLOVAK REPUBLIC,6339,5,peter dorazil,21,5,6,83.3,5,6,83.3,0,0,0,1,2,50,3,4,7,2,2,0,0,1,11
441819,499_14_65,SLOVAK REPUBLIC,1154,6,peter sedmak,30,7,15,46.7,7,9,77.8,0,6,0,6,6,100,1,2,3,3,2,1,2,1,20
441820,499_14_65,SLOVAK REPUBLIC,11264,7,tomas mrvis,19,3,6,50,3,5,60,0,1,0,1,2,50,0,3,3,0,1,1,0,0,7
441821,499_14_65,SLOVAK REPUBLIC,10469,8,milan ziak,27,5,8,62.5,3,6,50,2,2,100,1,2,50,1,5,6,1,5,3,0,0,13
441822,499_14_65,SLOVAK REPUBLIC,5862,9,martin bilik,21,2,6,33.3,1,3,33.3,1,3,33.3,0,0,0,0,0,0,0,4,2,0,0,5
441823,499_14_65,SLOVAK REPUBLIC,29524,10,nenad milosevic,28,3,8,37.5,3,4,75,0,4,0,4,5,80,0,3,3,7,4,0,1,0,10
441824,499_14_65,SLOVAK REPUBLIC,6335,11,stanislav baldovsky,0,0,0,0,0,0,0,0,0,0,0,0,0,0,0,0,0,0,0,0,0,0
441825,499_14_65,SLOVAK REPUBLIC,13095,12,maurizio galata,0,0,0,0,0,0,0,0,0,0,0,0,0,0,0,0,0,0,0,0,0,0
441826,499_14_65,SLOVAK REPUBLIC,12668,13,andrej kuffa,29,3,4,75,2,2,100,1,2,50,0,0,0,1,1,2,1,1,0,0,1,7
441827,499_14_65,SLOVAK REPUBLIC,8444,15,marek jass,12,1,2,50,0,0,0,1,2,50,0,0,0,1,2,3,1,3,2,0,0,3
441828,499_14_65,SLOVAK REPUBLIC,0,TOTALS,SLOVAK REPUBLIC,200,29,56,51.8,24,36,66.7,5,20,25,14,19,73.7,8,24,32,16,22,11,3,3,77
441829,499_14_66,ICELAND,24208,4,axel karason,9,1,3,33.3,0,2,0,1,1,100,0,2,0,2,1,3,2,4,0,0,0,3
441830,499_14_66,ICELAND,13211,5,haukur palsson,36,4,8,50,3,6,50,1,2,50,0,0,0,2,7,9,1,3,1,2,1,9
441831,499_14_66,ICELAND,2760,7,sigurdur gunnar thorsteinsson,0,0,0,0,0,0,0,0,0,0,0,0,0,0,0,0,0,0,0,0,0,0
441832,499_14_66,ICELAND,4841,8,hlynur baeringsson,7,0,0,0,0,0,0,0,0,0,0,0,0,1,0,1,0,3,0,0,0,0
441833,499_14_66,ICELAND,19926,9,martin hermannsson,14,0,2,0,0,1,0,0,1,0,5,6,83.3,1,2,3,1,1,1,1,0,5
441834,499_14_66,ICELAND,4837,9,jon arnor stefansson,31,8,21,38.1,6,16,37.5,2,5,40,3,3,100,1,1,2,2,3,5,0,0,21
441835,499_14_66,ICELAND,4840,10,helgi mar magnusson,5,0,2,0,0,1,0,0,1,0,0,0,0,0,0,0,0,0,0,0,0,0
441836,499_14_66,ICELAND,4839,11,sigurdur thorvaldsson,0,0,0,0,0,0,0,0,0,0,0,0,0,0,0,0,0,0,0,0,0,0
441837,499_14_66,ICELAND,15700,12,ragnar agust nathanaelsson,7,1,1,100,1,1,100,0,0,0,0,0,0,0,2,2,0,1,1,0,1,2
441838,499_14_66,ICELAND,2764,13,hordur vilhjalmsson,33,4,11,36.4,2,5,40,2,6,33.3,2,2,100,0,4,4,3,3,0,0,0,12
441839,499_14_66,ICELAND,4980,14,logi gunnarsson,23,2,8,25,1,5,20,1,3,33.3,4,6,66.7,0,2,2,0,2,1,0,1,9
441840,499_14_66,ICELAND,2071,15,pavel ermolinskij,35,3,9,33.3,0,4,0,3,5,60,0,0,0,0,6,6,3,5,3,1,0,9
441841,499_14_66,ICELAND,0,TOTALS,ICELAND,200,23,65,35.4,13,41,31.7,10,24,41.7,14,19,73.7,8,27,35,12,25,12,4,3,70
441842,499_14_66,BOSNIA AND HERZEGOVINA,5859,4,muhamed pasalic,18,2,2,100,0,0,0,2,2,100,0,0,0,0,2,2,4,0,1,0,0,6
441843,499_14_66,BOSNIA AND HERZEGOVINA,20566,5,nedim buza,6,0,1,0,0,0,0,0,1,0,0,0,0,0,1,1,0,1,0,0,1,0
441844,499_14_66,BOSNIA AND HERZEGOVINA,7780,6,andrija stipanovic,31,4,8,50,4,8,50,0,0,0,5,12,41.7,2,6,8,1,3,4,0,1,13
441845,499_14_66,BOSNIA AND HERZEGOVINA,24189,7,marko sutalo,31,5,12,41.7,2,2,100,3,10,30,2,2,100,0,1,1,3,4,1,0,1,15
441846,499_14_66,BOSNIA AND HERZEGOVINA,17435,8,stefan glogovac,0,0,0,0,0,0,0,0,0,0,0,0,0,0,0,0,0,0,0,0,0,0
441847,499_14_66,BOSNIA AND HERZEGOVINA,2887,10,nemanja gordic,28,4,9,44.4,3,6,50,1,3,33.3,6,9,66.7,0,3,3,5,5,3,1,0,15
441848,499_14_66,BOSNIA AND HERZEGOVINA,2891,11,elmedin kikanovic,34,10,16,62.5,10,16,62.5,0,0,0,4,8,50,4,12,16,1,2,3,2,4,24
441849,499_14_66,BOSNIA AND HERZEGOVINA,11206,13,miralem halilovic,14,0,2,0,0,2,0,0,0,0,0,0,0,2,3,5,2,1,0,0,2,0
441850,499_14_66,BOSNIA AND HERZEGOVINA,24216,14,nemanja mitrovic,4,0,0,0,0,0,0,0,0,0,0,0,0,0,1,1,0,0,1,0,0,0
441851,499_14_66,BOSNIA AND HERZEGOVINA,15282,15,milan milosevic,21,1,3,33.3,0,1,0,1,2,50,0,0,0,0,3,3,3,3,0,1,1,3
441852,499_14_66,BOSNIA AND HERZEGOVINA,17436,22,adin vrabac,13,1,2,50,1,2,50,0,0,0,0,0,0,0,2,2,2,2,2,0,0,2
441853,499_14_66,BOSNIA AND HERZEGOVINA,29498,23,drasko albijanic,0,0,0,0,0,0,0,0,0,0,0,0,0,0,0,0,0,0,0,0,0,0
441854,499_14_66,BOSNIA AND HERZEGOVINA,0,TOTALS,BOSNIA AND HERZEGOVINA,200,27,55,49.1,20,37,54.1,7,18,38.9,17,31,54.8,9,35,44,21,21,15,4,10,78
441855,499_14_67,LUXEMBOURG,5011,4,tom schumacher,23,3,7,42.9,1,3,33.3,2,4,50,2,3,66.7,1,2,3,0,2,6,0,0,10
441856,499_14_67,LUXEMBOURG,5918,5,pitt koster,7,1,2,50,1,1,100,0,1,0,0,2,0,0,1,1,1,0,0,0,0,2
441857,499_14_67,LUXEMBOURG,2966,6,raul leandro birenbaum,21,0,4,0,0,1,0,0,3,0,0,0,0,0,3,3,1,1,0,0,0,0
441858,499_14_67,LUXEMBOURG,8344,8,christopher c. g. jones,27,4,9,44.4,3,4,75,1,5,20,2,3,66.7,3,5,8,5,3,3,4,0,11
441859,499_14_67,LUXEMBOURG,19727,10,patrick arbaut,17,7,8,87.5,5,6,83.3,2,2,100,0,0,0,0,1,1,0,2,1,0,0,16
441860,499_14_67,LUXEMBOURG,13285,11,bob melcher,14,0,3,0,0,1,0,0,2,0,0,0,0,1,2,3,1,1,0,0,0,0
441861,499_14_67,LUXEMBOURG,19728,12,alexandre rodenbourg,16,3,4,75,3,4,75,0,0,0,1,2,50,0,1,1,1,5,1,1,0,7
441862,499_14_67,LUXEMBOURG,8340,22,jean nicolas c. kox,16,0,3,0,0,1,0,0,2,0,0,0,0,0,0,0,0,4,1,0,0,0
441863,499_14_67,LUXEMBOURG,1283,23,jairo emanuel delgado ferreira,26,2,6,33.3,0,3,0,2,3,66.7,0,0,0,0,3,3,0,4,2,0,0,6
441864,499_14_67,LUXEMBOURG,17901,24,thomas grun,8,0,1,0,0,1,0,0,0,0,2,2,100,0,0,0,1,0,0,0,0,2
441865,499_14_67,LUXEMBOURG,29517,30,dominique benseghir,2,0,0,0,0,0,0,0,0,0,0,0,0,0,0,0,0,0,0,0,0,0
441866,499_14_67,LUXEMBOURG,13176,31,alex laurent,25,3,10,30,2,6,33.3,1,4,25,5,5,100,1,2,3,0,3,3,0,1,12
441867,499_14_67,LUXEMBOURG,0,TOTALS,LUXEMBOURG,200,23,57,40.4,15,31,48.4,8,26,30.8,12,17,70.6,6,20,26,10,25,18,5,1,66
441868,499_14_67,GERMANY,8244,7,akeem vargas,14,1,3,33.3,0,0,0,1,3,33.3,0,0,0,0,1,1,0,1,0,0,0,3
441869,499_14_67,GERMANY,15385,8,heiko schaffartzik,22,2,9,22.2,0,1,0,2,8,25,1,2,50,1,1,2,1,2,2,2,0,7
441870,499_14_67,GERMANY,10446,9,karsten tadda,16,5,7,71.4,4,4,100,1,3,33.3,2,2,100,0,1,1,3,2,0,1,0,13
441871,499_14_67,GERMANY,5747,10,lucca staiger,23,3,8,37.5,0,2,0,3,6,50,0,0,0,1,0,1,1,2,0,0,0,9
441872,499_14_67,GERMANY,6326,12,robin benzing,15,4,8,50,0,1,0,4,7,57.1,2,4,50,0,3,3,0,2,1,0,0,14
441873,499_14_67,GERMANY,15492,13,bastian doreth,14,3,4,75,0,0,0,3,4,75,0,0,0,1,2,3,4,1,0,0,0,9
441874,499_14_67,GERMANY,15493,14,andreas seiferth,15,6,8,75,6,8,75,0,0,0,2,7,28.6,7,3,10,2,1,2,0,0,14
441875,499_14_67,GERMANY,19866,21,daniel theis,18,5,6,83.3,4,5,80,1,1,100,6,8,75,4,2,6,0,3,0,1,1,17
441876,499_14_67,GERMANY,19990,22,dennis schroder,22,4,7,57.1,4,5,80,0,2,0,2,2,100,0,1,1,7,0,4,1,0,10
441877,499_14_67,GERMANY,29529,24,maximilian kleber,21,4,9,44.4,4,6,66.7,0,3,0,4,6,66.7,3,6,9,1,1,0,3,2,12
441878,499_14_67,GERMANY,19867,25,johannes voigtmann,11,4,5,80,4,5,80,0,0,0,0,0,0,2,3,5,2,2,0,0,0,8
441879,499_14_67,GERMANY,12608,33,maik hendrik zirbes,10,1,1,100,1,1,100,0,0,0,0,0,0,1,3,4,1,0,2,0,0,2
441880,499_14_67,GERMANY,0,TOTALS,GERMANY,200,42,75,56,27,38,71.1,15,37,40.5,19,31,61.3,20,27,47,22,17,11,8,3,118
441881,499_14_68,DENMARK,29522,4,darko jukic,0,0,0,0,0,0,0,0,0,0,0,0,0,0,0,0,0,0,0,0,0,0
441882,499_14_68,DENMARK,16165,5,frederik rungby,12,0,0,0,0,0,0,0,0,0,0,0,0,0,3,3,2,2,0,0,0,0
441883,499_14_68,DENMARK,24492,6,tobias reinholt,16,0,2,0,0,2,0,0,0,0,0,0,0,2,0,2,0,1,2,0,0,0
441884,499_14_68,DENMARK,16162,7,esben reinholt,31,8,13,61.5,3,5,60,5,8,62.5,0,2,0,0,1,1,2,1,2,1,0,21
441885,499_14_68,DENMARK,21908,8,gabriel lundberg,23,2,4,50,1,2,50,1,2,50,1,2,50,0,3,3,2,1,3,0,0,6
441886,499_14_68,DENMARK,12662,9,alexander heidenheim bak,24,0,8,0,0,4,0,0,4,0,0,0,0,0,1,1,3,3,1,0,0,0
441887,499_14_68,DENMARK,10649,10,mathias seilund,30,2,7,28.6,1,4,25,1,3,33.3,1,2,50,0,4,4,1,2,0,0,0,6
441888,499_14_68,DENMARK,15650,11,thomas sebastian laerke,35,5,10,50,2,4,50,3,6,50,1,2,50,0,5,5,4,2,3,2,0,14
441889,499_14_68,DENMARK,12663,15,jonas zohore bergstedt,29,7,15,46.7,7,15,46.7,0,0,0,2,2,100,4,3,7,0,2,1,0,0,16
441890,499_14_68,DENMARK,0,TOTALS,DENMARK,200,24,59,40.7,14,36,38.9,10,23,43.5,5,10,50,6,21,27,14,14,13,3,0,63
441891,499_14_68,BELGIUM,10156,4,lionel georges m bosco,23,2,6,33.3,1,2,50,1,4,25,0,0,0,0,0,0,6,3,2,0,0,5
441892,499_14_68,BELGIUM,12601,5,alexandre libert,10,1,3,33.3,0,0,0,1,3,33.3,0,0,0,0,0,0,1,1,0,0,0,3
441893,499_14_68,BELGIUM,19894,6,kevin tumba,2,0,1,0,0,1,0,0,0,0,0,0,0,1,1,2,0,2,0,0,0,0
441894,499_14_68,BELGIUM,4548,7,axel hervelle,36,11,18,61.1,10,12,83.3,1,6,16.7,1,1,100,1,11,12,4,1,3,5,0,24
441895,499_14_68,BELGIUM,6157,8,jean-marc mwema,11,1,2,50,0,0,0,1,2,50,0,0,0,3,3,6,1,0,0,0,0,3
441896,499_14_68,BELGIUM,10706,9,olivier troisfontaines,16,2,4,50,1,1,100,1,3,33.3,0,0,0,0,1,1,1,0,1,0,0,5
441897,499_14_68,BELGIUM,13030,10,loic robin b. schwartz,15,3,4,75,2,2,100,1,2,50,0,0,0,0,1,1,1,1,0,2,0,7
441898,499_14_68,BELGIUM,19709,11,guy muya,25,1,5,20,0,1,0,1,4,25,0,0,0,1,2,3,4,1,5,0,0,3
441899,499_14_68,BELGIUM,24196,12,wen-boss mukubu,19,2,4,50,1,1,100,1,3,33.3,4,6,66.7,1,2,3,3,2,1,0,1,9
441900,499_14_68,BELGIUM,11181,13,pierre-antoine gillet,23,3,6,50,1,1,100,2,5,40,0,0,0,3,3,6,1,4,1,0,0,8
441901,499_14_68,BELGIUM,10498,14,maxime de zeeuw,19,5,10,50,5,8,62.5,0,2,0,0,1,0,2,4,6,0,3,3,0,0,10
441902,499_14_68,BELGIUM,0,TOTALS,BELGIUM,200,31,63,49.2,21,29,72.4,10,34,29.4,5,8,62.5,12,28,40,22,18,16,7,1,77
441903,499_14_69,NETHERLANDS,10202,4,arvin slagter,30,4,13,30.8,2,5,40,2,8,25,5,6,83.3,0,2,2,5,2,2,1,0,15
441904,499_14_69,NETHERLANDS,15661,5,leon williams,34,3,5,60,3,3,100,0,2,0,0,0,0,0,3,3,3,3,1,2,0,6
441905,499_14_69,NETHERLANDS,24213,6,worthy de jong,20,4,9,44.4,4,8,50,0,1,0,1,2,50,1,2,3,1,4,2,1,0,9
441906,499_14_69,NETHERLANDS,22012,7,julius clay van sauers,0,0,0,0,0,0,0,0,0,0,0,0,0,0,0,0,0,0,0,0,0,0
441907,499_14_69,NETHERLANDS,13250,8,dexter cornelis hope,3,0,0,0,0,0,0,0,0,0,0,0,0,0,1,1,0,1,0,0,0,0
441908,499_14_69,NETHERLANDS,10671,9,mohamed kherrazi,31,4,6,66.7,4,6,66.7,0,0,0,1,4,25,2,7,9,2,3,2,0,0,9
441909,499_14_69,NETHERLANDS,12501,10,ralf de pagter,12,1,2,50,1,2,50,0,0,0,2,2,100,0,3,3,1,1,0,0,0,4
441910,499_14_69,NETHERLANDS,6397,11,thomas koenis,16,1,2,50,1,2,50,0,0,0,0,0,0,0,0,0,0,3,0,1,0,2
441911,499_14_69,NETHERLANDS,20078,13,kevin bleeker,0,0,0,0,0,0,0,0,0,0,0,0,0,0,0,0,0,0,0,0,0,0
441912,499_14_69,NETHERLANDS,5812,14,nick oudendag,23,4,8,50,4,8,50,0,0,0,1,2,50,4,3,7,1,2,1,1,1,9
441913,499_14_69,NETHERLANDS,2871,21,roeland schaftenaar,31,6,11,54.5,4,8,50,2,3,66.7,0,3,0,1,7,8,0,1,2,0,0,14
441914,499_14_69,NETHERLANDS,0,TOTALS,NETHERLANDS,200,27,56,48.2,23,42,54.8,4,14,28.6,10,19,52.6,8,28,36,13,20,10,6,1,68
441915,499_14_69,MONTENEGRO,12640,5,vladimir mihailovic,15,3,5,60,2,3,66.7,1,2,50,0,1,0,0,1,1,0,1,0,0,0,7
441916,499_14_69,MONTENEGRO,10453,6,suad sehovic,29,6,12,50,2,3,66.7,4,9,44.4,1,2,50,1,3,4,1,3,1,2,0,17
441917,499_14_69,MONTENEGRO,19707,7,vladimir dragicevic,26,4,7,57.1,4,7,57.1,0,0,0,0,1,0,1,4,5,1,2,0,1,0,8
441918,499_14_69,MONTENEGRO,10457,8,sead sehovic,26,3,7,42.9,2,2,100,1,5,20,2,2,100,1,1,2,1,3,4,0,0,9
441919,499_14_69,MONTENEGRO,1863,9,vladimir golubovic,18,0,3,0,0,3,0,0,0,0,0,0,0,3,3,6,0,1,0,0,1,0
441920,499_14_69,MONTENEGRO,24211,10,taylor campbell rochestie,26,2,7,28.6,2,4,50,0,3,0,2,2,100,0,1,1,3,2,2,0,0,6
441921,499_14_69,MONTENEGRO,11120,12,nemanja radovic,11,0,2,0,0,1,0,0,1,0,0,0,0,0,2,2,0,2,1,0,0,0
441922,499_14_69,MONTENEGRO,11117,13,nemanja djurisic,0,0,0,0,0,0,0,0,0,0,0,0,0,0,0,0,0,0,0,0,0,0
441923,499_14_69,MONTENEGRO,1723,14,ivan maras,0,0,0,0,0,0,0,0,0,0,0,0,0,0,0,0,0,0,0,0,0,0
441924,499_14_69,MONTENEGRO,10455,15,aleksa popovic,10,0,2,0,0,1,0,0,1,0,0,0,0,1,1,2,0,2,0,0,0,0
441925,499_14_69,MONTENEGRO,15868,20,nikola ivanovic,14,0,2,0,0,1,0,0,1,0,2,2,100,0,3,3,3,0,0,1,0,2
441926,499_14_69,MONTENEGRO,15355,22,milos borisov,25,2,7,28.6,0,1,0,2,6,33.3,0,0,0,0,2,2,2,3,1,0,0,6
441927,499_14_69,MONTENEGRO,0,TOTALS,MONTENEGRO,200,20,54,37,12,26,46.2,8,28,28.6,7,10,70,7,21,28,11,20,11,4,1,55
441928,499_14_70,POLAND,5694,5,aaron cel,23,6,10,60,6,9,66.7,0,1,0,0,0,0,0,1,1,0,2,0,1,0,12
441929,499_14_70,POLAND,4799,6,robert jozef skibniewski,23,3,5,60,2,2,100,1,3,33.3,0,2,0,0,0,0,5,2,1,1,0,7
441930,499_14_70,POLAND,7833,7,damian kulig,30,10,16,62.5,10,14,71.4,0,2,0,2,3,66.7,2,10,12,2,4,0,1,0,22
441931,499_14_70,POLAND,24194,8,przemyslaw zamojski,25,1,5,20,1,2,50,0,3,0,0,0,0,0,0,0,1,3,2,3,0,2
441932,499_14_70,POLAND,15981,9,mateusz ponitka,30,3,8,37.5,2,3,66.7,1,5,20,4,6,66.7,2,5,7,0,3,3,4,0,11
441933,499_14_70,POLAND,4804,10,szymon pawel szewczyk,2,0,1,0,0,0,0,0,1,0,0,0,0,0,0,0,0,0,0,0,0,0
441934,499_14_70,POLAND,12920,11,przemyslaw karnowski,25,5,8,62.5,5,8,62.5,0,0,0,3,6,50,4,6,10,2,1,3,0,2,13
441935,499_14_70,POLAND,8034,12,adam waczynski,35,7,13,53.8,5,7,71.4,2,6,33.3,3,4,75,1,2,3,2,3,3,1,0,19
441936,499_14_70,POLAND,19694,14,adam hrycaniuk,10,0,3,0,0,3,0,0,0,0,0,0,0,0,1,1,0,5,0,0,0,0
441937,499_14_70,POLAND,6190,15,kamil jacek laczynski,22,2,4,50,2,3,66.7,0,1,0,0,0,0,0,1,1,5,4,2,0,0,4
441938,499_14_70,POLAND,15983,21,tomasz gielo,0,0,0,0,0,0,0,0,0,0,0,0,0,0,0,0,0,0,0,0,0,0
441939,499_14_70,POLAND,15977,23,michal michalak,0,0,0,0,0,0,0,0,0,0,0,0,0,0,0,0,0,0,0,0,0,0
441940,499_14_70,POLAND,0,TOTALS,POLAND,225,37,73,50.7,33,51,64.7,4,22,18.2,12,21,57.1,10,27,37,17,27,15,11,2,90
441941,499_14_70,AUSTRIA,2103,5,thomas schreiner,39,6,11,54.5,3,6,50,3,5,60,2,3,66.7,0,3,3,6,1,3,1,0,17
441942,499_14_70,AUSTRIA,29530,8,enis murati,0,0,0,0,0,0,0,0,0,0,0,0,0,0,0,0,0,0,0,0,0,0
441943,499_14_70,AUSTRIA,16191,14,jozo rados,8,0,3,0,0,3,0,0,0,0,0,0,0,0,3,3,0,3,1,1,0,0
441944,499_14_70,AUSTRIA,8395,15,david hasenburger,17,3,7,42.9,2,4,50,1,3,33.3,1,2,50,1,1,2,0,2,3,1,0,8
441945,499_14_70,AUSTRIA,8392,20,romed vieider,12,0,0,0,0,0,0,0,0,0,2,2,100,0,0,0,1,0,0,0,0,2
441946,499_14_70,AUSTRIA,8396,24,rasid mahalbasic,39,10,18,55.6,10,15,66.7,0,3,0,7,9,77.8,2,11,13,2,5,2,0,2,27
441947,499_14_70,AUSTRIA,8386,25,jesse nii l. seilern und aspang,0,0,0,0,0,0,0,0,0,0,0,0,0,0,0,0,0,0,0,0,0,0
441948,499_14_70,AUSTRIA,6415,34,moritz lanegger,22,0,2,0,0,2,0,0,0,0,2,4,50,1,5,6,2,5,1,0,0,2
441949,499_14_70,AUSTRIA,12529,35,sebastian koch,22,3,8,37.5,1,2,50,2,6,33.3,3,4,75,0,2,2,0,0,1,1,0,11
441950,499_14_70,AUSTRIA,13271,41,maximilian hopfgartner,4,0,0,0,0,0,0,0,0,0,0,0,0,0,0,0,0,0,1,0,0,0
441951,499_14_70,AUSTRIA,11250,42,thomas klepeisz,29,1,5,20,0,0,0,1,5,20,3,3,100,0,1,1,1,4,5,1,0,6
441952,499_14_70,AUSTRIA,15717,43,anton maresch,33,3,3,100,1,1,100,2,2,100,4,4,100,2,2,4,1,3,2,1,0,12
441953,499_14_70,AUSTRIA,0,TOTALS,AUSTRIA,225,26,57,45.6,17,33,51.5,9,24,37.5,24,31,77.4,6,28,34,13,23,19,6,2,85
441954,499_14_71,MKD,22445,5,andrej magdevski,25,2,5,40,0,0,0,2,5,40,0,0,0,2,2,4,2,1,2,0,0,6
441955,499_14_71,MKD,7810,6,darko sokolov,19,2,6,33.3,1,2,50,1,4,25,0,0,0,0,2,2,2,2,2,1,0,5
441956,499_14_71,MKD,2709,7,aleksandar kostoski,15,1,6,16.7,0,1,0,1,5,20,0,0,0,0,2,2,0,3,1,0,0,3
441957,499_14_71,MKD,5892,8,vojdan stojanovski,26,3,5,60,2,4,50,1,1,100,4,6,66.7,1,2,3,4,2,2,0,0,11
441958,499_14_71,MKD,5892,9,damjan stojanovski,20,3,4,75,0,1,0,3,3,100,4,4,100,1,3,4,2,1,0,0,0,13
441959,499_14_71,MKD,6300,10,marko simonovski,16,2,6,33.3,1,2,50,1,4,25,2,2,100,2,1,3,0,3,0,0,0,7
441960,499_14_71,MKD,6306,11,vladimir brckov,5,0,0,0,0,0,0,0,0,0,0,0,0,0,0,0,1,0,0,0,0,0
441961,499_14_71,MKD,2714,12,bojan trajkovski,24,4,11,36.4,4,8,50,0,3,0,0,2,0,1,7,8,2,5,2,1,0,8
441962,499_14_71,MKD,11275,13,stojan gjuroski,18,2,8,25,1,4,25,1,4,25,0,0,0,0,1,1,0,1,0,0,0,5
441963,499_14_71,MKD,2715,14,marjan janeski,4,0,2,0,0,2,0,0,0,0,2,2,100,1,0,1,0,3,0,0,0,2
441964,499_14_71,MKD,29507,15,venard richard hendriks,27,5,9,55.6,5,8,62.5,0,1,0,2,4,50,4,6,10,3,3,1,2,2,12
441965,499_14_71,MKD,20507,24,ljubomir mladenovski,1,0,0,0,0,0,0,0,0,0,0,0,0,0,0,0,0,0,0,0,0,0
441966,499_14_71,MKD,0,TOTALS,MKD,200,24,62,38.7,14,32,43.8,10,30,33.3,14,20,70,14,27,41,16,24,11,4,2,72
441967,499_14_71,BELARUS,1646,4,kanstantsin yafremau,18,0,1,0,0,0,0,0,1,0,1,2,50,0,4,4,0,2,0,0,0,1
441968,499_14_71,BELARUS,15346,5,siarhei charykau,17,0,2,0,0,1,0,0,1,0,0,0,0,0,0,0,2,1,0,1,0,0
441969,499_14_71,BELARUS,16119,6,aliaksandr semianiuk,0,0,0,0,0,0,0,0,0,0,0,0,0,0,0,0,0,0,0,0,0,0
441970,499_14_71,BELARUS,29521,7,kiryl sitnik,28,6,11,54.5,1,2,50,5,9,55.6,1,2,50,0,4,4,0,3,1,1,0,18
441971,499_14_71,BELARUS,2847,8,mikita meshcharakou,8,1,2,50,1,2,50,0,0,0,2,4,50,4,0,4,0,1,2,0,0,4
441972,499_14_71,BELARUS,4916,9,mikalai aliakseyeu,17,1,6,16.7,1,5,20,0,1,0,0,0,0,1,2,3,0,2,1,0,0,2
441973,499_14_71,BELARUS,13157,10,vitali liutych,30,4,8,50,3,7,42.9,1,1,100,7,10,70,1,3,4,2,0,2,1,0,16
441974,499_14_71,BELARUS,997,11,dzmitry paliashchuk,20,4,9,44.4,2,3,66.7,2,6,33.3,1,2,50,1,4,5,0,2,1,0,0,11
441975,499_14_71,BELARUS,998,12,aliaksandr pustahvar,18,0,4,0,0,2,0,0,2,0,5,5,100,1,5,6,0,2,0,0,0,5
441976,499_14_71,BELARUS,5476,13,valery gandlin,8,0,2,0,0,1,0,0,1,0,0,0,0,0,1,1,1,1,0,0,0,0
441977,499_14_71,BELARUS,4915,14,aliaksandr kudrautsau,24,3,8,37.5,3,5,60,0,3,0,1,2,50,1,0,1,2,5,1,1,0,7
441978,499_14_71,BELARUS,1645,15,aliaksei trastsinetski,12,1,2,50,1,2,50,0,0,0,0,0,0,0,2,2,0,1,2,0,0,2
441979,499_14_71,BELARUS,0,TOTALS,BELARUS,200,20,55,36.4,12,30,40,8,25,32,18,27,66.7,10,26,36,7,20,11,4,0,66
441980,499_14_72,SWITZERLAND,12691,4,jonathan malu kazadi-muyombu,31,1,6,16.7,1,6,16.7,0,0,0,0,0,0,1,2,3,4,3,2,0,0,2
441981,499_14_72,SWITZERLAND,12692,5,federico sergio fridel,2,0,0,0,0,0,0,0,0,0,0,0,0,0,2,2,0,0,0,0,0,0
441982,499_14_72,SWITZERLAND,7804,6,dusan mladjan,28,2,10,20,1,5,20,1,5,20,2,4,50,0,0,0,3,5,2,1,0,7
441983,499_14_72,SWITZERLAND,16096,7,marko mladjan,29,9,18,50,7,12,58.3,2,6,33.3,1,5,20,3,7,10,0,4,0,0,0,21
441984,499_14_72,SWITZERLAND,1260,8,cedric lionel mafuta,8,0,2,0,0,2,0,0,0,0,0,2,0,0,2,2,1,1,2,0,0,0
441985,499_14_72,SWITZERLAND,19748,9,roberto kovac,28,4,6,66.7,2,2,100,2,4,50,4,6,66.7,0,2,2,1,3,1,0,0,14
441986,499_14_72,SWITZERLAND,19912,10,alexis herrmann,4,0,1,0,0,1,0,0,0,0,0,0,0,0,0,0,2,0,0,0,0,0
441987,499_14_72,SWITZERLAND,10497,12,nicolas dos santos,9,0,1,0,0,0,0,0,1,0,0,0,0,0,0,0,0,0,1,0,0,0
441988,499_14_72,SWITZERLAND,17888,15,arnaud amedee cotture,23,0,2,0,0,2,0,0,0,0,1,2,50,1,3,4,0,3,1,1,1,1
441989,499_14_72,SWITZERLAND,4860,21,oliver matthias vogt,30,3,9,33.3,2,8,25,1,1,100,5,6,83.3,1,5,6,1,3,1,1,1,12
441990,499_14_72,SWITZERLAND,17392,22,evrard adam atcho,8,3,6,50,3,6,50,0,0,0,2,4,50,3,1,4,0,4,0,0,0,8
441991,499_14_72,SWITZERLAND,0,TOTALS,SWITZERLAND,200,22,61,36.1,16,44,36.4,6,17,35.3,15,29,51.7,10,25,35,12,26,11,3,2,65
441992,499_14_72,ITALY,12988,5,alessandro gentile,17,1,7,14.3,1,4,25,0,3,0,2,5,40,0,1,1,2,2,1,0,0,4
441993,499_14_72,ITALY,1705,7,luca vitali,16,1,4,25,0,0,0,1,4,25,0,0,0,0,2,2,0,4,0,0,0,3
441994,499_14_72,ITALY,15319,12,marco cusin,20,4,4,100,4,4,100,0,0,0,3,3,100,2,6,8,0,3,2,0,1,11
441995,499_14_72,ITALY,1861,13,luigi datome,32,9,11,81.8,6,7,85.7,3,4,75,3,4,75,2,5,7,2,3,3,0,0,24
441996,499_14_72,ITALY,19847,14,riccardo cervi,13,2,2,100,2,2,100,0,0,0,2,2,100,1,5,6,0,4,2,0,1,6
441997,499_14_72,ITALY,19752,20,andrea cinciarini,27,6,10,60,5,9,55.6,1,1,100,4,4,100,0,4,4,1,1,0,0,0,17
441998,499_14_72,ITALY,10579,22,stefano gentile,21,2,8,25,2,3,66.7,0,5,0,0,0,0,0,0,0,3,2,0,1,0,4
441999,499_14_72,ITALY,10962,24,riccardo moraschini,9,0,1,0,0,0,0,0,1,0,0,0,0,0,0,0,0,0,1,0,0,0
442000,499_14_72,ITALY,17241,27,davide pascolo,7,0,2,0,0,2,0,0,0,0,0,0,0,0,0,0,0,2,0,0,0,0
442001,499_14_72,ITALY,15645,31,michele vitali,12,0,2,0,0,1,0,0,1,0,3,4,75,0,2,2,0,1,1,0,0,3
442002,499_14_72,ITALY,7944,33,pietro aradori,19,2,4,50,1,3,33.3,1,1,100,2,2,100,0,3,3,4,1,2,1,0,7
442003,499_14_72,ITALY,15644,34,achille polonara,8,0,1,0,0,0,0,0,1,0,1,2,50,0,1,1,0,1,1,0,0,1
442004,499_14_72,ITALY,0,TOTALS,ITALY,200,27,56,48.2,21,35,60,6,21,28.6,20,26,76.9,6,33,39,12,24,13,2,2,80
471411,519_15_01,AUSTRALIA,9039,4,chris goulding,14,2,2,100,2,2,100,0,0,0,0,0,0,1,3,4,0,0,1,0,0,4
471412,519_15_01,AUSTRALIA,9045,5,patty mills,26,7,15,46.7,4,6,66.7,3,9,33.3,0,0,0,0,4,4,4,1,3,0,0,17
471413,519_15_01,AUSTRALIA,135,6,andrew bogut,22,1,6,16.7,1,5,20,0,1,0,2,2,100,0,4,4,1,1,2,1,1,4
471414,519_15_01,AUSTRALIA,3458,7,adam gibson,16,1,2,50,1,2,50,0,0,0,0,0,0,0,2,2,0,0,0,0,0,2
471415,519_15_01,AUSTRALIA,3466,8,brad newley,12,0,2,0,0,2,0,0,0,0,0,0,0,0,1,1,0,0,0,0,0,0
471416,519_15_01,AUSTRALIA,13811,9,matthew dellavedova,25,6,9,66.7,4,5,80,2,4,50,1,1,100,0,5,5,4,2,1,0,0,15
471417,519_15_01,AUSTRALIA,25376,10,cameron bairstow,19,3,9,33.3,2,8,25,1,1,100,1,2,50,4,1,5,1,1,1,0,0,8
471418,519_15_01,AUSTRALIA,142,13,david andersen,20,5,10,50,4,8,50,1,2,50,6,6,100,2,1,3,0,2,0,0,0,17
471419,519_15_01,AUSTRALIA,13814,14,brock motum,8,0,1,0,0,1,0,0,0,0,0,0,0,0,1,1,0,0,0,0,0,0
471420,519_15_01,AUSTRALIA,3457,15,nate jawai,11,2,2,100,2,2,100,0,0,0,0,0,0,1,1,2,1,2,1,0,0,4
471421,519_15_01,AUSTRALIA,9041,16,cameron gliddon,0,0,0,0,0,0,0,0,0,0,0,0,0,0,0,0,0,0,0,0,0,0
471422,519_15_01,AUSTRALIA,13813,45,ryan broekhoff,28,0,2,0,0,0,0,0,2,0,0,0,0,0,7,7,2,1,0,0,0,0
471423,519_15_01,AUSTRALIA,0,TOTALS,AUSTRALIA,200,27,60,45,20,41,48.8,7,19,36.8,10,11,90.9,8,30,38,13,10,10,1,1,71
471424,519_15_01,NEW ZEALAND,30799,0,shea ili,0,0,0,0,0,0,0,0,0,0,0,0,0,0,0,0,0,0,0,0,0,0
471425,519_15_01,NEW ZEALAND,22924,1,reuben te rangi,12,1,1,100,0,0,0,1,1,100,0,0,0,0,2,2,0,2,0,0,0,3
471426,519_15_01,NEW ZEALAND,6772,4,lindsay tait,12,0,2,0,0,1,0,0,1,0,0,0,0,1,0,1,1,1,0,0,0,0
471427,519_15_01,NEW ZEALAND,21055,5,everard bartlett,7,0,3,0,0,0,0,0,3,0,0,0,0,1,3,4,2,1,0,0,0,0
471428,519_15_01,NEW ZEALAND,16521,6,jarrod kenny,21,4,7,57.1,1,2,50,3,5,60,1,2,50,0,1,1,1,1,2,0,0,12
471429,519_15_01,NEW ZEALAND,6773,7,mika vukona,28,2,3,66.7,2,3,66.7,0,0,0,1,1,100,1,4,5,3,5,1,0,0,5
471430,519_15_01,NEW ZEALAND,11656,9,corey webster,36,10,24,41.7,8,19,42.1,2,5,40,0,0,0,0,1,1,2,1,0,0,0,22
471431,519_15_01,NEW ZEALAND,16523,10,thomas abercrombie,33,1,8,12.5,1,4,25,0,4,0,1,1,100,0,3,3,0,1,1,0,0,3
471432,519_15_01,NEW ZEALAND,25407,11,tai wynyard,1,0,0,0,0,0,0,0,0,0,0,0,0,0,0,0,0,0,0,0,0,0
471433,519_15_01,NEW ZEALAND,25442,12,isaac fotu,33,3,6,50,3,4,75,0,2,0,0,0,0,2,8,10,3,0,1,0,1,6
471434,519_15_01,NEW ZEALAND,13830,13,dion prewster,0,0,0,0,0,0,0,0,0,0,0,0,0,0,0,0,0,0,0,0,0,0
471435,519_15_01,NEW ZEALAND,13832,14,robert loe,18,3,10,30,2,4,50,1,6,16.7,1,1,100,1,0,1,1,3,2,0,0,8
471436,519_15_01,NEW ZEALAND,0,TOTALS,NEW ZEALAND,200,24,64,37.5,17,37,45.9,7,27,25.9,4,5,80,6,22,28,13,15,7,0,1,59
471437,519_15_02,NEW ZEALAND,30799,0,shea ili,6,1,4,25,1,3,33.3,0,1,0,0,0,0,0,0,0,2,2,1,1,0,2
471438,519_15_02,NEW ZEALAND,22924,1,reuben te rangi,20,5,10,50,1,5,20,4,5,80,0,0,0,1,0,1,0,3,0,0,0,14
471439,519_15_02,NEW ZEALAND,6772,4,lindsay tait,13,0,1,0,0,1,0,0,0,0,2,2,100,0,1,1,2,1,0,0,0,2
471440,519_15_02,NEW ZEALAND,21055,5,everard bartlett,15,4,7,57.1,1,1,100,3,6,50,2,3,66.7,0,0,0,1,1,1,0,0,13
471441,519_15_02,NEW ZEALAND,16521,6,jarrod kenny,11,0,3,0,0,2,0,0,1,0,0,0,0,0,0,0,0,1,0,0,0,0
471442,519_15_02,NEW ZEALAND,6773,7,mika vukona,29,4,7,57.1,4,7,57.1,0,0,0,0,2,0,4,4,8,3,3,2,0,0,8
471443,519_15_02,NEW ZEALAND,11656,9,corey webster,29,7,24,29.2,5,14,35.7,2,10,20,0,0,0,1,1,2,3,3,2,2,0,16
471444,519_15_02,NEW ZEALAND,16523,10,thomas abercrombie,34,3,8,37.5,3,7,42.9,0,1,0,2,2,100,0,3,3,3,2,1,3,0,8
471445,519_15_02,NEW ZEALAND,25407,11,tai wynyard,1,1,1,100,1,1,100,0,0,0,0,0,0,1,0,1,0,0,0,0,0,2
471446,519_15_02,NEW ZEALAND,25442,12,isaac fotu,31,4,9,44.4,2,5,40,2,4,50,2,2,100,3,5,8,3,2,1,0,1,12
471447,519_15_02,NEW ZEALAND,13830,13,dion prewster,1,0,0,0,0,0,0,0,0,0,0,0,0,0,0,0,0,0,0,0,0,0
471448,519_15_02,NEW ZEALAND,13832,14,robert loe,12,1,1,100,1,1,100,0,0,0,0,0,0,0,1,1,0,1,1,0,1,2
471449,519_15_02,NEW ZEALAND,0,TOTALS,NEW ZEALAND,200,30,75,40,19,47,40.4,11,28,39.3,8,11,72.7,12,16,28,17,19,9,6,2,79
471450,519_15_02,AUSTRALIA,9039,4,chris goulding,16,4,5,80,4,5,80,0,0,0,0,2,0,0,0,0,2,4,0,0,0,8
471451,519_15_02,AUSTRALIA,9045,5,patty mills,22,3,6,50,2,3,66.7,1,3,33.3,2,2,100,0,5,5,4,0,4,0,0,9
471452,519_15_02,AUSTRALIA,135,6,andrew bogut,20,4,7,57.1,4,7,57.1,0,0,0,2,2,100,1,9,10,0,3,1,0,3,10
471453,519_15_02,AUSTRALIA,3458,7,adam gibson,19,0,0,0,0,0,0,0,0,0,4,4,100,0,0,0,3,2,2,1,0,4
471454,519_15_02,AUSTRALIA,3466,8,brad newley,16,3,6,50,1,3,33.3,2,3,66.7,0,0,0,1,4,5,0,2,1,0,0,8
471455,519_15_02,AUSTRALIA,13811,9,matthew dellavedova,25,4,10,40,2,6,33.3,2,4,50,4,4,100,0,0,0,5,2,2,2,0,14
471456,519_15_02,AUSTRALIA,25376,10,cameron bairstow,18,4,8,50,4,8,50,0,0,0,2,2,100,3,4,7,1,1,0,0,1,10
471457,519_15_02,AUSTRALIA,142,13,david andersen,19,4,9,44.4,3,6,50,1,3,33.3,2,2,100,1,2,3,1,0,3,0,0,11
471458,519_15_02,AUSTRALIA,13814,14,brock motum,11,2,4,50,2,3,66.7,0,1,0,2,2,100,0,2,2,0,1,2,0,1,6
471459,519_15_02,AUSTRALIA,3457,15,nate jawai,10,1,1,100,1,1,100,0,0,0,2,2,100,1,2,3,0,2,2,0,0,4
471460,519_15_02,AUSTRALIA,13813,45,ryan broekhoff,24,2,3,66.7,2,2,100,0,1,0,1,2,50,1,5,6,0,1,0,0,1,5
471461,519_15_02,AUSTRALIA,0,TOTALS,AUSTRALIA,200,31,59,52.5,25,44,56.8,6,15,40,21,24,87.5,11,34,45,16,18,17,3,6,89
471930,523_16_01,AUSTRALIA,9039,4,chris goulding,1,0,2,0,0,0,0,0,2,0,0,0,0,0,0,0,0,0,0,0,0,0
471931,523_16_01,AUSTRALIA,9045,5,patty mills,28,7,15,46.7,3,6,50,4,9,44.4,3,4,75,0,2,2,5,1,0,2,0,21
471932,523_16_01,AUSTRALIA,135,6,andrew bogut,23,9,10,90,9,10,90,0,0,0,0,0,0,0,4,4,5,2,1,0,1,18
471933,523_16_01,AUSTRALIA,11635,7,joe ingles,25,2,6,33.3,2,3,66.7,0,3,0,0,0,0,0,2,2,6,4,1,2,0,4
471934,523_16_01,AUSTRALIA,13811,8,matthew dellavedova,27,2,6,33.3,2,5,40,0,1,0,0,0,0,1,2,3,10,3,1,3,0,4
471935,523_16_01,AUSTRALIA,13813,9,ryan broekhoff,15,2,6,33.3,1,2,50,1,4,25,2,4,50,0,4,4,0,1,1,2,0,7
471936,523_16_01,AUSTRALIA,25376,10,cameron bairstow,14,1,2,50,1,2,50,0,0,0,0,0,0,0,3,3,1,3,0,0,0,2
471937,523_16_01,AUSTRALIA,30889,11,kevin lisch,21,3,4,75,2,2,100,1,2,50,0,0,0,0,0,0,1,2,1,1,0,7
471938,523_16_01,AUSTRALIA,16519,12,aron baynes,24,5,14,35.7,5,14,35.7,0,0,0,4,6,66.7,6,2,8,1,1,2,0,1,14
471939,523_16_01,AUSTRALIA,142,13,david andersen,18,3,4,75,3,4,75,0,0,0,1,1,100,1,4,5,0,3,0,0,0,7
471940,523_16_01,AUSTRALIA,13814,14,brock motum,1,0,0,0,0,0,0,0,0,0,0,0,0,0,0,0,0,0,0,1,0,0
471941,523_16_01,AUSTRALIA,16520,15,damian martin,4,1,1,100,0,0,0,1,1,100,0,0,0,0,0,0,0,1,0,0,0,3
471942,523_16_01,AUSTRALIA,0,TOTALS,AUSTRALIA,200,35,70,50,28,48,58.3,7,22,31.8,10,15,66.7,9,28,37,29,22,7,11,2,87
471943,523_16_01,FRANCE,12495,4,thomas heurtel,18,4,6,66.7,4,5,80,0,1,0,0,0,0,0,1,1,3,1,3,0,0,8
471944,523_16_01,FRANCE,2588,5,nicolas batum,22,2,3,66.7,1,1,100,1,2,50,0,0,0,0,2,2,2,2,4,1,0,5
471945,523_16_01,FRANCE,2589,6,antoine diot,12,0,1,0,0,1,0,0,0,0,0,0,0,0,0,0,0,1,1,1,0,0
471946,523_16_01,FRANCE,11076,7,joffrey lauvergne,10,0,4,0,0,4,0,0,0,0,0,0,0,0,3,3,0,1,1,0,0,0
471947,523_16_01,FRANCE,1864,8,charles kahudi,5,0,2,0,0,2,0,0,0,0,0,0,0,0,1,1,0,0,0,0,0,0
471948,523_16_01,FRANCE,5047,9,tony parker,20,6,14,42.9,5,9,55.6,1,5,20,5,6,83.3,0,2,2,2,1,0,0,0,18
471949,523_16_01,FRANCE,4663,11,florent pietrus,4,0,0,0,0,0,0,0,0,0,0,0,0,0,0,0,0,1,0,0,0,0
471950,523_16_01,FRANCE,10428,12,nando de colo,24,2,6,33.3,2,6,33.3,0,0,0,2,2,100,0,2,2,3,3,1,1,0,6
471951,523_16_01,FRANCE,4665,13,boris diaw,31,4,11,36.4,3,6,50,1,5,20,0,0,0,2,3,5,2,3,2,2,2,9
471952,523_16_01,FRANCE,5044,15,mickael gelabale,19,5,5,100,4,4,100,1,1,100,2,2,100,0,4,4,0,3,0,0,0,13
471953,523_16_01,FRANCE,17374,16,rudy gobert,25,1,3,33.3,1,3,33.3,0,0,0,3,4,75,2,5,7,0,3,3,1,3,5
471954,523_16_01,FRANCE,7987,17,kim tillie,9,0,2,0,0,2,0,0,0,0,2,2,100,1,1,2,0,1,1,0,0,2
471955,523_16_01,FRANCE,0,TOTALS,FRANCE,200,24,57,42.1,20,43,46.5,4,14,28.6,14,16,87.5,5,27,32,12,20,17,6,5,66
471956,523_16_02,CHINA,18850,4,jiwei zhao,24,1,6,16.7,0,1,0,1,5,20,0,0,0,0,6,6,5,2,5,1,0,3
471957,523_16_02,CHINA,30890,5,ran sui,10,0,0,0,0,0,0,0,0,0,0,0,0,1,0,1,1,2,0,0,0,0
471958,523_16_02,CHINA,14374,6,ailun guo,16,3,6,50,3,5,60,0,1,0,0,0,0,2,0,2,4,3,5,1,0,6
471959,523_16_02,CHINA,14377,8,yanyuhang ding,23,1,6,16.7,1,5,20,0,1,0,2,2,100,0,1,1,1,1,0,0,0,4
471960,523_16_02,CHINA,14378,9,xiaochuan zhai,18,1,3,33.3,0,0,0,1,3,33.3,0,0,0,0,2,2,2,3,2,2,0,3
471961,523_16_02,CHINA,16587,10,peng zhou,21,0,4,0,0,3,0,0,1,0,0,0,0,0,2,2,2,1,2,0,0,0
471962,523_16_02,CHINA,56,11,jianlian yi,30,8,19,42.1,6,15,40,2,4,50,7,8,87.5,0,6,6,0,2,3,0,1,25
471963,523_16_02,CHINA,28364,12,gen li,9,2,2,100,1,1,100,1,1,100,2,3,66.7,0,0,0,0,2,1,1,0,7
471964,523_16_02,CHINA,18361,13,muhao li,9,0,0,0,0,0,0,0,0,0,1,4,25,0,0,0,0,4,2,0,0,1
471965,523_16_02,CHINA,30891,14,yuchen zou,7,2,3,66.7,2,3,66.7,0,0,0,1,1,100,1,1,2,0,5,0,0,0,5
471966,523_16_02,CHINA,18858,15,qi zhou,18,0,2,0,0,1,0,0,1,0,3,4,75,0,1,1,0,4,2,1,1,3
471967,523_16_02,CHINA,16635,31,zhelin wang,16,2,5,40,2,5,40,0,0,0,1,2,50,0,1,1,1,4,1,1,0,5
471968,523_16_02,CHINA,0,TOTALS,CHINA,200,20,56,35.7,15,39,38.5,5,17,29.4,17,24,70.8,7,22,29,16,34,24,7,2,62
471969,523_16_02,USA,30892,4,jimmy butler,16,2,5,40,2,4,50,0,1,0,4,4,100,3,3,6,4,0,0,1,0,8
471970,523_16_02,USA,16599,5,kevin durant,22,10,14,71.4,5,6,83.3,5,8,62.5,0,0,0,0,4,4,6,0,1,2,0,25
471971,523_16_02,USA,9017,6,deandre jordan,13,2,3,66.7,2,3,66.7,0,0,0,3,10,30,4,3,7,0,2,0,1,0,7
471972,523_16_02,USA,30893,7,kyle lowry,13,0,1,0,0,0,0,0,1,0,7,10,70,1,2,3,3,1,2,2,0,7
471973,523_16_02,USA,30894,8,harrison barnes,13,4,6,66.7,4,5,80,0,1,0,0,0,0,2,2,4,1,2,0,1,0,8
471974,523_16_02,USA,25452,9,demar derozan,18,2,5,40,2,5,40,0,0,0,2,3,66.7,0,0,0,1,0,3,2,0,6
471975,523_16_02,USA,16977,10,kyrie irving,19,4,8,50,0,3,0,4,5,80,0,0,0,1,1,2,5,1,1,1,0,12
471976,523_16_02,USA,13751,11,klay thompson,19,1,6,16.7,1,3,33.3,0,3,0,0,0,0,0,2,2,1,3,1,2,1,2
471977,523_16_02,USA,25453,12,demarcus cousins,15,6,8,75,6,8,75,0,0,0,5,5,100,2,3,5,2,4,0,0,0,17
471978,523_16_02,USA,30895,13,paul george,18,4,10,40,4,6,66.7,0,4,0,7,7,100,1,2,3,3,4,0,1,1,15
471979,523_16_02,USA,30896,14,draymond green,14,1,3,33.3,1,2,50,0,1,0,1,2,50,1,3,4,3,2,0,2,0,3
471980,523_16_02,USA,113,15,carmelo anthony,20,2,5,40,1,2,50,1,3,33.3,4,4,100,1,6,7,2,0,1,0,1,9
471981,523_16_02,USA,0,TOTALS,USA,200,38,74,51.4,28,47,59.6,10,27,37,33,45,73.3,19,33,52,31,19,9,15,3,119
471982,523_16_03,VENEZUELA,9985,0,gregory echenique,24,5,7,71.4,5,7,71.4,0,0,0,2,3,66.7,4,1,5,1,4,1,0,0,12
471983,523_16_03,VENEZUELA,19023,2,dwight lewis,14,2,10,20,1,5,20,1,5,20,0,0,0,2,0,2,0,1,2,0,0,5
471984,523_16_03,VENEZUELA,514,4,miguel marriaga,5,0,0,0,0,0,0,0,0,0,0,0,0,0,0,0,0,0,0,0,0,0
471985,523_16_03,VENEZUELA,16828,5,gregory vargas,23,1,5,20,1,2,50,0,3,0,4,5,80,0,2,2,5,3,2,3,0,6
471986,523_16_03,VENEZUELA,21053,6,john cox,29,3,9,33.3,3,7,42.9,0,2,0,0,0,0,0,1,1,2,2,2,1,0,6
471987,523_16_03,VENEZUELA,16829,8,david cubillan,14,0,0,0,0,0,0,0,0,0,0,0,0,0,0,0,2,0,0,0,0,0
471988,523_16_03,VENEZUELA,9857,10,jose vargas,26,4,14,28.6,2,7,28.6,2,7,28.6,2,2,100,3,2,5,1,4,1,0,0,12
471989,523_16_03,VENEZUELA,25751,14,miguel ruiz,8,0,1,0,0,1,0,0,0,0,3,4,75,0,0,0,0,1,0,1,0,3
471990,523_16_03,VENEZUELA,19026,15,windi graterol,5,0,1,0,0,0,0,0,1,0,0,0,0,0,1,1,0,3,1,0,0,0
471991,523_16_03,VENEZUELA,19021,19,heissler guillent,15,2,7,28.6,2,4,50,0,3,0,0,0,0,1,0,1,3,1,0,1,0,4
471992,523_16_03,VENEZUELA,12301,23,anthony perez,5,1,1,100,0,0,0,1,1,100,0,0,0,0,0,0,0,2,0,0,0,3
471993,523_16_03,VENEZUELA,19022,43,nestor colmenares,31,5,8,62.5,5,8,62.5,0,0,0,1,3,33.3,2,4,6,1,1,2,2,1,11
471994,523_16_03,VENEZUELA,0,TOTALS,VENEZUELA,200,23,63,36.5,19,41,46.3,4,22,18.2,12,17,70.6,13,13,26,15,22,13,8,1,62
471995,523_16_03,SERBIA,5751,4,milos teodosic,25,1,5,20,0,1,0,1,4,25,2,2,100,0,4,4,2,2,6,0,0,5
471996,523_16_03,SERBIA,2100,5,marko simonovic,14,2,3,66.7,1,1,100,1,2,50,1,2,50,0,0,0,1,1,0,2,1,6
471997,523_16_03,SERBIA,17361,7,bogdan bogdanovic,26,8,12,66.7,5,7,71.4,3,5,60,0,0,0,0,1,1,2,2,1,1,1,19
471998,523_16_03,SERBIA,2654,9,stefan markovic,14,1,1,100,1,1,100,0,0,0,0,0,0,0,2,2,2,0,1,0,0,2
471999,523_16_03,SERBIA,19860,10,nikola kalinic,17,0,1,0,0,0,0,0,1,0,0,0,0,0,1,1,1,3,0,0,0,0
472000,523_16_03,SERBIA,15503,11,nemanja nedovic,18,3,8,37.5,2,4,50,1,4,25,0,0,0,0,1,1,4,1,2,1,0,7
472001,523_16_03,SERBIA,15504,12,stefan bircevic,10,2,2,100,2,2,100,0,0,0,2,2,100,0,2,2,1,3,0,1,0,6
472002,523_16_03,SERBIA,2656,13,miroslav raduljica,15,7,8,87.5,7,8,87.5,0,0,0,4,4,100,1,3,4,3,2,2,0,0,18
472003,523_16_03,SERBIA,22978,14,nikola jokic,19,2,2,100,2,2,100,0,0,0,0,0,0,1,6,7,3,3,2,0,1,4
472004,523_16_03,SERBIA,5756,15,vladimir stimac,6,1,3,33.3,1,3,33.3,0,0,0,3,6,50,4,4,8,0,1,0,0,0,5
472005,523_16_03,SERBIA,25441,24,stefan jovic,18,2,5,40,2,4,50,0,1,0,1,1,100,1,2,3,2,0,2,2,0,5
472006,523_16_03,SERBIA,6241,25,milan macvan,18,3,6,50,3,6,50,0,0,0,3,4,75,4,1,5,1,4,0,0,0,9
472007,523_16_03,SERBIA,0,TOTALS,SERBIA,200,32,56,57.1,26,39,66.7,6,17,35.3,16,21,76.2,13,27,40,22,22,16,7,3,86
472008,523_16_04,BRAZIL,14848,5,raulzinho neto,26,4,6,66.7,3,4,75,1,2,50,5,7,71.4,0,3,3,2,1,1,1,0,14
472009,523_16_04,BRAZIL,16960,6,cristiano felicio,14,1,1,100,1,1,100,0,0,0,2,4,50,2,2,4,0,4,1,0,1,4
472010,523_16_04,BRAZIL,7625,8,vitor benite,6,1,2,50,1,2,50,0,0,0,0,0,0,0,0,0,0,1,0,0,0,2
472011,523_16_04,BRAZIL,4098,9,marcelinho huertas,14,2,5,40,2,5,40,0,0,0,1,3,33.3,0,2,2,3,0,3,0,0,5
472012,523_16_04,BRAZIL,4102,10,alex garcia,15,2,5,40,2,4,50,0,1,0,0,0,0,2,1,3,0,1,1,0,0,4
472013,523_16_04,BRAZIL,4104,12,guilherme giovannoni,8,0,2,0,0,0,0,0,2,0,0,0,0,0,1,1,0,1,1,2,0,0
472014,523_16_04,BRAZIL,9844,13,nene hilario,30,4,8,50,4,8,50,0,0,0,3,6,50,3,5,8,2,2,0,1,1,11
472015,523_16_04,BRAZIL,9845,14,marcus vinicius marquinhos,30,1,6,16.7,0,1,0,1,5,20,4,7,57.1,1,2,3,2,1,1,1,0,7
472016,523_16_04,BRAZIL,4100,19,leandro barbosa,29,8,17,47.1,8,13,61.5,0,4,0,5,6,83.3,1,0,1,2,3,2,2,0,21
472017,523_16_04,BRAZIL,19019,23,augusto lima,21,2,2,100,2,2,100,0,0,0,0,0,0,1,5,6,1,5,1,1,0,4
472018,523_16_04,BRAZIL,23752,30,rafael hettsheimeir,7,1,2,50,1,2,50,0,0,0,2,2,100,0,1,1,0,4,1,0,0,4
472019,523_16_04,BRAZIL,7622,55,rafael luz,0,0,0,0,0,0,0,0,0,0,0,0,0,0,0,0,0,0,0,0,0,0
472020,523_16_04,BRAZIL,0,TOTALS,BRAZIL,200,26,56,46.4,24,42,57.1,2,14,14.3,22,35,62.9,10,23,33,12,23,13,8,2,76
472021,523_16_04,LITHUANIA,1726,5,mantas kalnietis,36,5,11,45.5,3,5,60,2,6,33.3,4,4,100,0,3,3,8,3,3,1,1,16
472022,523_16_04,LITHUANIA,6225,7,adas juskevicius,0,0,0,0,0,0,0,0,0,0,0,0,0,0,0,0,0,0,0,0,0,0
472023,523_16_04,LITHUANIA,980,8,jonas maciulis,27,3,10,30,1,2,50,2,8,25,2,3,66.7,1,5,6,3,3,2,1,0,10
472024,523_16_04,LITHUANIA,3474,10,renaldas seibutis,31,4,6,66.7,1,2,50,3,4,75,0,0,0,0,2,2,3,1,2,1,1,11
472025,523_16_04,LITHUANIA,22216,11,domantas sabonis,19,4,8,50,4,8,50,0,0,0,2,4,50,1,1,2,0,5,3,1,0,10
472026,523_16_04,LITHUANIA,3476,12,antanas kavaliauskas,9,2,2,100,2,2,100,0,0,0,2,2,100,0,4,4,1,4,0,0,0,6
472027,523_16_04,LITHUANIA,987,13,paulius jankunas,22,6,10,60,5,7,71.4,1,3,33.3,2,2,100,0,7,7,3,4,2,1,0,15
472028,523_16_04,LITHUANIA,24,15,robertas javtokas,3,0,0,0,0,0,0,0,0,0,0,0,0,0,0,0,0,3,1,0,0,0
472029,523_16_04,LITHUANIA,10916,17,jonas valanciunas,20,3,6,50,3,6,50,0,0,0,0,0,0,2,1,3,2,5,3,0,1,6
472030,523_16_04,LITHUANIA,10639,19,mindaugas kuzminskas,21,2,5,40,1,2,50,1,3,33.3,3,3,100,3,2,5,1,0,1,0,0,8
472031,523_16_04,LITHUANIA,17690,40,marius grigonis,8,0,0,0,0,0,0,0,0,0,0,0,0,0,0,0,1,0,0,1,0,0
472032,523_16_04,LITHUANIA,15948,93,vaidas kariniauskas,4,0,0,0,0,0,0,0,0,0,0,0,0,0,0,0,1,1,0,0,0,0
472033,523_16_04,LITHUANIA,0,TOTALS,LITHUANIA,200,29,58,50,20,34,58.8,9,24,37.5,15,18,83.3,7,26,33,23,29,17,6,3,82
472034,523_16_05,CROATIA,13759,4,luka babic,14,2,5,40,2,4,50,0,1,0,0,0,0,1,6,7,1,2,0,0,0,4
472035,523_16_05,CROATIA,7990,5,filip kruslin,0,0,0,0,0,0,0,0,0,0,0,0,0,0,0,0,0,0,0,0,0,0
472036,523_16_05,CROATIA,1915,6,rok stipcevic,6,0,1,0,0,0,0,0,1,0,0,0,0,0,1,1,1,1,0,0,0,0
472037,523_16_05,CROATIA,1249,7,krunoslav simon,24,3,10,30,3,5,60,0,5,0,4,4,100,0,5,5,4,4,0,1,0,10
472038,523_16_05,CROATIA,18415,8,mario hezonja,16,2,5,40,1,3,33.3,1,2,50,0,0,0,0,2,2,1,0,0,0,0,5
472039,523_16_05,CROATIA,15894,9,dario saric,34,1,7,14.3,1,3,33.3,0,4,0,3,6,50,3,4,7,5,2,3,0,1,5
472040,523_16_05,CROATIA,4585,10,roko ukic,28,3,7,42.9,1,4,25,2,3,66.7,0,0,0,1,6,7,2,2,1,2,0,8
472041,523_16_05,CROATIA,12600,12,darko planinic,23,1,2,50,1,2,50,0,0,0,9,10,90,3,3,6,0,3,2,0,1,11
472042,523_16_05,CROATIA,10624,15,miro bilan,15,3,4,75,3,4,75,0,0,0,0,0,0,2,0,2,0,2,2,0,0,6
472043,523_16_05,CROATIA,7991,33,zeljko sakic,5,0,0,0,0,0,0,0,0,0,0,0,0,0,1,1,0,0,0,0,0,0
472044,523_16_05,CROATIA,20277,35,marko arapovic,0,0,0,0,0,0,0,0,0,0,0,0,0,0,0,0,0,0,0,0,0,0
472045,523_16_05,CROATIA,6280,44,bojan bogdanovic,36,8,15,53.3,5,7,71.4,3,8,37.5,4,5,80,0,3,3,2,4,4,0,1,23
472046,523_16_05,CROATIA,0,TOTALS,CROATIA,200,23,56,41.1,17,32,53.1,6,24,25,20,25,80,10,31,41,16,21,14,3,3,72
472047,523_16_05,SPAIN,61,4,pau gasol,32,11,17,64.7,8,13,61.5,3,4,75,1,2,50,1,8,9,1,4,0,0,0,26
472048,523_16_05,SPAIN,70,5,rudy fernandez,29,0,3,0,0,0,0,0,3,0,0,0,0,1,4,5,1,2,1,2,0,0
472049,523_16_05,SPAIN,1877,6,sergio rodriguez,28,3,11,27.3,1,4,25,2,7,28.6,2,2,100,1,1,2,7,2,4,1,0,10
472050,523_16_05,SPAIN,64,7,juan-carlos navarro,12,0,2,0,0,0,0,0,2,0,0,0,0,0,0,0,0,0,0,1,0,0
472051,523_16_05,SPAIN,65,8,jose manuel calderon,0,0,0,0,0,0,0,0,0,0,0,0,0,0,0,0,0,0,0,0,0,0
472052,523_16_05,SPAIN,66,9,felipe reyes,14,2,4,50,1,3,33.3,1,1,100,0,0,0,1,0,1,0,3,1,1,0,5
472053,523_16_05,SPAIN,2628,10,victor claver,11,0,0,0,0,0,0,0,0,0,1,2,50,0,1,1,1,2,0,0,0,1
472054,523_16_05,SPAIN,17609,14,willy hernangomez,4,0,3,0,0,3,0,0,0,0,0,0,0,0,0,0,0,2,1,0,0,0
472055,523_16_05,SPAIN,19988,21,alex abrines,0,0,0,0,0,0,0,0,0,0,0,0,0,0,0,0,0,0,0,0,0,0
472056,523_16_05,SPAIN,1871,23,sergio llull,28,2,6,33.3,1,2,50,1,4,25,4,4,100,0,2,2,3,3,1,0,0,9
472057,523_16_05,SPAIN,17234,44,nikola mirotic,31,7,14,50,3,6,50,4,8,50,1,2,50,2,4,6,3,1,1,1,0,19
472058,523_16_05,SPAIN,6259,79,ricky rubio,12,0,3,0,0,0,0,0,3,0,0,0,0,0,1,1,1,3,1,2,0,0
472059,523_16_05,SPAIN,0,TOTALS,SPAIN,200,25,63,39.7,14,31,45.2,11,32,34.4,9,12,75,7,23,30,17,22,10,8,0,70
472060,523_16_06,NIGERIA,23139,4,ben uzoh,14,1,3,33.3,1,2,50,0,1,0,2,2,100,0,0,0,0,1,3,0,0,4
472061,523_16_06,NIGERIA,13976,5,michael umeh,22,2,10,20,1,6,16.7,1,4,25,0,0,0,0,3,3,3,1,0,0,0,5
472062,523_16_06,NIGERIA,21026,6,ike diogu,28,4,10,40,2,3,66.7,2,7,28.6,5,6,83.3,1,12,13,1,3,5,1,2,15
472063,523_16_06,NIGERIA,6814,7,ebi ere,29,6,9,66.7,6,8,75,0,1,0,2,3,66.7,0,3,3,1,1,4,0,0,14
472064,523_16_06,NIGERIA,6813,8,josh akognon,5,0,2,0,0,0,0,0,2,0,0,0,0,0,1,1,0,2,1,0,0,0
472065,523_16_06,NIGERIA,3647,9,chamberlain oguchi,22,1,7,14.3,0,2,0,1,5,20,2,2,100,0,1,1,2,1,2,2,0,5
472066,523_16_06,NIGERIA,23140,10,stan okoye,0,0,0,0,0,0,0,0,0,0,0,0,0,0,0,0,0,0,0,0,0,0
472067,523_16_06,NIGERIA,23143,11,andy ogide,21,5,5,100,5,5,100,0,0,0,1,2,50,2,2,4,0,2,2,0,0,11
472068,523_16_06,NIGERIA,28095,12,michael gbinije,29,2,7,28.6,2,3,66.7,0,4,0,2,2,100,0,4,4,3,4,1,1,0,6
472069,523_16_06,NIGERIA,30897,13,shane lawal,3,0,0,0,0,0,0,0,0,0,0,0,0,0,1,1,0,0,1,0,1,0
472070,523_16_06,NIGERIA,21031,14,alade aminu,13,1,5,20,1,5,20,0,0,0,0,0,0,0,0,0,0,2,1,0,0,2
472071,523_16_06,NIGERIA,21025,15,ekene ibekwe,15,2,4,50,2,3,66.7,0,1,0,0,0,0,1,2,3,2,5,1,1,2,4
472072,523_16_06,NIGERIA,0,TOTALS,NIGERIA,200,24,62,38.7,20,37,54.1,4,25,16,14,17,82.4,8,30,38,12,22,21,5,5,66
472073,523_16_06,ARGENTINA,80,4,luis scola,25,7,12,58.3,6,10,60,1,2,50,3,4,75,1,8,9,3,4,2,1,0,18
472074,523_16_06,ARGENTINA,74,5,manu ginobili,25,4,10,40,2,5,40,2,5,40,2,4,50,2,3,5,5,2,1,2,0,12
472075,523_16_06,ARGENTINA,21037,7,facundo campazzo,23,6,10,60,1,2,50,5,8,62.5,2,2,100,2,1,3,5,1,4,5,0,19
472076,523_16_06,ARGENTINA,12228,8,nicolas laprovittola,17,2,8,25,0,3,0,2,5,40,1,2,50,0,2,2,2,2,1,0,0,7
472077,523_16_06,ARGENTINA,25732,9,nicolas brussino,5,1,2,50,1,1,100,0,1,0,0,0,0,0,2,2,0,0,0,0,1,2
472078,523_16_06,ARGENTINA,83,10,carlos delfino,21,1,7,14.3,0,2,0,1,5,20,0,0,0,0,1,1,0,2,1,0,0,3
472079,523_16_06,ARGENTINA,14903,12,marcos delia,19,2,6,33.3,2,6,33.3,0,0,0,1,2,50,3,1,4,2,1,0,0,1,5
472080,523_16_06,ARGENTINA,82,13,andres nocioni,25,4,8,50,2,3,66.7,2,5,40,0,0,0,0,6,6,1,2,4,3,1,10
472081,523_16_06,ARGENTINA,15007,14,gabriel deck,4,0,0,0,0,0,0,0,0,0,0,0,0,0,1,1,0,1,1,0,0,0
472082,523_16_06,ARGENTINA,459,19,leo mainoldi,9,1,2,50,0,0,0,1,2,50,0,0,0,0,0,0,0,3,0,0,1,3
472083,523_16_06,ARGENTINA,12296,29,patricio garino,26,5,6,83.3,4,5,80,1,1,100,4,5,80,3,3,6,0,1,1,0,0,15
472084,523_16_06,ARGENTINA,30898,35,roberto acuna,3,0,1,0,0,1,0,0,0,0,0,0,0,1,0,1,0,1,0,0,0,0
472085,523_16_06,ARGENTINA,0,TOTALS,ARGENTINA,200,33,72,45.8,18,38,47.4,15,34,44.1,13,19,68.4,13,31,44,18,20,15,11,4,94
472086,523_16_07,SERBIA,5751,4,milos teodosic,22,5,14,35.7,2,6,33.3,3,8,37.5,4,5,80,0,1,1,3,2,3,0,0,17
472087,523_16_07,SERBIA,2100,5,marko simonovic,0,0,0,0,0,0,0,0,0,0,0,0,0,0,0,0,0,0,0,0,0,0
472088,523_16_07,SERBIA,17361,7,bogdan bogdanovic,30,5,14,35.7,5,11,45.5,0,3,0,2,2,100,4,4,8,3,2,1,0,0,12
472089,523_16_07,SERBIA,2654,9,stefan markovic,22,0,4,0,0,2,0,0,2,0,0,0,0,1,1,2,4,3,1,2,0,0
472090,523_16_07,SERBIA,19860,10,nikola kalinic,16,0,2,0,0,0,0,0,2,0,0,0,0,1,3,4,0,0,1,1,0,0
472091,523_16_07,SERBIA,15503,11,nemanja nedovic,21,4,7,57.1,3,4,75,1,3,33.3,0,0,0,2,2,4,2,4,1,0,0,9
472092,523_16_07,SERBIA,15504,12,stefan bircevic,10,2,2,100,1,1,100,1,1,100,0,0,0,0,0,0,0,5,0,0,0,5
472093,523_16_07,SERBIA,2656,13,miroslav raduljica,29,7,13,53.8,7,13,53.8,0,0,0,11,13,84.6,1,0,1,3,4,1,1,0,25
472094,523_16_07,SERBIA,22978,14,nikola jokic,18,3,6,50,3,5,60,0,1,0,1,2,50,1,2,3,2,1,0,1,0,7
472095,523_16_07,SERBIA,5756,15,vladimir stimac,2,0,0,0,0,0,0,0,0,0,0,0,0,0,2,2,0,0,0,0,0,0
472096,523_16_07,SERBIA,25441,24,stefan jovic,13,0,3,0,0,3,0,0,0,0,1,2,50,2,5,7,3,0,0,1,0,1
472097,523_16_07,SERBIA,6241,25,milan macvan,17,1,4,25,1,2,50,0,2,0,2,2,100,0,2,2,3,0,0,0,0,4
472098,523_16_07,SERBIA,0,TOTALS,SERBIA,200,27,69,39.1,22,47,46.8,5,22,22.7,21,26,80.8,12,22,34,23,23,9,6,0,80
472099,523_16_07,AUSTRALIA,9039,4,chris goulding,0,0,0,0,0,0,0,0,0,0,0,0,0,0,0,0,0,0,0,0,0,0
472100,523_16_07,AUSTRALIA,9045,5,patty mills,33,8,17,47.1,6,8,75,2,9,22.2,8,8,100,0,2,2,0,1,4,0,0,26
472101,523_16_07,AUSTRALIA,135,6,andrew bogut,25,3,4,75,2,3,66.7,1,1,100,2,4,50,2,10,12,6,4,2,0,3,9
472102,523_16_07,AUSTRALIA,11635,7,joe ingles,30,2,5,40,0,1,0,2,4,50,4,4,100,0,3,3,5,3,3,1,0,10
472103,523_16_07,AUSTRALIA,13811,8,matthew dellavedova,29,7,8,87.5,4,4,100,3,4,75,6,7,85.7,0,0,0,13,4,0,2,0,23
472104,523_16_07,AUSTRALIA,13813,9,ryan broekhoff,10,1,4,25,1,1,100,0,3,0,2,2,100,0,0,0,0,1,0,0,0,4
472105,523_16_07,AUSTRALIA,25376,10,cameron bairstow,12,1,3,33.3,1,3,33.3,0,0,0,0,2,0,2,1,3,0,2,0,0,0,2
472106,523_16_07,AUSTRALIA,30889,11,kevin lisch,18,0,3,0,0,1,0,0,2,0,2,2,100,1,0,1,0,3,1,1,0,2
472107,523_16_07,AUSTRALIA,16519,12,aron baynes,23,4,10,40,4,10,40,0,0,0,2,2,100,2,5,7,1,2,3,0,0,10
472108,523_16_07,AUSTRALIA,142,13,david andersen,21,4,7,57.1,3,5,60,1,2,50,0,0,0,1,5,6,0,4,0,0,0,9
472109,523_16_07,AUSTRALIA,13814,14,brock motum,0,0,0,0,0,0,0,0,0,0,0,0,0,0,0,0,0,0,0,0,0,0
472110,523_16_07,AUSTRALIA,16520,15,damian martin,0,0,0,0,0,0,0,0,0,0,0,0,0,0,0,0,0,0,0,0,0,0
472111,523_16_07,AUSTRALIA,0,TOTALS,AUSTRALIA,200,30,61,49.2,21,36,58.3,9,25,36,26,31,83.9,9,29,38,25,24,13,4,3,95
472112,523_16_08,USA,30892,4,jimmy butler,20,4,7,57.1,3,5,60,1,2,50,8,8,100,0,1,1,0,2,0,1,0,17
472113,523_16_08,USA,16599,5,kevin durant,25,5,5,100,3,3,100,2,2,100,4,6,66.7,0,2,2,5,1,1,0,1,16
472114,523_16_08,USA,9017,6,deandre jordan,19,6,7,85.7,6,7,85.7,0,0,0,2,4,50,3,6,9,0,2,1,0,0,14
472115,523_16_08,USA,30893,7,kyle lowry,17,1,4,25,1,2,50,0,2,0,3,4,75,2,3,5,9,3,1,0,0,5
472116,523_16_08,USA,30894,8,harrison barnes,7,0,2,0,0,2,0,0,0,0,4,4,100,0,2,2,1,0,0,0,0,4
472117,523_16_08,USA,25452,9,demar derozan,16,3,5,60,3,5,60,0,0,0,2,2,100,1,2,3,1,2,2,1,0,8
472118,523_16_08,USA,16977,10,kyrie irving,20,3,7,42.9,2,4,50,1,3,33.3,0,0,0,0,0,0,3,1,1,0,0,7
472119,523_16_08,USA,13751,11,klay thompson,15,0,5,0,0,1,0,0,4,0,0,0,0,0,2,2,1,2,1,0,0,0
472120,523_16_08,USA,25453,12,demarcus cousins,9,2,4,50,2,4,50,0,0,0,2,2,100,4,1,5,1,5,1,1,0,6
472121,523_16_08,USA,30895,13,paul george,20,6,7,85.7,3,3,100,3,4,75,5,6,83.3,0,4,4,1,2,0,1,0,20
472122,523_16_08,USA,30896,14,draymond green,9,1,2,50,1,1,100,0,1,0,0,0,0,1,3,4,1,2,1,1,0,2
472123,523_16_08,USA,113,15,carmelo anthony,24,5,11,45.5,3,7,42.9,2,4,50,2,2,100,1,2,3,1,1,2,1,0,14
472124,523_16_08,USA,0,TOTALS,USA,200,36,66,54.5,27,44,61.4,9,22,40.9,32,38,84.2,14,28,42,24,23,11,6,1,113
472125,523_16_08,VENEZUELA,9985,0,gregory echenique,26,6,7,85.7,6,7,85.7,0,0,0,6,8,75,4,3,7,2,2,3,0,1,18
472126,523_16_08,VENEZUELA,19023,2,dwight lewis,20,0,4,0,0,2,0,0,2,0,0,0,0,0,2,2,2,3,0,1,0,0
472127,523_16_08,VENEZUELA,514,4,miguel marriaga,1,0,0,0,0,0,0,0,0,0,0,0,0,0,1,1,0,2,0,0,0,0
472128,523_16_08,VENEZUELA,16828,5,gregory vargas,30,4,9,44.4,4,7,57.1,0,2,0,2,2,100,0,0,0,5,3,1,4,0,10
472129,523_16_08,VENEZUELA,21053,6,john cox,31,6,20,30,4,15,26.7,2,5,40,5,7,71.4,1,1,2,1,2,2,1,0,19
472130,523_16_08,VENEZUELA,16829,8,david cubillan,18,3,6,50,1,3,33.3,2,3,66.7,2,2,100,0,2,2,3,4,1,1,0,10
472131,523_16_08,VENEZUELA,9857,10,jose vargas,8,0,3,0,0,2,0,0,1,0,0,0,0,1,1,2,1,1,1,0,0,0
472132,523_16_08,VENEZUELA,25751,14,miguel ruiz,18,1,2,50,1,2,50,0,0,0,0,0,0,2,0,2,0,4,1,0,0,2
472133,523_16_08,VENEZUELA,19026,15,windi graterol,9,0,2,0,0,1,0,0,1,0,0,0,0,1,1,2,0,0,2,0,0,0
472134,523_16_08,VENEZUELA,19021,19,heissler guillent,11,0,3,0,0,1,0,0,2,0,4,4,100,0,0,0,0,1,1,0,0,4
472135,523_16_08,VENEZUELA,12301,23,anthony perez,12,2,6,33.3,1,4,25,1,2,50,0,0,0,0,3,3,0,3,1,1,1,5
472136,523_16_08,VENEZUELA,19022,43,nestor colmenares,15,0,2,0,0,2,0,0,0,0,1,2,50,1,0,1,1,4,1,0,0,1
472137,523_16_08,VENEZUELA,0,TOTALS,VENEZUELA,200,22,64,34.4,17,46,37,5,18,27.8,20,25,80,13,19,32,15,29,18,8,2,69
472138,523_16_09,FRANCE,12495,4,thomas heurtel,14,5,6,83.3,4,5,80,1,1,100,0,0,0,0,1,1,2,1,3,0,0,11
472139,523_16_09,FRANCE,2588,5,nicolas batum,25,3,6,50,2,2,100,1,4,25,0,0,0,2,8,10,3,2,2,1,0,7
472140,523_16_09,FRANCE,2589,6,antoine diot,4,0,0,0,0,0,0,0,0,0,2,2,100,0,1,1,0,0,0,0,0,2
472141,523_16_09,FRANCE,11076,7,joffrey lauvergne,17,3,8,37.5,3,7,42.9,0,1,0,0,0,0,2,2,4,1,2,2,0,0,6
472142,523_16_09,FRANCE,1864,8,charles kahudi,12,2,2,100,2,2,100,0,0,0,0,0,0,2,2,4,1,0,1,0,0,4
472143,523_16_09,FRANCE,5047,9,tony parker,26,3,6,50,2,3,66.7,1,3,33.3,7,8,87.5,0,2,2,8,1,3,0,0,14
472144,523_16_09,FRANCE,4663,11,florent pietrus,12,1,1,100,1,1,100,0,0,0,0,0,0,0,1,1,0,5,1,1,0,2
472145,523_16_09,FRANCE,10428,12,nando de colo,21,5,8,62.5,4,6,66.7,1,2,50,8,8,100,0,1,1,0,3,3,2,0,19
472146,523_16_09,FRANCE,4665,13,boris diaw,21,2,3,66.7,1,2,50,1,1,100,2,3,66.7,1,3,4,5,1,3,0,3,7
472147,523_16_09,FRANCE,5044,15,mickael gelabale,19,2,3,66.7,1,2,50,1,1,100,1,2,50,0,1,1,0,1,1,0,0,6
472148,523_16_09,FRANCE,17374,16,rudy gobert,20,3,4,75,3,4,75,0,0,0,4,8,50,3,5,8,0,3,3,0,5,10
472149,523_16_09,FRANCE,7987,17,kim tillie,10,0,1,0,0,1,0,0,0,0,0,0,0,1,0,1,1,2,1,1,0,0
472150,523_16_09,FRANCE,0,TOTALS,FRANCE,200,29,48,60.4,23,35,65.7,6,13,46.2,24,31,77.4,11,31,42,21,21,23,5,8,88
472151,523_16_09,CHINA,18850,4,jiwei zhao,24,0,2,0,0,0,0,0,2,0,2,2,100,0,1,1,3,5,1,2,0,2
472152,523_16_09,CHINA,30890,5,ran sui,0,0,0,0,0,0,0,0,0,0,0,0,0,0,0,0,0,0,0,0,0,0
472153,523_16_09,CHINA,14374,6,ailun guo,21,3,7,42.9,3,5,60,0,2,0,3,4,75,0,1,1,4,4,2,3,0,9
472154,523_16_09,CHINA,14377,8,yanyuhang ding,10,0,3,0,0,2,0,0,1,0,0,0,0,0,0,0,4,3,0,0,0,0
472155,523_16_09,CHINA,14378,9,xiaochuan zhai,21,1,4,25,1,3,33.3,0,1,0,0,0,0,2,2,4,1,1,0,1,0,2
472156,523_16_09,CHINA,16587,10,peng zhou,34,3,11,27.3,3,6,50,0,5,0,0,0,0,0,2,2,2,4,2,1,1,6
472157,523_16_09,CHINA,56,11,jianlian yi,33,6,18,33.3,3,13,23.1,3,5,60,4,6,66.7,1,5,6,0,4,1,4,1,19
472158,523_16_09,CHINA,28364,12,gen li,13,3,5,60,3,3,100,0,2,0,0,1,0,0,0,0,0,3,1,1,0,6
472159,523_16_09,CHINA,18361,13,muhao li,0,0,0,0,0,0,0,0,0,0,0,0,0,0,0,0,0,0,0,0,0,0
472160,523_16_09,CHINA,30891,14,yuchen zou,5,0,1,0,0,1,0,0,0,0,0,0,0,0,1,1,0,2,0,0,0,0
472161,523_16_09,CHINA,18858,15,qi zhou,18,2,3,66.7,1,2,50,1,1,100,0,0,0,0,0,0,0,2,1,1,1,5
472162,523_16_09,CHINA,16635,31,zhelin wang,22,5,6,83.3,5,6,83.3,0,0,0,1,2,50,0,1,1,0,4,3,1,0,11
472163,523_16_09,CHINA,0,TOTALS,CHINA,200,23,60,38.3,19,41,46.3,4,19,21.1,10,15,66.7,7,13,20,14,32,13,14,3,60
472164,523_16_10,SPAIN,61,4,pau gasol,32,4,11,36.4,4,9,44.4,0,2,0,5,12,41.7,1,9,10,1,3,3,1,4,13
472165,523_16_10,SPAIN,70,5,rudy fernandez,29,2,6,33.3,1,2,50,1,4,25,3,4,75,1,0,1,2,3,1,3,0,8
472166,523_16_10,SPAIN,1877,6,sergio rodriguez,22,3,6,50,1,2,50,2,4,50,2,2,100,0,2,2,5,1,2,0,0,10
472167,523_16_10,SPAIN,64,7,juan-carlos navarro,13,2,5,40,2,3,66.7,0,2,0,1,1,100,0,1,1,0,1,1,0,0,5
472168,523_16_10,SPAIN,65,8,jose manuel calderon,1,0,0,0,0,0,0,0,0,0,0,0,0,0,0,0,0,1,0,0,0,0
472169,523_16_10,SPAIN,66,9,felipe reyes,11,1,5,20,1,5,20,0,0,0,3,4,75,0,2,2,1,1,0,0,0,5
472170,523_16_10,SPAIN,2628,10,victor claver,10,1,1,100,1,1,100,0,0,0,2,2,100,1,3,4,1,3,1,1,0,4
472171,523_16_10,SPAIN,17609,14,willy hernangomez,0,0,0,0,0,0,0,0,0,0,0,0,0,0,0,0,0,0,0,0,0,0
472172,523_16_10,SPAIN,19988,21,alex abrines,2,0,0,0,0,0,0,0,0,0,0,0,0,0,0,0,0,0,0,0,0,0
472173,523_16_10,SPAIN,1871,23,sergio llull,31,3,7,42.9,1,4,25,2,3,66.7,3,4,75,0,3,3,0,3,3,1,0,11
472174,523_16_10,SPAIN,17234,44,nikola mirotic,33,2,8,25,2,4,50,0,4,0,2,2,100,3,5,8,2,2,0,0,1,6
472175,523_16_10,SPAIN,6259,79,ricky rubio,17,1,3,33.3,1,3,33.3,0,0,0,1,2,50,2,2,4,0,5,2,0,0,3
472176,523_16_10,SPAIN,0,TOTALS,SPAIN,200,19,52,36.5,14,33,42.4,5,19,26.3,22,33,66.7,12,30,42,12,23,13,6,5,65
472177,523_16_10,BRAZIL,14848,5,raulzinho neto,9,1,4,25,0,1,0,1,3,33.3,0,0,0,0,1,1,2,3,1,0,0,3
472178,523_16_10,BRAZIL,16960,6,cristiano felicio,12,2,3,66.7,2,3,66.7,0,0,0,3,3,100,1,1,2,0,3,0,0,1,7
472179,523_16_10,BRAZIL,7625,8,vitor benite,16,1,3,33.3,0,1,0,1,2,50,1,2,50,0,1,1,0,2,1,2,0,4
472180,523_16_10,BRAZIL,4098,9,marcelinho huertas,31,4,10,40,3,9,33.3,1,1,100,2,2,100,0,4,4,7,2,0,0,0,11
472181,523_16_10,BRAZIL,4102,10,alex garcia,18,3,8,37.5,3,6,50,0,2,0,3,3,100,0,4,4,2,2,3,0,0,9
472182,523_16_10,BRAZIL,4104,12,guilherme giovannoni,9,1,2,50,0,1,0,1,1,100,0,0,0,0,2,2,1,3,1,0,0,3
472183,523_16_10,BRAZIL,9844,13,nene hilario,22,1,5,20,1,4,25,0,1,0,4,8,50,0,4,4,5,4,3,1,0,6
472184,523_16_10,BRAZIL,9845,14,marcus vinicius marquinhos,21,5,9,55.6,5,8,62.5,0,1,0,0,0,0,2,3,5,1,3,0,0,0,10
472185,523_16_10,BRAZIL,4100,19,leandro barbosa,25,2,8,25,2,5,40,0,3,0,0,0,0,0,0,0,1,3,1,0,0,4
472186,523_16_10,BRAZIL,19019,23,augusto lima,28,3,6,50,3,6,50,0,0,0,3,3,100,4,6,10,0,4,0,0,0,9
472187,523_16_10,BRAZIL,23752,30,rafael hettsheimeir,9,0,2,0,0,1,0,0,1,0,0,0,0,0,0,0,0,2,0,0,0,0
472188,523_16_10,BRAZIL,7622,55,rafael luz,0,0,0,0,0,0,0,0,0,0,0,0,0,0,0,0,0,0,0,0,0,0
472189,523_16_10,BRAZIL,0,TOTALS,BRAZIL,200,23,60,38.3,19,45,42.2,4,15,26.7,16,21,76.2,9,26,35,19,31,10,3,1,66
472190,523_16_11,LITHUANIA,1726,5,mantas kalnietis,31,5,8,62.5,4,5,80,1,3,33.3,10,12,83.3,1,3,4,12,1,2,1,1,21
472191,523_16_11,LITHUANIA,6225,7,adas juskevicius,0,0,0,0,0,0,0,0,0,0,0,0,0,0,0,0,0,0,0,0,0,0
472192,523_16_11,LITHUANIA,980,8,jonas maciulis,29,8,14,57.1,5,11,45.5,3,3,100,2,2,100,0,4,4,2,0,2,1,1,21
472193,523_16_11,LITHUANIA,3474,10,renaldas seibutis,26,5,9,55.6,3,6,50,2,3,66.7,0,0,0,1,2,3,2,2,0,2,0,12
472194,523_16_11,LITHUANIA,22216,11,domantas sabonis,25,4,7,57.1,4,6,66.7,0,1,0,0,0,0,2,5,7,1,1,1,3,0,8
472195,523_16_11,LITHUANIA,3476,12,antanas kavaliauskas,7,1,1,100,1,1,100,0,0,0,0,0,0,1,0,1,0,0,0,0,0,2
472196,523_16_11,LITHUANIA,987,13,paulius jankunas,21,3,6,50,2,3,66.7,1,3,33.3,0,0,0,1,3,4,0,4,0,0,1,7
472197,523_16_11,LITHUANIA,24,15,robertas javtokas,0,0,0,0,0,0,0,0,0,0,0,0,0,0,0,0,0,0,0,0,0,0
472198,523_16_11,LITHUANIA,10916,17,jonas valanciunas,24,3,5,60,3,5,60,0,0,0,4,4,100,1,4,5,0,4,3,0,3,10
472199,523_16_11,LITHUANIA,10639,19,mindaugas kuzminskas,15,3,5,60,2,3,66.7,1,2,50,1,2,50,2,3,5,2,2,2,0,0,8
472200,523_16_11,LITHUANIA,17690,40,marius grigonis,14,0,5,0,0,1,0,0,4,0,0,0,0,1,0,1,2,1,1,1,0,0
472201,523_16_11,LITHUANIA,15948,93,vaidas kariniauskas,9,0,5,0,0,4,0,0,1,0,0,0,0,0,0,0,2,1,1,0,0,0
472202,523_16_11,LITHUANIA,0,TOTALS,LITHUANIA,200,32,65,49.2,24,45,53.3,8,20,40,17,20,85,14,24,38,23,16,14,8,6,89
472203,523_16_11,NIGERIA,23139,4,ben uzoh,21,4,10,40,4,10,40,0,0,0,0,0,0,0,0,0,3,5,0,1,1,8
472204,523_16_11,NIGERIA,13976,5,michael umeh,26,7,9,77.8,4,5,80,3,4,75,0,0,0,0,2,2,4,0,2,1,0,17
472205,523_16_11,NIGERIA,21026,6,ike diogu,29,5,11,45.5,2,5,40,3,6,50,6,8,75,3,4,7,1,3,3,3,1,19
472206,523_16_11,NIGERIA,6814,7,ebi ere,29,1,5,20,1,3,33.3,0,2,0,0,0,0,0,1,1,4,2,2,0,0,2
472207,523_16_11,NIGERIA,6813,8,josh akognon,15,3,9,33.3,2,6,33.3,1,3,33.3,0,0,0,0,1,1,0,4,1,0,0,7
472208,523_16_11,NIGERIA,3647,9,chamberlain oguchi,29,2,8,25,1,3,33.3,1,5,20,0,0,0,0,6,6,3,1,4,1,0,5
472209,523_16_11,NIGERIA,23140,10,stan okoye,0,0,0,0,0,0,0,0,0,0,0,0,0,0,0,0,0,0,0,0,0,0
472210,523_16_11,NIGERIA,23143,11,andy ogide,16,2,3,66.7,1,1,100,1,2,50,0,0,0,0,0,0,0,1,0,0,1,5
472211,523_16_11,NIGERIA,28095,12,michael gbinije,0,0,0,0,0,0,0,0,0,0,0,0,0,0,0,0,0,0,0,0,0,0
472212,523_16_11,NIGERIA,30897,13,shane lawal,0,0,0,0,0,0,0,0,0,0,0,0,0,0,0,0,0,0,0,0,0,0
472213,523_16_11,NIGERIA,21031,14,alade aminu,22,5,7,71.4,5,7,71.4,0,0,0,2,2,100,0,2,2,0,1,0,0,0,12
472214,523_16_11,NIGERIA,21025,15,ekene ibekwe,14,2,3,66.7,1,2,50,1,1,100,0,0,0,1,2,3,1,5,2,0,1,5
472215,523_16_11,NIGERIA,0,TOTALS,NIGERIA,200,31,65,47.7,21,42,50,10,23,43.5,8,10,80,8,21,29,16,22,15,6,4,80
472216,523_16_12,ARGENTINA,80,4,luis scola,36,8,15,53.3,5,10,50,3,5,60,4,9,44.4,2,7,9,0,3,4,1,1,23
472217,523_16_12,ARGENTINA,74,5,manu ginobili,19,2,5,40,1,1,100,1,4,25,8,9,88.9,0,1,1,2,4,0,1,0,13
472218,523_16_12,ARGENTINA,21037,7,facundo campazzo,29,4,13,30.8,3,4,75,1,9,11.1,1,2,50,1,3,4,8,3,5,2,0,10
472219,523_16_12,ARGENTINA,12228,8,nicolas laprovittola,17,5,6,83.3,2,2,100,3,4,75,0,0,0,1,2,3,4,2,2,0,0,13
472220,523_16_12,ARGENTINA,25732,9,nicolas brussino,0,0,0,0,0,0,0,0,0,0,0,0,0,0,0,0,0,0,0,0,0,0
472221,523_16_12,ARGENTINA,83,10,carlos delfino,23,3,9,33.3,2,5,40,1,4,25,0,0,0,0,2,2,1,1,0,0,0,7
472222,523_16_12,ARGENTINA,14903,12,marcos delia,4,1,1,100,1,1,100,0,0,0,0,0,0,0,1,1,0,1,0,0,0,2
472223,523_16_12,ARGENTINA,82,13,andres nocioni,31,3,12,25,1,9,11.1,2,3,66.7,3,3,100,1,4,5,0,4,2,0,0,11
472224,523_16_12,ARGENTINA,15007,14,gabriel deck,8,2,3,66.7,2,3,66.7,0,0,0,0,1,0,2,0,2,0,1,0,1,0,4
472225,523_16_12,ARGENTINA,459,19,leo mainoldi,0,0,0,0,0,0,0,0,0,0,0,0,0,0,0,0,0,0,0,0,0,0
472226,523_16_12,ARGENTINA,12296,29,patricio garino,25,2,5,40,1,2,50,1,3,33.3,0,0,0,1,3,4,1,2,1,0,0,5
472227,523_16_12,ARGENTINA,30898,35,roberto acuna,8,1,1,100,1,1,100,0,0,0,0,0,0,2,2,4,1,0,0,0,3,2
472228,523_16_12,ARGENTINA,0,TOTALS,ARGENTINA,200,31,70,44.3,19,38,50,12,32,37.5,16,24,66.7,11,28,39,17,21,14,5,4,90
472229,523_16_12,CROATIA,13759,4,luka babic,23,3,5,60,1,2,50,2,3,66.7,0,0,0,0,2,2,5,2,1,2,1,8
472230,523_16_12,CROATIA,7990,5,filip kruslin,0,0,0,0,0,0,0,0,0,0,0,0,0,0,0,0,0,0,0,0,0,0
472231,523_16_12,CROATIA,1915,6,rok stipcevic,4,0,1,0,0,0,0,0,1,0,0,0,0,0,0,0,0,0,0,0,0,0
472232,523_16_12,CROATIA,1249,7,krunoslav simon,27,3,12,25,1,3,33.3,2,9,22.2,0,0,0,2,3,5,6,3,4,2,0,8
472233,523_16_12,CROATIA,18415,8,mario hezonja,25,6,9,66.7,2,3,66.7,4,6,66.7,0,0,0,0,3,3,1,3,1,0,1,16
472234,523_16_12,CROATIA,15894,9,dario saric,35,7,16,43.8,7,12,58.3,0,4,0,5,8,62.5,2,8,10,7,4,1,0,0,19
472235,523_16_12,CROATIA,4585,10,roko ukic,21,1,5,20,1,3,33.3,0,2,0,0,0,0,1,2,3,3,3,0,0,0,2
472236,523_16_12,CROATIA,12600,12,darko planinic,18,3,4,75,3,4,75,0,0,0,1,2,50,4,3,7,0,0,0,0,0,7
472237,523_16_12,CROATIA,10624,15,miro bilan,12,2,4,50,2,4,50,0,0,0,0,0,0,1,2,3,0,4,2,1,0,4
472238,523_16_12,CROATIA,7991,33,zeljko sakic,5,0,1,0,0,1,0,0,0,0,0,0,0,0,0,0,0,0,1,0,0,0
472239,523_16_12,CROATIA,20277,35,marko arapovic,0,0,0,0,0,0,0,0,0,0,0,0,0,0,0,0,0,0,0,0,0,0
472240,523_16_12,CROATIA,6280,44,bojan bogdanovic,29,5,13,38.5,4,7,57.1,1,6,16.7,7,11,63.6,0,7,7,2,3,3,0,1,18
472241,523_16_12,CROATIA,0,TOTALS,CROATIA,200,30,70,42.9,21,39,53.8,9,31,29,13,21,61.9,12,31,43,24,24,14,5,3,82
472242,523_16_13,SERBIA,5751,4,milos teodosic,32,3,12,25,1,5,20,2,7,28.6,2,2,100,0,2,2,9,3,2,1,0,10
472243,523_16_13,SERBIA,2100,5,marko simonovic,11,4,5,80,3,3,100,1,2,50,0,0,0,0,2,2,0,1,1,0,0,9
472244,523_16_13,SERBIA,17361,7,bogdan bogdanovic,27,3,7,42.9,0,3,0,3,4,75,1,2,50,0,4,4,2,0,3,2,0,10
472245,523_16_13,SERBIA,2654,9,stefan markovic,25,2,8,25,1,3,33.3,1,5,20,2,2,100,0,3,3,1,1,0,1,0,7
472246,523_16_13,SERBIA,19860,10,nikola kalinic,14,2,2,100,2,2,100,0,0,0,0,0,0,0,0,0,1,3,1,0,0,4
472247,523_16_13,SERBIA,15503,11,nemanja nedovic,12,1,3,33.3,0,2,0,1,1,100,2,2,100,0,1,1,3,0,4,2,0,5
472248,523_16_13,SERBIA,15504,12,stefan bircevic,3,0,0,0,0,0,0,0,0,0,0,0,0,0,0,0,0,1,0,0,0,0
472249,523_16_13,SERBIA,2656,13,miroslav raduljica,24,7,9,77.8,7,9,77.8,0,0,0,2,4,50,1,2,3,1,4,0,0,2,16
472250,523_16_13,SERBIA,22978,14,nikola jokic,21,1,4,25,1,1,100,0,3,0,0,0,0,0,7,7,4,4,1,1,0,2
472251,523_16_13,SERBIA,5756,15,vladimir stimac,12,2,5,40,2,5,40,0,0,0,1,2,50,2,1,3,0,4,2,1,1,5
472252,523_16_13,SERBIA,25441,24,stefan jovic,9,2,2,100,1,1,100,1,1,100,0,0,0,1,0,1,1,0,1,0,0,5
472253,523_16_13,SERBIA,6241,25,milan macvan,10,1,3,33.3,1,2,50,0,1,0,0,0,0,0,2,2,0,3,0,0,0,2
472254,523_16_13,SERBIA,0,TOTALS,SERBIA,200,28,60,46.7,19,36,52.8,9,24,37.5,10,14,71.4,8,24,32,22,24,16,8,3,75
472255,523_16_13,FRANCE,12495,4,thomas heurtel,18,2,6,33.3,1,3,33.3,1,3,33.3,0,0,0,0,4,4,3,0,0,2,0,5
472256,523_16_13,FRANCE,2588,5,nicolas batum,27,4,9,44.4,1,5,20,3,4,75,0,0,0,0,1,1,3,1,1,2,0,11
472257,523_16_13,FRANCE,2589,6,antoine diot,7,0,2,0,0,1,0,0,1,0,0,0,0,0,1,1,0,0,0,1,0,0
472258,523_16_13,FRANCE,11076,7,joffrey lauvergne,17,6,11,54.5,6,10,60,0,1,0,0,0,0,0,2,2,0,3,1,0,0,12
472259,523_16_13,FRANCE,1864,8,charles kahudi,6,0,0,0,0,0,0,0,0,0,0,0,0,0,1,1,0,1,1,0,0,0
472260,523_16_13,FRANCE,5047,9,tony parker,22,3,5,60,3,5,60,0,0,0,0,0,0,0,1,1,2,2,3,2,0,6
472261,523_16_13,FRANCE,4663,11,florent pietrus,11,0,2,0,0,1,0,0,1,0,1,2,50,0,1,1,1,3,1,0,0,1
472262,523_16_13,FRANCE,10428,12,nando de colo,30,6,10,60,4,6,66.7,2,4,50,8,8,100,1,1,2,1,3,2,3,0,22
472263,523_16_13,FRANCE,4665,13,boris diaw,29,3,5,60,3,5,60,0,0,0,5,6,83.3,2,7,9,9,3,3,0,0,11
472264,523_16_13,FRANCE,5044,15,mickael gelabale,10,1,3,33.3,0,1,0,1,2,50,2,2,100,0,0,0,0,1,0,0,0,5
472265,523_16_13,FRANCE,17374,16,rudy gobert,23,0,1,0,0,1,0,0,0,0,3,6,50,3,3,6,1,2,1,1,2,3
472266,523_16_13,FRANCE,7987,17,kim tillie,0,0,0,0,0,0,0,0,0,0,0,0,0,0,0,0,0,0,0,0,0,0
472267,523_16_13,FRANCE,0,TOTALS,FRANCE,200,25,54,46.3,18,38,47.4,7,16,43.8,19,24,79.2,7,24,31,20,19,14,11,2,76
472268,523_16_14,AUSTRALIA,9039,4,chris goulding,8,0,2,0,0,1,0,0,1,0,0,0,0,0,2,2,2,1,0,1,0,0
472269,523_16_14,AUSTRALIA,9045,5,patty mills,34,11,22,50,6,11,54.5,5,11,45.5,3,4,75,0,2,2,0,2,2,0,0,30
472270,523_16_14,AUSTRALIA,135,6,andrew bogut,26,7,9,77.8,7,9,77.8,0,0,0,1,2,50,0,1,1,3,2,2,1,3,15
472271,523_16_14,AUSTRALIA,11635,7,joe ingles,24,3,6,50,2,3,66.7,1,3,33.3,0,0,0,0,3,3,1,5,0,0,0,7
472272,523_16_14,AUSTRALIA,13811,8,matthew dellavedova,32,5,8,62.5,5,7,71.4,0,1,0,1,1,100,1,5,6,11,4,4,0,0,11
472273,523_16_14,AUSTRALIA,13813,9,ryan broekhoff,19,0,2,0,0,0,0,0,2,0,2,2,100,0,4,4,4,0,1,0,0,2
472274,523_16_14,AUSTRALIA,25376,10,cameron bairstow,14,2,4,50,2,3,66.7,0,1,0,2,2,100,0,5,5,0,3,0,1,1,6
472275,523_16_14,AUSTRALIA,30889,11,kevin lisch,2,0,1,0,0,0,0,0,1,0,0,0,0,1,0,1,0,0,0,0,0,0
472276,523_16_14,AUSTRALIA,16519,12,aron baynes,17,0,5,0,0,5,0,0,0,0,4,4,100,2,1,3,1,4,1,0,0,4
472277,523_16_14,AUSTRALIA,142,13,david andersen,18,5,6,83.3,4,5,80,1,1,100,2,3,66.7,0,5,5,1,4,4,0,0,13
472278,523_16_14,AUSTRALIA,13814,14,brock motum,2,0,1,0,0,1,0,0,0,0,0,0,0,0,1,1,0,0,0,0,0,0
472279,523_16_14,AUSTRALIA,16520,15,damian martin,3,0,0,0,0,0,0,0,0,0,0,0,0,0,0,0,0,0,1,1,0,0
472280,523_16_14,AUSTRALIA,0,TOTALS,AUSTRALIA,200,33,66,50,26,45,57.8,7,21,33.3,15,18,83.3,8,32,40,23,25,17,4,4,88
472281,523_16_14,USA,30892,4,jimmy butler,6,0,3,0,0,1,0,0,2,0,0,0,0,1,0,1,0,1,0,0,0,0
472282,523_16_14,USA,16599,5,kevin durant,34,4,16,25,2,12,16.7,2,4,50,4,4,100,1,4,5,1,1,2,0,2,14
472283,523_16_14,USA,9017,6,deandre jordan,21,1,1,100,1,1,100,0,0,0,1,3,33.3,1,3,4,0,4,1,0,1,3
472284,523_16_14,USA,30893,7,kyle lowry,16,2,6,33.3,2,6,33.3,0,0,0,3,3,100,2,0,2,4,2,0,1,0,7
472285,523_16_14,USA,30894,8,harrison barnes,0,0,0,0,0,0,0,0,0,0,0,0,0,0,0,0,0,0,0,0,0,0
472286,523_16_14,USA,25452,9,demar derozan,3,0,0,0,0,0,0,0,0,0,0,0,0,0,0,0,0,0,0,1,0,0
472287,523_16_14,USA,16977,10,kyrie irving,22,7,15,46.7,5,10,50,2,5,40,3,4,75,1,1,2,5,3,2,1,0,19
472288,523_16_14,USA,13751,11,klay thompson,23,2,9,22.2,0,3,0,2,6,33.3,0,0,0,1,3,4,2,3,1,0,0,6
472289,523_16_14,USA,25453,12,demarcus cousins,10,3,5,60,3,5,60,0,0,0,0,0,0,4,4,8,1,4,0,0,0,6
472290,523_16_14,USA,30895,13,paul george,17,2,6,33.3,1,3,33.3,1,3,33.3,0,0,0,2,1,3,2,2,1,0,1,5
472291,523_16_14,USA,30896,14,draymond green,13,2,5,40,1,1,100,1,4,25,2,3,66.7,1,1,2,1,1,0,2,0,7
472292,523_16_14,USA,113,15,carmelo anthony,35,11,21,52.4,2,6,33.3,9,15,60,0,1,0,2,6,8,1,3,0,2,0,31
472293,523_16_14,USA,0,TOTALS,USA,200,34,87,39.1,17,48,35.4,17,39,43.6,13,18,72.2,21,26,47,17,24,9,7,4,98
472294,523_16_15,VENEZUELA,9985,0,gregory echenique,19,1,2,50,1,2,50,0,0,0,2,2,100,0,2,2,2,2,2,1,0,4
472295,523_16_15,VENEZUELA,19023,2,dwight lewis,9,0,1,0,0,0,0,0,1,0,0,0,0,1,0,1,0,1,0,0,0,0
472296,523_16_15,VENEZUELA,514,4,miguel marriaga,5,0,2,0,0,2,0,0,0,0,0,0,0,1,0,1,1,1,0,0,0,0
472297,523_16_15,VENEZUELA,16828,5,gregory vargas,24,2,7,28.6,1,5,20,1,2,50,8,8,100,0,3,3,5,2,2,1,0,13
472298,523_16_15,VENEZUELA,21053,6,john cox,20,1,10,10,0,8,0,1,2,50,2,2,100,2,1,3,1,3,2,0,0,5
472299,523_16_15,VENEZUELA,16829,8,david cubillan,14,1,2,50,0,0,0,1,2,50,0,0,0,0,1,1,2,1,1,0,0,3
472300,523_16_15,VENEZUELA,9857,10,jose vargas,32,4,8,50,2,2,100,2,6,33.3,0,0,0,0,3,3,4,5,1,1,1,10
472301,523_16_15,VENEZUELA,25751,14,miguel ruiz,19,2,2,100,2,2,100,0,0,0,1,2,50,1,3,4,0,3,1,2,0,5
472302,523_16_15,VENEZUELA,19026,15,windi graterol,3,0,0,0,0,0,0,0,0,0,0,0,0,1,0,1,0,0,0,0,0,0
472303,523_16_15,VENEZUELA,19021,19,heissler guillent,13,2,4,50,2,3,66.7,0,1,0,5,6,83.3,0,0,0,2,3,2,2,0,9
472304,523_16_15,VENEZUELA,12301,23,anthony perez,15,3,4,75,2,2,100,1,2,50,0,1,0,0,0,0,0,2,1,1,0,7
472305,523_16_15,VENEZUELA,19022,43,nestor colmenares,26,8,11,72.7,8,10,80,0,1,0,0,0,0,4,1,5,4,4,1,0,0,16
472306,523_16_15,VENEZUELA,0,TOTALS,VENEZUELA,200,24,53,45.3,18,36,50,6,17,35.3,18,21,85.7,12,14,26,21,27,16,8,1,72
472307,523_16_15,CHINA,18850,4,jiwei zhao,15,0,2,0,0,0,0,0,2,0,2,2,100,0,2,2,2,0,1,0,0,2
472308,523_16_15,CHINA,30890,5,ran sui,1,0,0,0,0,0,0,0,0,0,0,0,0,0,0,0,0,1,0,0,0,0
472309,523_16_15,CHINA,14374,6,ailun guo,25,5,9,55.6,4,6,66.7,1,3,33.3,6,9,66.7,0,2,2,3,5,3,1,0,17
472310,523_16_15,CHINA,14377,8,yanyuhang ding,9,3,5,60,2,2,100,1,3,33.3,0,0,0,0,0,0,0,2,0,0,0,7
472311,523_16_15,CHINA,14378,9,xiaochuan zhai,21,1,4,25,1,3,33.3,0,1,0,0,0,0,2,0,2,0,2,1,0,0,2
472312,523_16_15,CHINA,16587,10,peng zhou,34,2,5,40,2,4,50,0,1,0,2,3,66.7,0,2,2,3,4,3,1,0,6
472313,523_16_15,CHINA,56,11,jianlian yi,34,6,13,46.2,6,13,46.2,0,0,0,6,8,75,3,7,10,1,1,0,3,0,18
472314,523_16_15,CHINA,28364,12,gen li,15,1,1,100,1,1,100,0,0,0,0,0,0,0,0,0,0,1,0,0,0,2
472315,523_16_15,CHINA,18361,13,muhao li,0,0,0,0,0,0,0,0,0,0,0,0,0,0,0,0,0,0,0,0,0,0
472316,523_16_15,CHINA,30891,14,yuchen zou,10,0,0,0,0,0,0,0,0,0,3,4,75,0,3,3,0,0,1,0,1,3
472317,523_16_15,CHINA,18858,15,qi zhou,26,4,5,80,4,4,100,0,1,0,3,7,42.9,2,0,2,0,3,5,2,2,11
472318,523_16_15,CHINA,16635,31,zhelin wang,11,0,1,0,0,1,0,0,0,0,0,0,0,0,0,0,0,1,1,0,0,0
472319,523_16_15,CHINA,0,TOTALS,CHINA,200,22,45,48.9,20,34,58.8,2,11,18.2,22,33,66.7,9,17,26,9,20,16,7,3,68
472320,523_16_16,BRAZIL,14848,5,raulzinho neto,14,0,4,0,0,3,0,0,1,0,0,0,0,0,0,0,0,2,1,1,0,0
472321,523_16_16,BRAZIL,16960,6,cristiano felicio,10,0,2,0,0,2,0,0,0,0,0,0,0,2,2,4,0,2,0,0,0,0
472322,523_16_16,BRAZIL,7625,8,vitor benite,6,2,3,66.7,2,2,100,0,1,0,1,1,100,0,1,1,0,2,0,0,0,5
472323,523_16_16,BRAZIL,4098,9,marcelinho huertas,26,3,5,60,1,3,33.3,2,2,100,2,2,100,0,2,2,9,1,0,2,0,10
472324,523_16_16,BRAZIL,4102,10,alex garcia,18,2,3,66.7,1,1,100,1,2,50,1,2,50,3,1,4,2,3,1,0,0,6
472325,523_16_16,BRAZIL,4104,12,guilherme giovannoni,10,3,4,75,1,1,100,2,3,66.7,3,3,100,2,1,3,0,2,1,0,0,11
472326,523_16_16,BRAZIL,9844,13,nene hilario,31,2,10,20,2,10,20,0,0,0,1,2,50,0,2,2,2,2,2,3,0,5
472327,523_16_16,BRAZIL,9845,14,marcus vinicius marquinhos,22,4,7,57.1,1,1,100,3,6,50,1,2,50,1,2,3,3,2,1,0,0,12
472328,523_16_16,BRAZIL,4100,19,leandro barbosa,34,7,18,38.9,5,10,50,2,8,25,0,0,0,0,3,3,4,3,2,1,0,16
472329,523_16_16,BRAZIL,19019,23,augusto lima,22,5,8,62.5,5,8,62.5,0,0,0,1,1,100,3,3,6,2,1,1,0,0,11
472330,523_16_16,BRAZIL,23752,30,rafael hettsheimeir,7,0,4,0,0,1,0,0,3,0,0,0,0,0,0,0,0,0,0,0,0,0
472331,523_16_16,BRAZIL,7622,55,rafael luz,1,0,0,0,0,0,0,0,0,0,0,0,0,0,0,0,0,0,0,0,0,0
472332,523_16_16,BRAZIL,0,TOTALS,BRAZIL,200,28,68,41.2,18,42,42.9,10,26,38.5,10,13,76.9,13,17,30,22,20,9,7,0,76
472333,523_16_16,CROATIA,13759,4,luka babic,15,1,2,50,1,1,100,0,1,0,0,0,0,1,3,4,3,0,0,0,0,2
472334,523_16_16,CROATIA,7990,5,filip kruslin,0,0,0,0,0,0,0,0,0,0,0,0,0,0,0,0,0,0,0,0,0,0
472335,523_16_16,CROATIA,1915,6,rok stipcevic,0,0,0,0,0,0,0,0,0,0,0,0,0,0,0,0,0,0,0,0,0,0
472336,523_16_16,CROATIA,1249,7,krunoslav simon,27,2,7,28.6,0,3,0,2,4,50,0,0,0,1,3,4,3,3,1,0,0,6
472337,523_16_16,CROATIA,18415,8,mario hezonja,25,2,3,66.7,0,0,0,2,3,66.7,0,0,0,0,2,2,1,1,2,1,0,6
472338,523_16_16,CROATIA,15894,9,dario saric,35,5,11,45.5,2,6,33.3,3,5,60,2,2,100,3,4,7,3,4,6,1,1,15
472339,523_16_16,CROATIA,4585,10,roko ukic,21,3,5,60,2,2,100,1,3,33.3,0,0,0,0,0,0,4,4,1,1,0,7
472340,523_16_16,CROATIA,12600,12,darko planinic,18,1,1,100,1,1,100,0,0,0,3,4,75,1,4,5,0,1,0,0,0,5
472341,523_16_16,CROATIA,10624,15,miro bilan,21,3,7,42.9,3,7,42.9,0,0,0,0,0,0,1,3,4,1,2,1,1,0,6
472342,523_16_16,CROATIA,7991,33,zeljko sakic,0,0,0,0,0,0,0,0,0,0,0,0,0,0,0,0,0,0,0,0,0,0
472343,523_16_16,CROATIA,20277,35,marko arapovic,0,0,0,0,0,0,0,0,0,0,0,0,0,0,0,0,0,0,0,0,0,0
472344,523_16_16,CROATIA,6280,44,bojan bogdanovic,38,10,16,62.5,7,10,70,3,6,50,10,11,90.9,0,6,6,3,2,4,0,0,33
472345,523_16_16,CROATIA,0,TOTALS,CROATIA,200,27,52,51.9,16,30,53.3,11,22,50,15,17,88.2,8,27,35,18,17,17,4,1,80
472346,523_16_17,NIGERIA,23139,4,ben uzoh,22,2,6,33.3,2,6,33.3,0,0,0,4,6,66.7,0,0,0,7,4,3,1,0,8
472347,523_16_17,NIGERIA,13976,5,michael umeh,19,2,5,40,1,2,50,1,3,33.3,0,0,0,0,2,2,1,2,2,0,0,5
472348,523_16_17,NIGERIA,21026,6,ike diogu,28,1,4,25,1,2,50,0,2,0,5,6,83.3,2,5,7,3,1,1,0,1,7
472349,523_16_17,NIGERIA,6814,7,ebi ere,15,0,4,0,0,1,0,0,3,0,0,0,0,0,0,0,0,1,2,0,0,0
472350,523_16_17,NIGERIA,6813,8,josh akognon,21,4,10,40,1,2,50,3,8,37.5,1,1,100,0,5,5,4,2,1,0,0,12
472351,523_16_17,NIGERIA,3647,9,chamberlain oguchi,27,7,12,58.3,0,0,0,7,12,58.3,3,3,100,1,2,3,4,2,3,2,0,24
472352,523_16_17,NIGERIA,23140,10,stan okoye,0,0,0,0,0,0,0,0,0,0,0,0,0,0,0,0,0,0,0,0,0,0
472353,523_16_17,NIGERIA,23143,11,andy ogide,14,2,3,66.7,2,3,66.7,0,0,0,0,0,0,1,1,2,0,2,0,0,0,4
472354,523_16_17,NIGERIA,28095,12,michael gbinije,16,3,3,100,2,2,100,1,1,100,0,0,0,1,1,2,1,1,0,1,0,7
472355,523_16_17,NIGERIA,30897,13,shane lawal,0,0,0,0,0,0,0,0,0,0,0,0,0,0,0,0,0,0,0,0,0,0
472356,523_16_17,NIGERIA,21031,14,alade aminu,18,4,7,57.1,4,6,66.7,0,1,0,1,2,50,1,3,4,0,5,1,1,2,9
472357,523_16_17,NIGERIA,21025,15,ekene ibekwe,21,4,9,44.4,3,4,75,1,5,20,2,3,66.7,1,4,5,0,4,1,0,3,11
472358,523_16_17,NIGERIA,0,TOTALS,NIGERIA,200,29,63,46,16,28,57.1,13,35,37.1,16,21,76.2,7,26,33,20,24,14,5,6,87
472359,523_16_17,SPAIN,61,4,pau gasol,23,7,15,46.7,7,14,50,0,1,0,2,3,66.7,3,4,7,3,3,2,0,2,16
472360,523_16_17,SPAIN,70,5,rudy fernandez,26,4,9,44.4,1,2,50,3,7,42.9,2,5,40,1,4,5,2,2,0,2,0,13
472361,523_16_17,SPAIN,1877,6,sergio rodriguez,13,2,4,50,1,3,33.3,1,1,100,0,0,0,1,2,3,3,2,1,0,0,5
472362,523_16_17,SPAIN,64,7,juan-carlos navarro,17,4,9,44.4,1,4,25,3,5,60,0,0,0,0,0,0,1,1,0,0,0,11
472363,523_16_17,SPAIN,65,8,jose manuel calderon,6,0,1,0,0,0,0,0,1,0,0,0,0,0,1,1,2,1,1,0,0,0
472364,523_16_17,SPAIN,66,9,felipe reyes,23,2,3,66.7,2,3,66.7,0,0,0,5,6,83.3,3,6,9,1,3,1,1,0,9
472365,523_16_17,SPAIN,2628,10,victor claver,7,0,2,0,0,0,0,0,2,0,0,0,0,0,0,0,0,1,1,0,0,0
472366,523_16_17,SPAIN,17609,14,willy hernangomez,16,5,6,83.3,5,6,83.3,0,0,0,1,1,100,0,3,3,0,3,0,0,0,11
472367,523_16_17,SPAIN,19988,21,alex abrines,0,0,0,0,0,0,0,0,0,0,0,0,0,0,0,0,0,0,0,0,0,0
472368,523_16_17,SPAIN,1871,23,sergio llull,29,2,5,40,1,2,50,1,3,33.3,4,4,100,1,1,2,5,3,2,0,0,9
472369,523_16_17,SPAIN,17234,44,nikola mirotic,17,2,3,66.7,1,1,100,1,2,50,2,2,100,1,4,5,2,1,2,1,0,7
472370,523_16_17,SPAIN,6259,79,ricky rubio,22,5,11,45.5,5,7,71.4,0,4,0,5,5,100,1,3,4,4,2,1,1,0,15
472371,523_16_17,SPAIN,0,TOTALS,SPAIN,200,33,68,48.5,24,42,57.1,9,26,34.6,21,26,80.8,13,30,43,23,22,11,5,2,96
472372,523_16_18,LITHUANIA,1726,5,mantas kalnietis,37,7,13,53.8,5,7,71.4,2,6,33.3,1,1,100,2,3,5,7,1,3,1,0,17
472373,523_16_18,LITHUANIA,6225,7,adas juskevicius,2,0,0,0,0,0,0,0,0,0,0,0,0,0,0,0,0,1,1,0,0,0
472374,523_16_18,LITHUANIA,980,8,jonas maciulis,27,4,11,36.4,2,5,40,2,6,33.3,0,0,0,1,5,6,1,2,6,0,0,10
472375,523_16_18,LITHUANIA,3474,10,renaldas seibutis,16,2,7,28.6,2,5,40,0,2,0,5,5,100,1,2,3,0,4,0,0,0,9
472376,523_16_18,LITHUANIA,22216,11,domantas sabonis,19,2,5,40,2,4,50,0,1,0,3,5,60,1,5,6,1,3,1,2,2,7
472377,523_16_18,LITHUANIA,3476,12,antanas kavaliauskas,3,0,0,0,0,0,0,0,0,0,0,0,0,0,0,0,0,1,0,0,0,0
472378,523_16_18,LITHUANIA,987,13,paulius jankunas,18,0,6,0,0,4,0,0,2,0,2,2,100,0,6,6,1,2,0,1,0,2
472379,523_16_18,LITHUANIA,24,15,robertas javtokas,0,0,0,0,0,0,0,0,0,0,0,0,0,0,0,0,0,0,0,0,0,0
472380,523_16_18,LITHUANIA,10916,17,jonas valanciunas,24,2,4,50,2,4,50,0,0,0,2,2,100,1,9,10,1,3,2,0,0,6
472381,523_16_18,LITHUANIA,10639,19,mindaugas kuzminskas,27,9,13,69.2,7,10,70,2,3,66.7,3,4,75,2,3,5,1,3,2,0,0,23
472382,523_16_18,LITHUANIA,17690,40,marius grigonis,25,3,5,60,2,2,100,1,3,33.3,0,0,0,0,5,5,0,3,0,1,0,7
472383,523_16_18,LITHUANIA,15948,93,vaidas kariniauskas,3,0,1,0,0,0,0,0,1,0,0,0,0,0,1,1,0,2,0,0,0,0
472384,523_16_18,LITHUANIA,0,TOTALS,LITHUANIA,200,29,65,44.6,22,41,53.7,7,24,29.2,16,19,84.2,11,40,51,12,25,16,5,2,81
472385,523_16_18,ARGENTINA,80,4,luis scola,30,5,11,45.5,4,8,50,1,3,33.3,1,2,50,1,6,7,4,5,1,1,0,12
472386,523_16_18,ARGENTINA,74,5,manu ginobili,29,5,12,41.7,3,7,42.9,2,5,40,10,17,58.8,0,1,1,1,3,0,1,0,22
472387,523_16_18,ARGENTINA,21037,7,facundo campazzo,26,4,11,36.4,2,7,28.6,2,4,50,0,2,0,1,2,3,1,1,0,2,0,10
472388,523_16_18,ARGENTINA,12228,8,nicolas laprovittola,15,1,6,16.7,1,3,33.3,0,3,0,1,2,50,0,1,1,3,2,0,1,0,3
472389,523_16_18,ARGENTINA,25732,9,nicolas brussino,0,0,0,0,0,0,0,0,0,0,0,0,0,0,0,0,0,0,0,0,0,0
472390,523_16_18,ARGENTINA,83,10,carlos delfino,21,4,9,44.4,2,4,50,2,5,40,0,1,0,1,3,4,0,1,2,1,0,10
472391,523_16_18,ARGENTINA,14903,12,marcos delia,12,0,0,0,0,0,0,0,0,0,0,0,0,1,1,2,0,3,0,0,0,0
472392,523_16_18,ARGENTINA,82,13,andres nocioni,37,5,14,35.7,5,9,55.6,0,5,0,4,4,100,1,6,7,1,3,1,1,2,14
472393,523_16_18,ARGENTINA,15007,14,gabriel deck,0,0,0,0,0,0,0,0,0,0,0,0,0,0,0,0,0,0,0,0,0,0
472394,523_16_18,ARGENTINA,459,19,leo mainoldi,3,0,1,0,0,0,0,0,1,0,0,0,0,0,0,0,1,0,1,0,0,0
472395,523_16_18,ARGENTINA,12296,29,patricio garino,14,0,0,0,0,0,0,0,0,0,0,0,0,0,2,2,0,3,0,0,1,0
472396,523_16_18,ARGENTINA,30898,35,roberto acuna,14,1,2,50,1,2,50,0,0,0,0,0,0,0,1,1,0,2,1,1,0,2
472397,523_16_18,ARGENTINA,0,TOTALS,ARGENTINA,200,25,66,37.9,18,40,45,7,26,26.9,16,28,57.1,6,23,29,11,23,6,8,3,73
472398,523_16_19,CHINA,18850,4,jiwei zhao,16,2,2,100,2,2,100,0,0,0,0,0,0,0,1,1,4,2,5,0,0,4
472399,523_16_19,CHINA,30890,5,ran sui,2,0,0,0,0,0,0,0,0,0,0,0,0,0,0,0,0,0,0,0,0,0
472400,523_16_19,CHINA,14374,6,ailun guo,35,3,10,30,2,4,50,1,6,16.7,4,4,100,1,1,2,5,2,5,0,0,11
472401,523_16_19,CHINA,14377,8,yanyuhang ding,26,1,1,100,1,1,100,0,0,0,6,8,75,0,0,0,1,3,0,0,0,8
472402,523_16_19,CHINA,14378,9,xiaochuan zhai,7,1,1,100,1,1,100,0,0,0,2,2,100,0,1,1,1,1,1,0,0,4
472403,523_16_19,CHINA,16587,10,peng zhou,20,0,1,0,0,1,0,0,0,0,2,2,100,0,0,0,0,0,0,1,0,2
472404,523_16_19,CHINA,56,11,jianlian yi,33,9,18,50,7,15,46.7,2,3,66.7,0,1,0,3,6,9,2,3,2,0,2,20
472405,523_16_19,CHINA,28364,12,gen li,20,1,3,33.3,1,2,50,0,1,0,3,4,75,0,1,1,1,3,2,0,0,5
472406,523_16_19,CHINA,18361,13,muhao li,0,0,0,0,0,0,0,0,0,0,0,0,0,0,0,0,0,0,0,0,0,0
472407,523_16_19,CHINA,30891,14,yuchen zou,14,3,4,75,3,4,75,0,0,0,2,2,100,1,1,2,1,5,0,0,0,8
472408,523_16_19,CHINA,18858,15,qi zhou,18,2,3,66.7,2,2,100,0,1,0,2,4,50,0,2,2,3,1,0,2,1,6
472409,523_16_19,CHINA,16635,31,zhelin wang,10,0,2,0,0,2,0,0,0,0,0,0,0,0,3,3,1,2,1,1,0,0
472410,523_16_19,CHINA,0,TOTALS,CHINA,200,22,45,48.9,19,34,55.9,3,11,27.3,21,27,77.8,5,16,21,19,22,18,4,3,68
472411,523_16_19,AUSTRALIA,9039,4,chris goulding,10,0,2,0,0,0,0,0,2,0,2,2,100,0,2,2,4,3,0,0,0,2
472412,523_16_19,AUSTRALIA,9045,5,patty mills,19,2,4,50,1,1,100,1,3,33.3,0,0,0,0,3,3,3,2,1,3,0,5
472413,523_16_19,AUSTRALIA,135,6,andrew bogut,0,0,0,0,0,0,0,0,0,0,0,0,0,0,0,0,0,0,0,0,0,0
472414,523_16_19,AUSTRALIA,11635,7,joe ingles,23,2,4,50,2,3,66.7,0,1,0,0,0,0,0,2,2,4,2,0,1,0,4
472415,523_16_19,AUSTRALIA,13811,8,matthew dellavedova,20,3,4,75,3,4,75,0,0,0,0,0,0,1,0,1,8,3,0,0,0,6
472416,523_16_19,AUSTRALIA,13813,9,ryan broekhoff,17,5,10,50,3,5,60,2,5,40,0,0,0,1,0,1,2,3,0,0,0,12
472417,523_16_19,AUSTRALIA,25376,10,cameron bairstow,19,7,13,53.8,6,12,50,1,1,100,2,6,33.3,4,5,9,0,2,5,1,1,17
472418,523_16_19,AUSTRALIA,30889,11,kevin lisch,18,1,2,50,0,1,0,1,1,100,2,2,100,2,0,2,6,1,0,0,0,5
472419,523_16_19,AUSTRALIA,16519,12,aron baynes,26,5,8,62.5,5,8,62.5,0,0,0,2,2,100,0,4,4,2,1,1,1,0,12
472420,523_16_19,AUSTRALIA,142,13,david andersen,15,5,9,55.6,4,6,66.7,1,3,33.3,1,2,50,1,2,3,0,3,2,2,0,12
472421,523_16_19,AUSTRALIA,13814,14,brock motum,16,6,9,66.7,6,8,75,0,1,0,3,4,75,3,0,3,2,3,0,0,0,15
472422,523_16_19,AUSTRALIA,16520,15,damian martin,16,1,1,100,0,0,0,1,1,100,0,0,0,1,0,1,3,2,0,2,0,3
472423,523_16_19,AUSTRALIA,0,TOTALS,AUSTRALIA,200,37,66,56.1,30,48,62.5,7,18,38.9,12,18,66.7,15,20,35,34,25,10,10,1,93
472424,523_16_20,USA,30892,4,jimmy butler,15,2,4,50,1,2,50,1,2,50,4,5,80,0,0,0,0,3,0,1,0,9
472425,523_16_20,USA,16599,5,kevin durant,30,2,4,50,1,1,100,1,3,33.3,7,8,87.5,0,5,5,1,2,1,1,0,12
472426,523_16_20,USA,9017,6,deandre jordan,14,4,4,100,4,4,100,0,0,0,5,8,62.5,0,1,1,3,3,1,1,1,13
472427,523_16_20,USA,30893,7,kyle lowry,10,1,1,100,1,1,100,0,0,0,0,0,0,0,1,1,1,2,0,2,0,2
472428,523_16_20,USA,30894,8,harrison barnes,0,0,0,0,0,0,0,0,0,0,0,0,0,0,0,0,0,0,0,0,0,0
472429,523_16_20,USA,25452,9,demar derozan,10,3,5,60,3,5,60,0,0,0,5,6,83.3,0,1,1,1,1,0,0,0,11
472430,523_16_20,USA,16977,10,kyrie irving,30,5,8,62.5,4,6,66.7,1,2,50,4,4,100,0,0,0,5,3,2,0,0,15
472431,523_16_20,USA,13751,11,klay thompson,9,1,6,16.7,0,3,0,1,3,33.3,0,0,0,0,1,1,3,1,0,0,0,3
472432,523_16_20,USA,25453,12,demarcus cousins,21,2,3,66.7,2,3,66.7,0,0,0,1,2,50,1,2,3,5,2,5,2,0,5
472433,523_16_20,USA,30895,13,paul george,24,4,10,40,2,6,33.3,2,4,50,2,2,100,4,5,9,4,2,0,1,0,12
472434,523_16_20,USA,30896,14,draymond green,13,0,2,0,0,1,0,0,1,0,0,0,0,0,3,3,2,1,2,0,0,0
472435,523_16_20,USA,113,15,carmelo anthony,24,3,8,37.5,2,3,66.7,1,5,20,5,7,71.4,0,3,3,3,4,1,0,0,12
472436,523_16_20,USA,0,TOTALS,USA,200,27,55,49.1,20,35,57.1,7,20,35,33,42,78.6,9,24,33,28,25,12,8,1,94
472437,523_16_20,SERBIA,5751,4,milos teodosic,30,4,9,44.4,0,2,0,4,7,57.1,6,6,100,1,2,3,6,3,4,1,0,18
472438,523_16_20,SERBIA,2100,5,marko simonovic,15,1,2,50,1,1,100,0,1,0,1,2,50,0,1,1,1,2,0,0,0,3
472439,523_16_20,SERBIA,17361,7,bogdan bogdanovic,25,3,7,42.9,2,2,100,1,5,20,0,0,0,0,1,1,3,3,2,0,0,7
472440,523_16_20,SERBIA,2654,9,stefan markovic,24,4,6,66.7,2,3,66.7,2,3,66.7,2,2,100,0,4,4,4,2,1,0,0,12
472441,523_16_20,SERBIA,19860,10,nikola kalinic,22,1,4,25,1,1,100,0,3,0,3,4,75,1,4,5,2,5,2,2,0,5
472442,523_16_20,SERBIA,15503,11,nemanja nedovic,12,1,4,25,0,3,0,1,1,100,0,0,0,0,1,1,0,0,0,0,0,3
472443,523_16_20,SERBIA,15504,12,stefan bircevic,5,0,2,0,0,0,0,0,2,0,0,0,0,0,0,0,0,3,0,0,0,0
472444,523_16_20,SERBIA,2656,13,miroslav raduljica,15,6,8,75,6,8,75,0,0,0,6,8,75,1,1,2,0,5,0,0,0,18
472445,523_16_20,SERBIA,22978,14,nikola jokic,30,11,15,73.3,9,13,69.2,2,2,100,1,3,33.3,1,5,6,3,3,3,1,1,25
472446,523_16_20,SERBIA,5756,15,vladimir stimac,5,0,1,0,0,1,0,0,0,0,0,0,0,1,1,2,0,2,0,0,0,0
472447,523_16_20,SERBIA,25441,24,stefan jovic,14,0,1,0,0,0,0,0,1,0,0,0,0,0,2,2,3,3,2,1,0,0
472448,523_16_20,SERBIA,6241,25,milan macvan,6,0,1,0,0,1,0,0,0,0,0,0,0,0,0,0,1,0,0,0,0,0
472449,523_16_20,SERBIA,0,TOTALS,SERBIA,200,31,60,51.7,21,35,60,10,25,40,19,25,76,8,23,31,23,32,16,5,1,91
472450,523_16_21,FRANCE,12495,4,thomas heurtel,20,5,7,71.4,4,4,100,1,3,33.3,0,0,0,1,2,3,8,0,2,0,0,11
472451,523_16_21,FRANCE,2588,5,nicolas batum,15,2,7,28.6,1,5,20,1,2,50,0,0,0,0,1,1,0,1,0,0,1,5
472452,523_16_21,FRANCE,2589,6,antoine diot,18,4,5,80,2,3,66.7,2,2,100,4,4,100,0,1,1,0,3,1,0,0,14
472453,523_16_21,FRANCE,11076,7,joffrey lauvergne,19,8,10,80,8,9,88.9,0,1,0,1,2,50,1,3,4,2,1,0,0,1,17
472454,523_16_21,FRANCE,1864,8,charles kahudi,19,2,4,50,1,3,33.3,1,1,100,1,1,100,1,11,12,2,2,0,0,0,6
472455,523_16_21,FRANCE,5047,9,tony parker,20,6,9,66.7,6,7,85.7,0,2,0,2,2,100,0,0,0,3,0,0,2,0,14
472456,523_16_21,FRANCE,4663,11,florent pietrus,14,1,2,50,1,1,100,0,1,0,0,0,0,1,1,2,3,2,0,0,0,2
472457,523_16_21,FRANCE,10428,12,nando de colo,18,5,6,83.3,5,5,100,0,1,0,0,0,0,1,3,4,4,0,1,1,0,10
472458,523_16_21,FRANCE,4665,13,boris diaw,18,5,9,55.6,5,8,62.5,0,1,0,0,0,0,1,3,4,0,2,0,1,0,10
472459,523_16_21,FRANCE,5044,15,mickael gelabale,10,1,2,50,1,1,100,0,1,0,0,0,0,0,3,3,3,0,0,0,0,2
472460,523_16_21,FRANCE,17374,16,rudy gobert,17,1,3,33.3,1,3,33.3,0,0,0,1,2,50,2,3,5,0,2,0,0,0,3
472461,523_16_21,FRANCE,7987,17,kim tillie,12,1,3,33.3,1,3,33.3,0,0,0,0,0,0,0,1,1,0,2,0,0,0,2
472462,523_16_21,FRANCE,0,TOTALS,FRANCE,200,41,67,61.2,36,52,69.2,5,15,33.3,9,11,81.8,9,33,42,25,15,5,4,2,96
472463,523_16_21,VENEZUELA,9985,0,gregory echenique,26,4,6,66.7,4,6,66.7,0,0,0,4,4,100,0,3,3,0,1,0,0,0,12
472464,523_16_21,VENEZUELA,19023,2,dwight lewis,5,0,4,0,0,2,0,0,2,0,0,0,0,0,0,0,1,0,0,0,0,0
472465,523_16_21,VENEZUELA,514,4,miguel marriaga,10,0,0,0,0,0,0,0,0,0,2,2,100,2,0,2,0,2,0,1,0,2
472466,523_16_21,VENEZUELA,16828,5,gregory vargas,21,1,5,20,0,0,0,1,5,20,0,0,0,0,0,0,1,4,2,0,0,3
472467,523_16_21,VENEZUELA,21053,6,john cox,29,3,10,30,3,9,33.3,0,1,0,0,0,0,2,0,2,4,1,0,0,0,6
472468,523_16_21,VENEZUELA,16829,8,david cubillan,21,2,7,28.6,0,4,0,2,3,66.7,0,0,0,0,0,0,2,2,0,1,0,6
472469,523_16_21,VENEZUELA,9857,10,jose vargas,22,3,11,27.3,3,6,50,0,5,0,2,2,100,0,7,7,0,3,0,0,0,8
472470,523_16_21,VENEZUELA,25751,14,miguel ruiz,17,1,3,33.3,1,3,33.3,0,0,0,0,1,0,2,0,2,2,2,0,0,0,2
472471,523_16_21,VENEZUELA,19026,15,windi graterol,4,0,1,0,0,0,0,0,1,0,0,0,0,0,0,0,0,0,0,0,0,0
472472,523_16_21,VENEZUELA,19021,19,heissler guillent,13,2,5,40,1,3,33.3,1,2,50,0,0,0,0,0,0,3,0,0,0,0,5
472473,523_16_21,VENEZUELA,12301,23,anthony perez,14,1,4,25,1,2,50,0,2,0,0,0,0,1,1,2,0,1,0,0,0,2
472474,523_16_21,VENEZUELA,19022,43,nestor colmenares,17,5,7,71.4,5,5,100,0,2,0,0,2,0,0,4,4,4,1,3,1,0,10
472475,523_16_21,VENEZUELA,0,TOTALS,VENEZUELA,200,22,63,34.9,18,40,45,4,23,17.4,8,11,72.7,8,18,26,17,18,8,3,0,56
472476,523_16_22,ARGENTINA,80,4,luis scola,34,6,9,66.7,4,5,80,2,4,50,0,2,0,2,8,10,1,5,3,0,0,14
472477,523_16_22,ARGENTINA,74,5,manu ginobili,39,4,14,28.6,4,6,66.7,0,8,0,5,10,50,1,2,3,4,2,0,1,2,13
472478,523_16_22,ARGENTINA,21037,7,facundo campazzo,43,9,22,40.9,4,12,33.3,5,10,50,10,12,83.3,1,3,4,11,4,3,4,0,33
472479,523_16_22,ARGENTINA,12228,8,nicolas laprovittola,7,0,0,0,0,0,0,0,0,0,0,0,0,1,0,1,1,3,1,0,0,0
472480,523_16_22,ARGENTINA,25732,9,nicolas brussino,0,0,0,0,0,0,0,0,0,0,0,0,0,0,0,0,0,0,0,0,0,0
472481,523_16_22,ARGENTINA,83,10,carlos delfino,16,0,4,0,0,1,0,0,3,0,0,2,0,0,1,1,0,0,2,1,0,0
472482,523_16_22,ARGENTINA,14903,12,marcos delia,12,1,1,100,1,1,100,0,0,0,0,0,0,1,2,3,1,1,1,1,0,2
472483,523_16_22,ARGENTINA,82,13,andres nocioni,47,11,19,57.9,3,7,42.9,8,12,66.7,7,8,87.5,0,11,11,0,5,3,1,0,37
472484,523_16_22,ARGENTINA,15007,14,gabriel deck,7,1,2,50,1,2,50,0,0,0,0,0,0,0,0,0,0,2,2,0,0,2
472485,523_16_22,ARGENTINA,459,19,leo mainoldi,2,0,1,0,0,0,0,0,1,0,0,0,0,0,0,0,0,0,0,0,0,0
472486,523_16_22,ARGENTINA,12296,29,patricio garino,43,4,7,57.1,2,3,66.7,2,4,50,0,0,0,2,2,4,1,3,0,3,0,10
472487,523_16_22,ARGENTINA,30898,35,roberto acuna,0,0,0,0,0,0,0,0,0,0,0,0,0,0,0,0,0,0,0,0,0,0
472488,523_16_22,ARGENTINA,0,TOTALS,ARGENTINA,250,36,79,45.6,19,37,51.4,17,42,40.5,22,34,64.7,9,34,43,19,25,15,11,2,111
472489,523_16_22,BRAZIL,14848,5,raulzinho neto,27,0,4,0,0,0,0,0,4,0,3,4,75,0,1,1,4,4,3,1,0,3
472490,523_16_22,BRAZIL,16960,6,cristiano felicio,1,1,1,100,1,1,100,0,0,0,0,0,0,1,0,1,0,0,0,0,0,2
472491,523_16_22,BRAZIL,7625,8,vitor benite,15,5,10,50,2,4,50,3,6,50,0,0,0,0,0,0,0,0,0,0,0,13
472492,523_16_22,BRAZIL,4098,9,marcelinho huertas,21,5,11,45.5,5,10,50,0,1,0,4,4,100,0,1,1,3,5,1,0,0,14
472493,523_16_22,BRAZIL,4102,10,alex garcia,34,5,11,45.5,3,7,42.9,2,4,50,2,2,100,1,7,8,3,4,1,0,0,14
472494,523_16_22,BRAZIL,4104,12,guilherme giovannoni,30,3,5,60,1,3,33.3,2,2,100,2,3,66.7,1,5,6,1,2,0,0,0,10
472495,523_16_22,BRAZIL,9844,13,nene hilario,38,11,17,64.7,11,17,64.7,0,0,0,2,4,50,4,7,11,2,4,4,2,0,24
472496,523_16_22,BRAZIL,9845,14,marcus vinicius marquinhos,33,2,11,18.2,2,5,40,0,6,0,5,6,83.3,0,5,5,3,4,2,1,0,9
472497,523_16_22,BRAZIL,4100,19,leandro barbosa,21,4,8,50,3,6,50,1,2,50,2,2,100,1,4,5,0,5,3,1,0,11
472498,523_16_22,BRAZIL,19019,23,augusto lima,13,0,0,0,0,0,0,0,0,0,2,2,100,1,2,3,0,3,1,0,1,2
472499,523_16_22,BRAZIL,23752,30,rafael hettsheimeir,15,2,5,40,1,4,25,1,1,100,0,0,0,1,2,3,0,0,2,1,1,5
472500,523_16_22,BRAZIL,7622,55,rafael luz,2,0,0,0,0,0,0,0,0,0,0,0,0,0,0,0,0,0,1,0,0,0
472501,523_16_22,BRAZIL,0,TOTALS,BRAZIL,250,38,83,45.8,29,57,50.9,9,26,34.6,22,27,81.5,11,38,49,16,31,19,6,2,107
472502,523_16_23,SPAIN,61,4,pau gasol,23,7,9,77.8,2,4,50,5,5,100,4,5,80,1,4,5,5,1,0,2,2,23
472503,523_16_23,SPAIN,70,5,rudy fernandez,21,3,6,50,1,1,100,2,5,40,5,6,83.3,0,1,1,3,2,1,2,1,13
472504,523_16_23,SPAIN,1877,6,sergio rodriguez,17,2,8,25,0,2,0,2,6,33.3,0,0,0,0,1,1,3,2,0,1,0,6
472505,523_16_23,SPAIN,64,7,juan-carlos navarro,18,2,6,33.3,2,5,40,0,1,0,0,0,0,0,2,2,5,1,0,1,0,4
472506,523_16_23,SPAIN,65,8,jose manuel calderon,6,1,2,50,0,0,0,1,2,50,0,0,0,0,1,1,1,1,0,0,0,3
472507,523_16_23,SPAIN,66,9,felipe reyes,15,4,8,50,3,6,50,1,2,50,2,2,100,5,4,9,0,1,0,0,0,11
472508,523_16_23,SPAIN,2628,10,victor claver,19,1,2,50,1,2,50,0,0,0,0,0,0,3,2,5,3,3,0,1,0,2
472509,523_16_23,SPAIN,17609,14,willy hernangomez,17,3,5,60,3,5,60,0,0,0,3,4,75,1,1,2,1,0,1,1,2,9
472510,523_16_23,SPAIN,19988,21,alex abrines,0,0,0,0,0,0,0,0,0,0,0,0,0,0,0,0,0,0,0,0,0,0
472511,523_16_23,SPAIN,1871,23,sergio llull,21,4,6,66.7,3,3,100,1,3,33.3,1,1,100,0,2,2,6,1,1,1,0,10
472512,523_16_23,SPAIN,17234,44,nikola mirotic,25,8,11,72.7,7,7,100,1,4,25,0,0,0,1,3,4,0,2,2,0,0,17
472513,523_16_23,SPAIN,6259,79,ricky rubio,18,4,5,80,1,1,100,3,4,75,0,0,0,0,2,2,4,2,3,1,0,11
472514,523_16_23,SPAIN,0,TOTALS,SPAIN,200,39,68,57.4,23,36,63.9,16,32,50,15,18,83.3,15,26,41,31,16,9,10,5,109
472515,523_16_23,LITHUANIA,1726,5,mantas kalnietis,17,7,9,77.8,5,7,71.4,2,2,100,0,0,0,0,0,0,2,1,3,0,0,16
472516,523_16_23,LITHUANIA,6225,7,adas juskevicius,11,2,3,66.7,1,1,100,1,2,50,0,0,0,0,0,0,2,0,1,0,0,5
472517,523_16_23,LITHUANIA,980,8,jonas maciulis,19,1,6,16.7,1,3,33.3,0,3,0,2,2,100,0,0,0,2,2,0,1,0,4
472518,523_16_23,LITHUANIA,3474,10,renaldas seibutis,11,0,2,0,0,1,0,0,1,0,0,0,0,0,0,0,0,1,0,1,0,0
472519,523_16_23,LITHUANIA,22216,11,domantas sabonis,24,2,7,28.6,1,5,20,1,2,50,0,0,0,2,3,5,2,2,2,1,1,5
472520,523_16_23,LITHUANIA,3476,12,antanas kavaliauskas,9,1,3,33.3,1,3,33.3,0,0,0,0,0,0,0,0,0,0,1,1,0,0,2
472521,523_16_23,LITHUANIA,987,13,paulius jankunas,10,0,3,0,0,1,0,0,2,0,2,2,100,0,0,0,0,2,2,0,0,2
472522,523_16_23,LITHUANIA,24,15,robertas javtokas,11,0,0,0,0,0,0,0,0,0,0,0,0,0,0,0,1,2,1,1,2,0
472523,523_16_23,LITHUANIA,10916,17,jonas valanciunas,19,0,6,0,0,6,0,0,0,0,0,0,0,5,5,10,0,2,2,0,0,0
472524,523_16_23,LITHUANIA,10639,19,mindaugas kuzminskas,27,7,12,58.3,5,6,83.3,2,6,33.3,1,4,25,1,3,4,2,3,0,0,1,17
472525,523_16_23,LITHUANIA,17690,40,marius grigonis,19,1,5,20,1,1,100,0,4,0,0,0,0,0,0,0,1,4,0,0,0,2
472526,523_16_23,LITHUANIA,15948,93,vaidas kariniauskas,21,3,4,75,3,3,100,0,1,0,0,1,0,0,2,2,1,3,3,0,0,6
472527,523_16_23,LITHUANIA,0,TOTALS,LITHUANIA,200,24,60,40,18,37,48.6,6,23,26.1,5,9,55.6,11,14,25,13,23,15,4,4,59
472528,523_16_24,CROATIA,13759,4,luka babic,22,4,9,44.4,4,6,66.7,0,3,0,0,0,0,3,2,5,1,3,0,1,0,8
472529,523_16_24,CROATIA,7990,5,filip kruslin,0,0,0,0,0,0,0,0,0,0,0,0,0,0,0,0,0,0,0,0,0,0
472530,523_16_24,CROATIA,1915,6,rok stipcevic,0,0,0,0,0,0,0,0,0,0,0,0,0,0,0,0,0,0,0,0,0,0
472531,523_16_24,CROATIA,1249,7,krunoslav simon,20,1,7,14.3,1,3,33.3,0,4,0,0,0,0,2,4,6,2,0,2,0,0,2
472532,523_16_24,CROATIA,18415,8,mario hezonja,16,2,8,25,1,3,33.3,1,5,20,0,0,0,0,1,1,3,0,1,0,0,5
472533,523_16_24,CROATIA,15894,9,dario saric,27,2,5,40,1,2,50,1,3,33.3,2,3,66.7,1,5,6,0,4,3,2,1,7
472534,523_16_24,CROATIA,4585,10,roko ukic,35,4,12,33.3,3,6,50,1,6,16.7,1,2,50,2,3,5,4,3,0,2,0,10
472535,523_16_24,CROATIA,12600,12,darko planinic,17,2,3,66.7,2,3,66.7,0,0,0,5,7,71.4,1,2,3,1,2,2,1,0,9
472536,523_16_24,CROATIA,10624,15,miro bilan,21,3,4,75,3,4,75,0,0,0,1,2,50,0,1,1,0,2,0,0,0,7
472537,523_16_24,CROATIA,7991,33,zeljko sakic,7,0,2,0,0,1,0,0,1,0,0,0,0,1,0,1,0,1,0,0,0,0
472538,523_16_24,CROATIA,20277,35,marko arapovic,0,0,0,0,0,0,0,0,0,0,0,0,0,0,0,0,0,0,0,0,0,0
472539,523_16_24,CROATIA,6280,44,bojan bogdanovic,36,8,15,53.3,5,9,55.6,3,6,50,9,12,75,0,3,3,2,2,2,2,0,28
472540,523_16_24,CROATIA,0,TOTALS,CROATIA,200,26,65,40,20,37,54.1,6,28,21.4,18,26,69.2,12,22,34,13,17,11,8,1,76
472541,523_16_24,NIGERIA,23139,4,ben uzoh,11,1,3,33.3,1,3,33.3,0,0,0,0,0,0,0,3,3,1,0,0,0,0,2
472542,523_16_24,NIGERIA,13976,5,michael umeh,24,6,10,60,0,0,0,6,10,60,1,2,50,0,5,5,4,4,2,0,0,19
472543,523_16_24,NIGERIA,21026,6,ike diogu,30,3,10,30,2,7,28.6,1,3,33.3,3,4,75,8,4,12,4,3,2,0,2,10
472544,523_16_24,NIGERIA,6814,7,ebi ere,24,5,8,62.5,1,3,33.3,4,5,80,0,0,0,1,3,4,6,4,1,1,0,14
472545,523_16_24,NIGERIA,6813,8,josh akognon,17,6,9,66.7,3,3,100,3,6,50,3,3,100,0,1,1,5,3,3,1,0,18
472546,523_16_24,NIGERIA,3647,9,chamberlain oguchi,28,1,10,10,0,1,0,1,9,11.1,0,0,0,1,2,3,3,1,3,0,0,3
472547,523_16_24,NIGERIA,23140,10,stan okoye,0,0,0,0,0,0,0,0,0,0,0,0,0,0,0,0,0,0,0,0,0,0
472548,523_16_24,NIGERIA,23143,11,andy ogide,8,1,1,100,1,1,100,0,0,0,0,0,0,0,0,0,0,2,0,0,0,2
472549,523_16_24,NIGERIA,28095,12,michael gbinije,17,3,4,75,1,2,50,2,2,100,0,0,0,1,2,3,3,2,0,1,0,8
472550,523_16_24,NIGERIA,30897,13,shane lawal,0,0,0,0,0,0,0,0,0,0,0,0,0,0,0,0,0,0,0,0,0,0
472551,523_16_24,NIGERIA,21031,14,alade aminu,25,4,8,50,4,8,50,0,0,0,5,8,62.5,3,4,7,0,3,1,1,1,13
472552,523_16_24,NIGERIA,21025,15,ekene ibekwe,17,0,5,0,0,4,0,0,1,0,1,2,50,3,2,5,0,3,2,1,3,1
472553,523_16_24,NIGERIA,0,TOTALS,NIGERIA,200,30,68,44.1,13,32,40.6,17,36,47.2,13,19,68.4,17,28,45,26,25,14,5,6,90
472554,523_16_25,USA,30892,4,jimmy butler,6,1,1,100,1,1,100,0,0,0,0,0,0,1,0,1,1,0,0,0,0,2
472555,523_16_25,USA,16599,5,kevin durant,30,6,6,100,5,5,100,1,1,100,4,5,80,0,6,6,4,1,3,2,0,17
472556,523_16_25,USA,9017,6,deandre jordan,18,3,5,60,3,5,60,0,0,0,1,2,50,1,2,3,1,3,1,1,0,7
472557,523_16_25,USA,30893,7,kyle lowry,13,0,1,0,0,1,0,0,0,0,0,0,0,0,1,1,3,0,0,0,0,0
472558,523_16_25,USA,30894,8,harrison barnes,0,0,0,0,0,0,0,0,0,0,0,0,0,0,0,0,0,0,0,0,0,0
472559,523_16_25,USA,25452,9,demar derozan,12,2,5,40,2,3,66.7,0,2,0,5,7,71.4,0,1,1,1,1,2,1,0,9
472560,523_16_25,USA,16977,10,kyrie irving,27,3,6,50,3,4,75,0,2,0,4,4,100,0,4,4,12,1,0,1,0,10
472561,523_16_25,USA,13751,11,klay thompson,26,9,16,56.2,2,3,66.7,7,13,53.8,5,7,71.4,0,0,0,1,3,1,1,0,30
472562,523_16_25,USA,25453,12,demarcus cousins,20,4,5,80,4,5,80,0,0,0,1,2,50,3,2,5,1,4,4,0,1,9
472563,523_16_25,USA,30895,13,paul george,14,3,6,50,3,5,60,0,1,0,0,0,0,1,0,1,2,0,1,1,0,6
472564,523_16_25,USA,30896,14,draymond green,6,0,1,0,0,0,0,0,1,0,0,0,0,0,0,0,1,1,0,0,0,0
472565,523_16_25,USA,113,15,carmelo anthony,27,4,11,36.4,2,4,50,2,7,28.6,0,0,0,1,3,4,5,3,0,1,0,10
472566,523_16_25,USA,0,TOTALS,USA,200,35,63,55.6,25,36,69.4,10,27,37,20,27,74.1,8,21,29,32,17,13,8,1,100
472567,523_16_25,FRANCE,12495,4,thomas heurtel,27,8,14,57.1,7,10,70,1,4,25,1,1,100,2,6,8,9,3,1,1,0,18
472568,523_16_25,FRANCE,2588,5,nicolas batum,28,4,6,66.7,3,3,100,1,3,33.3,5,5,100,1,2,3,3,0,2,0,0,14
472569,523_16_25,FRANCE,2589,6,antoine diot,17,3,8,37.5,1,2,50,2,6,33.3,0,0,0,1,0,1,3,4,0,1,0,8
472570,523_16_25,FRANCE,11076,7,joffrey lauvergne,22,6,10,60,6,9,66.7,0,1,0,0,3,0,2,3,5,0,3,2,0,0,12
472571,523_16_25,FRANCE,1864,8,charles kahudi,13,1,2,50,1,2,50,0,0,0,0,0,0,0,2,2,0,2,1,0,1,2
472572,523_16_25,FRANCE,5047,9,tony parker,0,0,0,0,0,0,0,0,0,0,0,0,0,0,0,0,0,0,0,0,0,0
472573,523_16_25,FRANCE,4663,11,florent pietrus,5,0,0,0,0,0,0,0,0,0,0,0,0,0,0,0,0,0,0,0,0,0
472574,523_16_25,FRANCE,10428,12,nando de colo,19,8,13,61.5,7,9,77.8,1,4,25,1,1,100,1,3,4,5,2,3,1,0,18
472575,523_16_25,FRANCE,4665,13,boris diaw,26,2,5,40,2,4,50,0,1,0,1,1,100,0,1,1,7,3,2,2,0,5
472576,523_16_25,FRANCE,5044,15,mickael gelabale,16,4,8,50,4,8,50,0,0,0,0,0,0,0,1,1,1,3,1,1,1,8
472577,523_16_25,FRANCE,17374,16,rudy gobert,18,3,5,60,3,5,60,0,0,0,0,0,0,1,4,5,0,2,0,0,0,6
472578,523_16_25,FRANCE,7987,17,kim tillie,9,2,2,100,2,2,100,0,0,0,2,2,100,1,0,1,0,0,0,0,0,6
472579,523_16_25,FRANCE,0,TOTALS,FRANCE,200,41,73,56.2,36,54,66.7,5,19,26.3,10,13,76.9,11,24,35,28,23,13,6,2,97
472580,523_16_26,AUSTRALIA,9039,4,chris goulding,25,6,10,60,2,3,66.7,4,7,57.1,6,8,75,2,1,3,2,3,1,1,0,22
472581,523_16_26,AUSTRALIA,9045,5,patty mills,0,0,0,0,0,0,0,0,0,0,0,0,0,0,0,0,0,0,0,0,0,0
472582,523_16_26,AUSTRALIA,135,6,andrew bogut,18,5,6,83.3,5,6,83.3,0,0,0,0,0,0,2,4,6,2,3,2,1,0,10
472583,523_16_26,AUSTRALIA,11635,7,joe ingles,26,5,9,55.6,4,5,80,1,4,25,0,0,0,0,1,1,3,1,2,0,0,11
472584,523_16_26,AUSTRALIA,13811,8,matthew dellavedova,8,1,2,50,1,2,50,0,0,0,1,2,50,0,0,0,1,0,0,0,0,3
472585,523_16_26,AUSTRALIA,13813,9,ryan broekhoff,25,4,10,40,2,6,33.3,2,4,50,0,0,0,4,4,8,2,2,0,1,0,10
472586,523_16_26,AUSTRALIA,25376,10,cameron bairstow,8,0,0,0,0,0,0,0,0,0,0,0,0,0,2,2,0,0,1,0,0,0
472587,523_16_26,AUSTRALIA,30889,11,kevin lisch,17,1,2,50,0,1,0,1,1,100,1,2,50,1,0,1,2,3,1,0,0,4
472588,523_16_26,AUSTRALIA,16519,12,aron baynes,24,4,8,50,4,8,50,0,0,0,0,0,0,3,4,7,2,1,4,0,0,8
472589,523_16_26,AUSTRALIA,142,13,david andersen,16,4,7,57.1,4,7,57.1,0,0,0,0,0,0,0,4,4,0,1,0,0,0,8
472590,523_16_26,AUSTRALIA,13814,14,brock motum,11,1,4,25,1,2,50,0,2,0,3,4,75,1,3,4,1,1,1,1,0,5
472591,523_16_26,AUSTRALIA,16520,15,damian martin,21,0,1,0,0,0,0,0,1,0,0,0,0,0,4,4,4,2,1,0,0,0
472592,523_16_26,AUSTRALIA,0,TOTALS,AUSTRALIA,200,31,59,52.5,23,40,57.5,8,19,42.1,11,16,68.8,16,29,45,19,17,15,4,0,81
472593,523_16_26,VENEZUELA,9985,0,gregory echenique,15,0,2,0,0,2,0,0,0,0,0,0,0,1,1,2,0,2,0,0,2,0
472594,523_16_26,VENEZUELA,19023,2,dwight lewis,3,0,0,0,0,0,0,0,0,0,0,0,0,0,0,0,0,0,0,1,0,0
472595,523_16_26,VENEZUELA,514,4,miguel marriaga,4,0,1,0,0,1,0,0,0,0,0,2,0,1,0,1,0,0,0,0,0,0
472596,523_16_26,VENEZUELA,16828,5,gregory vargas,21,2,6,33.3,2,4,50,0,2,0,2,3,66.7,1,3,4,7,3,2,3,0,6
472597,523_16_26,VENEZUELA,21053,6,john cox,29,2,10,20,2,6,33.3,0,4,0,5,6,83.3,2,1,3,0,1,1,3,0,9
472598,523_16_26,VENEZUELA,16829,8,david cubillan,20,3,8,37.5,1,1,100,2,7,28.6,2,2,100,0,0,0,3,2,2,0,0,10
472599,523_16_26,VENEZUELA,9857,10,jose vargas,20,1,8,12.5,1,7,14.3,0,1,0,0,0,0,0,0,0,0,5,1,0,0,2
472600,523_16_26,VENEZUELA,25751,14,miguel ruiz,22,2,2,100,2,2,100,0,0,0,0,0,0,1,3,4,1,4,0,3,1,4
472601,523_16_26,VENEZUELA,19026,15,windi graterol,17,4,6,66.7,3,3,100,1,3,33.3,0,0,0,0,2,2,1,3,1,0,0,9
472602,523_16_26,VENEZUELA,19021,19,heissler guillent,8,0,5,0,0,3,0,0,2,0,0,0,0,0,1,1,0,2,0,0,0,0
472603,523_16_26,VENEZUELA,12301,23,anthony perez,23,5,7,71.4,3,4,75,2,3,66.7,0,0,0,1,2,3,2,1,2,1,0,12
472604,523_16_26,VENEZUELA,19022,43,nestor colmenares,17,2,5,40,2,5,40,0,0,0,0,1,0,2,0,2,1,1,1,1,0,4
472605,523_16_26,VENEZUELA,0,TOTALS,VENEZUELA,200,21,60,35,16,38,42.1,5,22,22.7,9,14,64.3,10,15,25,15,24,11,12,3,56
472606,523_16_27,SERBIA,5751,4,milos teodosic,15,2,5,40,1,2,50,1,3,33.3,2,2,100,0,0,0,5,0,1,1,0,7
472607,523_16_27,SERBIA,2100,5,marko simonovic,18,2,2,100,1,1,100,1,1,100,3,4,75,1,1,2,0,2,0,2,1,8
472608,523_16_27,SERBIA,17361,7,bogdan bogdanovic,23,7,13,53.8,2,4,50,5,9,55.6,0,0,0,0,5,5,2,3,2,0,0,19
472609,523_16_27,SERBIA,2654,9,stefan markovic,18,0,1,0,0,0,0,0,1,0,0,0,0,0,0,0,5,0,1,0,0,0
472610,523_16_27,SERBIA,19860,10,nikola kalinic,17,6,9,66.7,5,8,62.5,1,1,100,2,2,100,3,2,5,3,1,0,3,0,15
472611,523_16_27,SERBIA,15503,11,nemanja nedovic,16,2,7,28.6,0,4,0,2,3,66.7,0,0,0,0,1,1,2,0,1,2,1,6
472612,523_16_27,SERBIA,15504,12,stefan bircevic,17,0,4,0,0,1,0,0,3,0,0,0,0,2,0,2,0,3,1,0,0,0
472613,523_16_27,SERBIA,2656,13,miroslav raduljica,12,3,5,60,3,5,60,0,0,0,5,8,62.5,0,4,4,0,1,0,0,1,11
472614,523_16_27,SERBIA,22978,14,nikola jokic,20,2,7,28.6,2,5,40,0,2,0,4,4,100,3,4,7,0,4,1,2,1,8
472615,523_16_27,SERBIA,5756,15,vladimir stimac,10,3,3,100,3,3,100,0,0,0,1,2,50,1,4,5,1,2,2,0,0,7
472616,523_16_27,SERBIA,25441,24,stefan jovic,20,1,2,50,1,2,50,0,0,0,0,0,0,1,1,2,3,3,3,0,0,2
472617,523_16_27,SERBIA,6241,25,milan macvan,13,4,6,66.7,2,2,100,2,4,50,1,1,100,1,3,4,3,1,0,1,0,11
472618,523_16_27,SERBIA,0,TOTALS,SERBIA,200,32,64,50,20,37,54.1,12,27,44.4,18,23,78.3,13,27,40,24,20,12,11,4,94
472619,523_16_27,CHINA,18850,4,jiwei zhao,0,0,0,0,0,0,0,0,0,0,0,0,0,0,0,0,0,0,0,0,0,0
472620,523_16_27,CHINA,30890,5,ran sui,5,0,2,0,0,0,0,0,2,0,0,0,0,0,0,0,1,2,1,0,0,0
472621,523_16_27,CHINA,14374,6,ailun guo,35,3,10,30,3,7,42.9,0,3,0,2,2,100,1,0,1,8,3,2,1,0,8
472622,523_16_27,CHINA,14377,8,yanyuhang ding,21,1,4,25,0,2,0,1,2,50,0,0,0,1,1,2,1,4,3,0,0,3
472623,523_16_27,CHINA,14378,9,xiaochuan zhai,21,4,4,100,1,1,100,3,3,100,0,0,0,2,4,6,0,3,1,1,0,11
472624,523_16_27,CHINA,16587,10,peng zhou,17,2,6,33.3,2,5,40,0,1,0,0,2,0,0,3,3,1,2,2,1,0,4
472625,523_16_27,CHINA,56,11,jianlian yi,35,7,14,50,7,11,63.6,0,3,0,6,8,75,0,2,2,2,4,4,0,1,20
472626,523_16_27,CHINA,28364,12,gen li,21,1,7,14.3,0,3,0,1,4,25,0,0,0,0,1,1,1,1,0,0,0,3
472627,523_16_27,CHINA,18361,13,muhao li,0,0,0,0,0,0,0,0,0,0,0,0,0,0,0,0,0,0,0,0,0,0
472628,523_16_27,CHINA,30891,14,yuchen zou,8,2,3,66.7,2,3,66.7,0,0,0,0,0,0,1,1,2,0,1,1,2,0,4
472629,523_16_27,CHINA,18858,15,qi zhou,15,1,3,33.3,1,2,50,0,1,0,1,1,100,0,1,1,1,2,2,1,0,3
472630,523_16_27,CHINA,16635,31,zhelin wang,22,2,5,40,2,5,40,0,0,0,0,0,0,2,6,8,0,3,2,0,0,4
472631,523_16_27,CHINA,0,TOTALS,CHINA,200,23,58,39.7,18,39,46.2,5,19,26.3,9,13,69.2,9,20,29,15,25,19,6,1,60
472632,523_16_28,NIGERIA,23139,4,ben uzoh,21,5,7,71.4,5,7,71.4,0,0,0,5,8,62.5,1,3,4,2,0,1,0,0,15
472633,523_16_28,NIGERIA,13976,5,michael umeh,20,3,8,37.5,2,5,40,1,3,33.3,2,2,100,1,3,4,2,0,2,0,0,9
472634,523_16_28,NIGERIA,21026,6,ike diogu,28,3,8,37.5,2,6,33.3,1,2,50,2,4,50,2,2,4,2,0,1,0,0,9
472635,523_16_28,NIGERIA,6814,7,ebi ere,18,2,4,50,1,2,50,1,2,50,0,0,0,0,1,1,1,1,3,2,0,5
472636,523_16_28,NIGERIA,6813,8,josh akognon,20,4,9,44.4,1,3,33.3,3,6,50,5,5,100,0,0,0,0,4,1,0,0,16
472637,523_16_28,NIGERIA,3647,9,chamberlain oguchi,20,1,6,16.7,0,1,0,1,5,20,0,0,0,0,2,2,1,2,0,0,0,3
472638,523_16_28,NIGERIA,23140,10,stan okoye,0,0,0,0,0,0,0,0,0,0,0,0,0,0,0,0,0,0,0,0,0,0
472639,523_16_28,NIGERIA,23143,11,andy ogide,9,0,1,0,0,1,0,0,0,0,0,0,0,0,0,0,0,0,0,0,1,0
472640,523_16_28,NIGERIA,28095,12,michael gbinije,22,1,2,50,1,2,50,0,0,0,0,0,0,0,3,3,1,3,1,0,0,2
472641,523_16_28,NIGERIA,30897,13,shane lawal,0,0,0,0,0,0,0,0,0,0,0,0,0,0,0,0,0,0,0,0,0,0
472642,523_16_28,NIGERIA,21031,14,alade aminu,26,5,10,50,5,10,50,0,0,0,0,0,0,4,3,7,2,3,5,1,0,10
472643,523_16_28,NIGERIA,21025,15,ekene ibekwe,17,0,3,0,0,1,0,0,2,0,0,0,0,0,4,4,0,3,1,0,3,0
472644,523_16_28,NIGERIA,0,TOTALS,NIGERIA,200,24,58,41.4,17,38,44.7,7,20,35,14,19,73.7,10,23,33,11,16,18,3,4,69
472645,523_16_28,BRAZIL,14848,5,raulzinho neto,14,2,4,50,2,3,66.7,0,1,0,0,0,0,1,1,2,5,0,1,0,0,4
472646,523_16_28,BRAZIL,16960,6,cristiano felicio,16,1,3,33.3,1,3,33.3,0,0,0,0,2,0,3,3,6,2,2,1,1,0,2
472647,523_16_28,BRAZIL,7625,8,vitor benite,22,6,11,54.5,3,4,75,3,7,42.9,0,0,0,1,1,2,1,1,0,1,0,15
472648,523_16_28,BRAZIL,4098,9,marcelinho huertas,26,3,7,42.9,3,5,60,0,2,0,6,6,100,3,3,6,11,2,3,1,0,12
472649,523_16_28,BRAZIL,4102,10,alex garcia,22,6,10,60,6,8,75,0,2,0,1,1,100,0,2,2,1,3,1,0,0,13
472650,523_16_28,BRAZIL,4104,12,guilherme giovannoni,11,0,5,0,0,3,0,0,2,0,0,0,0,2,3,5,0,0,0,0,1,0
472651,523_16_28,BRAZIL,9844,13,nene hilario,24,8,12,66.7,7,11,63.6,1,1,100,2,2,100,4,3,7,4,2,1,3,1,19
472652,523_16_28,BRAZIL,9845,14,marcus vinicius marquinhos,13,1,5,20,1,3,33.3,0,2,0,0,0,0,0,2,2,0,0,0,0,0,2
472653,523_16_28,BRAZIL,4100,19,leandro barbosa,23,3,10,30,3,6,50,0,4,0,1,2,50,0,4,4,3,2,1,3,0,7
472654,523_16_28,BRAZIL,19019,23,augusto lima,0,0,0,0,0,0,0,0,0,0,0,0,0,0,0,0,0,0,0,0,0,0
472655,523_16_28,BRAZIL,23752,30,rafael hettsheimeir,28,4,8,50,1,2,50,3,6,50,1,2,50,5,1,6,0,4,0,1,0,12
472656,523_16_28,BRAZIL,7622,55,rafael luz,0,0,0,0,0,0,0,0,0,0,0,0,0,0,0,0,0,0,0,0,0,0
472657,523_16_28,BRAZIL,0,TOTALS,BRAZIL,200,34,75,45.3,27,48,56.2,7,27,25.9,11,15,73.3,20,24,44,27,16,11,10,2,86
472658,523_16_29,SPAIN,61,4,pau gasol,28,8,17,47.1,7,14,50,1,3,33.3,2,3,66.7,2,11,13,1,2,3,0,2,19
472659,523_16_29,SPAIN,70,5,rudy fernandez,30,8,10,80,4,5,80,4,5,80,3,4,75,0,7,7,2,1,2,1,0,23
472660,523_16_29,SPAIN,1877,6,sergio rodriguez,21,2,4,50,1,1,100,1,3,33.3,0,1,0,1,1,2,6,3,5,1,0,5
472661,523_16_29,SPAIN,64,7,juan-carlos navarro,12,2,2,100,1,1,100,1,1,100,1,1,100,0,1,1,1,4,0,1,0,6
472662,523_16_29,SPAIN,65,8,jose manuel calderon,7,2,4,50,2,2,100,0,2,0,2,2,100,0,0,0,0,1,0,1,0,6
472663,523_16_29,SPAIN,66,9,felipe reyes,15,2,6,33.3,2,6,33.3,0,0,0,1,3,33.3,1,4,5,0,3,1,0,1,5
472664,523_16_29,SPAIN,2628,10,victor claver,11,0,1,0,0,1,0,0,0,0,0,0,0,0,2,2,0,2,1,0,0,0
472665,523_16_29,SPAIN,17609,14,willy hernangomez,6,1,1,100,1,1,100,0,0,0,2,2,100,1,1,2,0,1,1,0,0,4
472666,523_16_29,SPAIN,19988,21,alex abrines,1,0,1,0,0,0,0,0,1,0,2,2,100,0,0,0,0,0,0,0,1,2
472667,523_16_29,SPAIN,1871,23,sergio llull,21,4,8,50,4,7,57.1,0,1,0,2,2,100,1,0,1,5,4,1,1,0,10
472668,523_16_29,SPAIN,17234,44,nikola mirotic,28,3,8,37.5,1,3,33.3,2,5,40,2,2,100,0,5,5,3,2,2,0,1,10
472669,523_16_29,SPAIN,6259,79,ricky rubio,19,0,4,0,0,3,0,0,1,0,2,4,50,1,4,5,4,1,1,3,0,2
472670,523_16_29,SPAIN,0,TOTALS,SPAIN,200,32,66,48.5,23,44,52.3,9,22,40.9,19,26,73.1,8,36,44,22,24,17,8,5,92
472671,523_16_29,ARGENTINA,80,4,luis scola,27,2,6,33.3,1,3,33.3,1,3,33.3,2,2,100,1,4,5,1,4,1,0,0,7
472672,523_16_29,ARGENTINA,74,5,manu ginobili,19,6,11,54.5,2,5,40,4,6,66.7,0,0,0,1,4,5,2,2,0,0,0,16
472673,523_16_29,ARGENTINA,21037,7,facundo campazzo,21,4,8,50,3,4,75,1,4,25,1,2,50,0,1,1,1,4,0,0,0,10
472674,523_16_29,ARGENTINA,12228,8,nicolas laprovittola,29,5,14,35.7,4,9,44.4,1,5,20,10,11,90.9,0,1,1,4,4,5,4,0,21
472675,523_16_29,ARGENTINA,25732,9,nicolas brussino,8,1,3,33.3,1,2,50,0,1,0,0,0,0,0,2,2,0,1,0,0,0,2
472676,523_16_29,ARGENTINA,83,10,carlos delfino,13,0,5,0,0,2,0,0,3,0,1,2,50,0,4,4,1,0,0,1,0,1
472677,523_16_29,ARGENTINA,14903,12,marcos delia,10,1,2,50,1,2,50,0,0,0,0,0,0,2,3,5,0,1,1,0,0,2
472678,523_16_29,ARGENTINA,82,13,andres nocioni,19,2,7,28.6,2,5,40,0,2,0,2,2,100,0,2,2,0,3,3,2,1,6
472679,523_16_29,ARGENTINA,15007,14,gabriel deck,11,0,2,0,0,1,0,0,1,0,0,0,0,0,1,1,0,1,0,0,0,0
472680,523_16_29,ARGENTINA,459,19,leo mainoldi,13,2,2,100,0,0,0,2,2,100,0,0,0,0,2,2,0,0,1,0,0,6
472681,523_16_29,ARGENTINA,12296,29,patricio garino,18,0,3,0,0,2,0,0,1,0,0,0,0,0,1,1,0,4,1,3,0,0
472682,523_16_29,ARGENTINA,30898,35,roberto acuna,12,0,1,0,0,1,0,0,0,0,2,2,100,0,0,0,0,2,3,1,1,2
472683,523_16_29,ARGENTINA,0,TOTALS,ARGENTINA,200,23,64,35.9,14,36,38.9,9,28,32.1,18,21,85.7,4,27,31,9,27,15,11,2,73
472684,523_16_30,LITHUANIA,1726,5,mantas kalnietis,40,10,12,83.3,6,6,100,4,6,66.7,2,2,100,0,1,1,11,2,3,1,0,26
472685,523_16_30,LITHUANIA,6225,7,adas juskevicius,0,0,0,0,0,0,0,0,0,0,0,0,0,0,0,0,0,0,0,0,0,0
472686,523_16_30,LITHUANIA,980,8,jonas maciulis,34,2,8,25,1,3,33.3,1,5,20,1,2,50,0,5,5,2,1,2,4,0,6
472687,523_16_30,LITHUANIA,3474,10,renaldas seibutis,22,3,3,100,2,2,100,1,1,100,0,0,0,0,1,1,4,4,0,1,0,7
472688,523_16_30,LITHUANIA,22216,11,domantas sabonis,10,1,5,20,1,5,20,0,0,0,0,0,0,0,3,3,0,3,1,0,0,2
472689,523_16_30,LITHUANIA,3476,12,antanas kavaliauskas,0,0,0,0,0,0,0,0,0,0,0,0,0,0,0,0,0,0,0,0,0,0
472690,523_16_30,LITHUANIA,987,13,paulius jankunas,28,7,11,63.6,3,4,75,4,7,57.1,0,0,0,1,4,5,2,4,1,1,1,18
472691,523_16_30,LITHUANIA,24,15,robertas javtokas,0,0,0,0,0,0,0,0,0,0,0,0,0,0,0,0,0,0,0,0,0,0
472692,523_16_30,LITHUANIA,10916,17,jonas valanciunas,33,6,15,40,6,15,40,0,0,0,1,2,50,2,4,6,0,2,3,0,1,13
472693,523_16_30,LITHUANIA,10639,19,mindaugas kuzminskas,15,1,5,20,0,0,0,1,5,20,0,0,0,0,2,2,1,2,1,0,0,3
472694,523_16_30,LITHUANIA,17690,40,marius grigonis,18,2,8,25,2,4,50,0,4,0,2,2,100,1,1,2,2,2,0,1,0,6
472695,523_16_30,LITHUANIA,15948,93,vaidas kariniauskas,0,0,0,0,0,0,0,0,0,0,0,0,0,0,0,0,0,0,0,0,0,0
472696,523_16_30,LITHUANIA,0,TOTALS,LITHUANIA,200,32,67,47.8,21,39,53.8,11,28,39.3,6,8,75,5,22,27,22,20,11,8,2,81
472697,523_16_30,CROATIA,13759,4,luka babic,20,3,4,75,2,2,100,1,2,50,0,0,0,0,3,3,4,1,0,1,0,7
472698,523_16_30,CROATIA,7990,5,filip kruslin,0,0,0,0,0,0,0,0,0,0,0,0,0,0,0,0,0,0,0,0,0,0
472699,523_16_30,CROATIA,1915,6,rok stipcevic,0,0,0,0,0,0,0,0,0,0,0,0,0,0,0,0,0,0,0,0,0,0
472700,523_16_30,CROATIA,1249,7,krunoslav simon,29,6,11,54.5,3,6,50,3,5,60,4,4,100,0,10,10,6,2,4,1,0,19
472701,523_16_30,CROATIA,18415,8,mario hezonja,23,2,4,50,0,1,0,2,3,66.7,0,0,0,1,3,4,0,1,0,1,0,6
472702,523_16_30,CROATIA,15894,9,dario saric,38,7,12,58.3,6,9,66.7,1,3,33.3,3,4,75,0,6,6,3,1,2,1,0,18
472703,523_16_30,CROATIA,4585,10,roko ukic,20,0,2,0,0,2,0,0,0,0,0,0,0,1,2,3,3,1,1,1,0,0
472704,523_16_30,CROATIA,12600,12,darko planinic,23,4,6,66.7,4,6,66.7,0,0,0,2,3,66.7,1,3,4,0,0,1,0,0,10
472705,523_16_30,CROATIA,10624,15,miro bilan,14,3,6,50,3,6,50,0,0,0,2,2,100,1,1,2,0,4,1,0,0,8
472706,523_16_30,CROATIA,7991,33,zeljko sakic,1,0,0,0,0,0,0,0,0,0,0,0,0,0,0,0,0,1,0,0,0,0
472707,523_16_30,CROATIA,20277,35,marko arapovic,0,0,0,0,0,0,0,0,0,0,0,0,0,0,0,0,0,0,0,0,0,0
472708,523_16_30,CROATIA,6280,44,bojan bogdanovic,34,7,15,46.7,3,9,33.3,4,6,66.7,4,5,80,0,2,2,1,3,5,1,0,22
472709,523_16_30,CROATIA,0,TOTALS,CROATIA,200,32,60,53.3,21,41,51.2,11,19,57.9,15,18,83.3,6,31,37,17,14,15,6,0,90
472710,523_16_31,AUSTRALIA,9039,4,chris goulding,4,0,0,0,0,0,0,0,0,0,0,0,0,0,1,1,0,0,0,0,0,0
472711,523_16_31,AUSTRALIA,9045,5,patty mills,27,8,15,53.3,3,4,75,5,11,45.5,3,4,75,1,0,1,0,2,1,0,0,24
472712,523_16_31,AUSTRALIA,135,6,andrew bogut,20,3,4,75,3,4,75,0,0,0,0,0,0,1,6,7,6,4,1,0,0,6
472713,523_16_31,AUSTRALIA,11635,7,joe ingles,27,4,7,57.1,4,4,100,0,3,0,2,2,100,0,2,2,5,3,1,2,0,10
472714,523_16_31,AUSTRALIA,13811,8,matthew dellavedova,19,5,12,41.7,1,5,20,4,7,57.1,1,1,100,0,1,1,3,0,1,1,0,15
472715,523_16_31,AUSTRALIA,13813,9,ryan broekhoff,20,2,5,40,1,3,33.3,1,2,50,2,2,100,0,3,3,4,1,1,0,1,7
472716,523_16_31,AUSTRALIA,25376,10,cameron bairstow,0,0,0,0,0,0,0,0,0,0,0,0,0,0,0,0,0,0,0,0,0,0
472717,523_16_31,AUSTRALIA,30889,11,kevin lisch,15,0,1,0,0,1,0,0,0,0,0,0,0,0,2,2,2,2,2,1,0,0
472718,523_16_31,AUSTRALIA,16519,12,aron baynes,23,7,9,77.8,7,9,77.8,0,0,0,2,3,66.7,1,4,5,3,0,0,0,0,16
472719,523_16_31,AUSTRALIA,142,13,david andersen,26,2,6,33.3,2,4,50,0,2,0,2,3,66.7,3,3,6,3,1,1,0,0,6
472720,523_16_31,AUSTRALIA,13814,14,brock motum,4,1,2,50,1,2,50,0,0,0,2,2,100,0,0,0,0,0,0,0,0,4
472721,523_16_31,AUSTRALIA,16520,15,damian martin,16,1,2,50,1,2,50,0,0,0,0,0,0,0,1,1,4,5,0,4,0,2
472722,523_16_31,AUSTRALIA,0,TOTALS,AUSTRALIA,200,33,63,52.4,23,38,60.5,10,25,40,14,17,82.4,6,25,31,30,18,9,8,1,90
472723,523_16_31,LITHUANIA,1726,5,mantas kalnietis,30,6,13,46.2,6,10,60,0,3,0,0,2,0,1,2,3,5,3,1,1,1,12
472724,523_16_31,LITHUANIA,6225,7,adas juskevicius,15,2,4,50,1,1,100,1,3,33.3,0,0,0,0,0,0,2,3,2,1,0,5
472725,523_16_31,LITHUANIA,980,8,jonas maciulis,12,2,6,33.3,0,4,0,2,2,100,0,0,0,0,3,3,0,5,2,0,0,6
472726,523_16_31,LITHUANIA,3474,10,renaldas seibutis,25,4,7,57.1,4,5,80,0,2,0,0,0,0,0,1,1,3,1,2,1,1,8
472727,523_16_31,LITHUANIA,22216,11,domantas sabonis,14,0,3,0,0,1,0,0,2,0,1,4,25,1,3,4,0,2,1,0,0,1
472728,523_16_31,LITHUANIA,3476,12,antanas kavaliauskas,16,5,6,83.3,5,6,83.3,0,0,0,2,2,100,0,1,1,0,0,1,0,0,12
472729,523_16_31,LITHUANIA,987,13,paulius jankunas,8,2,3,66.7,1,2,50,1,1,100,0,0,0,0,1,1,0,1,0,0,1,5
472730,523_16_31,LITHUANIA,24,15,robertas javtokas,0,0,0,0,0,0,0,0,0,0,0,0,0,0,0,0,0,0,0,0,0,0
472731,523_16_31,LITHUANIA,10916,17,jonas valanciunas,24,2,5,40,2,5,40,0,0,0,1,2,50,2,6,8,0,1,0,0,1,5
472732,523_16_31,LITHUANIA,10639,19,mindaugas kuzminskas,31,3,7,42.9,3,6,50,0,1,0,0,0,0,3,3,6,2,3,3,0,0,6
472733,523_16_31,LITHUANIA,17690,40,marius grigonis,20,0,2,0,0,1,0,0,1,0,0,0,0,0,0,0,2,3,2,0,0,0
472734,523_16_31,LITHUANIA,15948,93,vaidas kariniauskas,5,2,2,100,2,2,100,0,0,0,0,2,0,1,0,1,0,0,1,1,0,4
472735,523_16_31,LITHUANIA,0,TOTALS,LITHUANIA,200,28,58,48.3,24,43,55.8,4,15,26.7,4,12,33.3,9,23,32,14,22,17,4,4,64
472736,523_16_32,SPAIN,61,4,pau gasol,23,2,7,28.6,2,6,33.3,0,1,0,1,3,33.3,1,7,8,3,1,1,0,3,5
472737,523_16_32,SPAIN,70,5,rudy fernandez,24,2,7,28.6,0,0,0,2,7,28.6,0,0,0,1,0,1,2,1,1,1,0,6
472738,523_16_32,SPAIN,1877,6,sergio rodriguez,16,3,5,60,3,3,100,0,2,0,0,0,0,0,1,1,4,3,0,1,0,6
472739,523_16_32,SPAIN,64,7,juan-carlos navarro,15,2,5,40,2,2,100,0,3,0,0,0,0,0,0,0,5,1,1,0,0,4
472740,523_16_32,SPAIN,65,8,jose manuel calderon,6,1,3,33.3,1,1,100,0,2,0,0,0,0,0,0,0,0,0,1,0,0,2
472741,523_16_32,SPAIN,66,9,felipe reyes,11,1,2,50,1,2,50,0,0,0,5,5,100,0,2,2,0,1,3,0,0,7
472742,523_16_32,SPAIN,2628,10,victor claver,16,0,1,0,0,1,0,0,0,0,2,2,100,0,2,2,2,3,0,1,0,2
472743,523_16_32,SPAIN,17609,14,willy hernangomez,17,8,11,72.7,8,11,72.7,0,0,0,0,1,0,0,5,5,0,2,3,1,0,16
472744,523_16_32,SPAIN,19988,21,alex abrines,3,2,3,66.7,1,2,50,1,1,100,0,0,0,1,0,1,0,0,0,0,0,5
472745,523_16_32,SPAIN,1871,23,sergio llull,25,3,6,50,2,3,66.7,1,3,33.3,3,4,75,1,3,4,2,3,0,1,0,10
472746,523_16_32,SPAIN,17234,44,nikola mirotic,26,9,15,60,4,7,57.1,5,8,62.5,0,0,0,2,3,5,2,3,0,2,0,23
472747,523_16_32,SPAIN,6259,79,ricky rubio,18,2,2,100,1,1,100,1,1,100,1,1,100,0,2,2,5,3,0,1,0,6
472748,523_16_32,SPAIN,0,TOTALS,SPAIN,200,35,67,52.2,25,39,64.1,10,28,35.7,12,16,75,8,27,35,25,21,11,8,3,92
472749,523_16_32,FRANCE,12495,4,thomas heurtel,18,2,5,40,1,4,25,1,1,100,0,0,0,0,2,2,2,2,4,0,0,5
472750,523_16_32,FRANCE,2588,5,nicolas batum,18,0,2,0,0,0,0,0,2,0,0,0,0,0,0,0,1,0,0,2,0,0
472751,523_16_32,FRANCE,2589,6,antoine diot,9,0,2,0,0,1,0,0,1,0,0,0,0,0,2,2,3,0,1,1,0,0
472752,523_16_32,FRANCE,11076,7,joffrey lauvergne,22,6,12,50,6,12,50,0,0,0,0,0,0,2,5,7,2,3,0,1,0,12
472753,523_16_32,FRANCE,1864,8,charles kahudi,8,0,2,0,0,2,0,0,0,0,0,0,0,0,1,1,0,1,0,0,0,0
472754,523_16_32,FRANCE,5047,9,tony parker,25,4,9,44.4,2,6,33.3,2,3,66.7,4,4,100,0,1,1,4,3,2,1,0,14
472755,523_16_32,FRANCE,4663,11,florent pietrus,3,0,0,0,0,0,0,0,0,0,0,0,0,0,0,0,0,2,0,0,0,0
472756,523_16_32,FRANCE,10428,12,nando de colo,29,5,9,55.6,4,7,57.1,1,2,50,2,2,100,1,1,2,2,3,2,0,1,13
472757,523_16_32,FRANCE,4665,13,boris diaw,28,3,7,42.9,2,5,40,1,2,50,1,2,50,0,2,2,5,2,4,0,0,8
472758,523_16_32,FRANCE,5044,15,mickael gelabale,13,1,6,16.7,1,4,25,0,2,0,3,3,100,2,2,4,1,2,0,0,0,5
472759,523_16_32,FRANCE,17374,16,rudy gobert,18,2,6,33.3,2,6,33.3,0,0,0,3,5,60,5,7,12,0,1,1,1,1,7
472760,523_16_32,FRANCE,7987,17,kim tillie,9,1,2,50,0,1,0,1,1,100,0,0,0,0,2,2,1,2,1,0,0,3
472761,523_16_32,FRANCE,0,TOTALS,FRANCE,200,24,62,38.7,18,48,37.5,6,14,42.9,13,16,81.2,12,25,37,21,21,16,6,2,67
472762,523_16_33,USA,30892,4,jimmy butler,24,3,10,30,3,8,37.5,0,2,0,1,1,100,2,2,4,4,1,0,1,0,7
472763,523_16_33,USA,16599,5,kevin durant,28,9,13,69.2,2,4,50,7,9,77.8,2,2,100,0,7,7,6,0,3,1,0,27
472764,523_16_33,USA,9017,6,deandre jordan,13,1,2,50,1,2,50,0,0,0,0,0,0,2,2,4,0,0,0,0,0,2
472765,523_16_33,USA,30893,7,kyle lowry,24,2,5,40,1,1,100,1,4,25,0,0,0,0,6,6,2,4,1,0,0,5
472766,523_16_33,USA,30894,8,harrison barnes,6,1,3,33.3,0,2,0,1,1,100,0,0,0,0,1,1,0,1,0,0,0,3
472767,523_16_33,USA,25452,9,demar derozan,8,3,3,100,3,3,100,0,0,0,0,0,0,0,3,3,0,0,0,1,0,6
472768,523_16_33,USA,16977,10,kyrie irving,16,3,6,50,3,4,75,0,2,0,5,6,83.3,1,3,4,3,2,2,0,0,11
472769,523_16_33,USA,13751,11,klay thompson,20,2,8,25,2,2,100,0,6,0,0,0,0,2,2,4,1,2,2,0,0,4
472770,523_16_33,USA,25453,12,demarcus cousins,14,6,10,60,6,10,60,0,0,0,3,3,100,1,1,2,1,3,1,0,2,15
472771,523_16_33,USA,30895,13,paul george,21,8,14,57.1,7,9,77.8,1,5,20,0,2,0,4,4,8,0,3,0,3,3,17
472772,523_16_33,USA,30896,14,draymond green,13,0,5,0,0,4,0,0,1,0,1,2,50,2,1,3,2,0,1,2,1,1
472773,523_16_33,USA,113,15,carmelo anthony,13,3,10,30,2,7,28.6,1,3,33.3,0,1,0,3,2,5,2,4,0,0,0,7
472774,523_16_33,USA,0,TOTALS,USA,200,41,89,46.1,30,56,53.6,11,33,33.3,12,17,70.6,17,37,54,21,20,11,8,6,105
472775,523_16_33,ARGENTINA,80,4,luis scola,29,6,16,37.5,4,9,44.4,2,7,28.6,1,2,50,0,10,10,0,4,5,1,0,15
472776,523_16_33,ARGENTINA,74,5,manu ginobili,26,5,13,38.5,3,6,50,2,7,28.6,2,3,66.7,1,2,3,7,2,0,1,0,14
472777,523_16_33,ARGENTINA,21037,7,facundo campazzo,28,6,10,60,6,8,75,0,2,0,1,1,100,1,2,3,9,3,4,4,0,13
472778,523_16_33,ARGENTINA,12228,8,nicolas laprovittola,17,1,6,16.7,0,2,0,1,4,25,2,2,100,1,4,5,2,1,4,0,0,5
472779,523_16_33,ARGENTINA,25732,9,nicolas brussino,12,0,3,0,0,1,0,0,2,0,2,2,100,0,2,2,1,2,0,0,0,2
472780,523_16_33,ARGENTINA,83,10,carlos delfino,10,1,4,25,0,1,0,1,3,33.3,0,0,0,0,0,0,1,0,1,0,0,3
472781,523_16_33,ARGENTINA,14903,12,marcos delia,4,0,2,0,0,2,0,0,0,0,0,0,0,0,0,0,0,0,0,0,0,0
472782,523_16_33,ARGENTINA,82,13,andres nocioni,31,4,13,30.8,2,9,22.2,2,4,50,2,2,100,2,3,5,0,0,2,0,1,12
472783,523_16_33,ARGENTINA,15007,14,gabriel deck,9,1,2,50,1,2,50,0,0,0,0,0,0,0,1,1,1,2,0,0,0,2
472784,523_16_33,ARGENTINA,459,19,leo mainoldi,5,1,1,100,1,1,100,0,0,0,0,0,0,0,2,2,0,0,0,0,1,2
472785,523_16_33,ARGENTINA,12296,29,patricio garino,23,4,7,57.1,4,4,100,0,3,0,0,0,0,0,2,2,1,1,0,0,0,8
472786,523_16_33,ARGENTINA,30898,35,roberto acuna,6,1,2,50,1,2,50,0,0,0,0,0,0,2,0,2,1,0,0,0,0,2
472787,523_16_33,ARGENTINA,0,TOTALS,ARGENTINA,200,30,79,38,22,47,46.8,8,32,25,10,12,83.3,11,32,43,23,15,16,6,2,78
472788,523_16_34,CROATIA,13759,4,luka babic,19,1,1,100,1,1,100,0,0,0,2,4,50,0,1,1,2,3,2,1,0,4
472789,523_16_34,CROATIA,7990,5,filip kruslin,0,0,0,0,0,0,0,0,0,0,0,0,0,0,0,0,0,0,0,0,0,0
472790,523_16_34,CROATIA,1915,6,rok stipcevic,0,0,0,0,0,0,0,0,0,0,0,0,0,0,0,0,0,0,0,0,0,0
472791,523_16_34,CROATIA,1249,7,krunoslav simon,26,3,7,42.9,3,3,100,0,4,0,2,2,100,1,1,2,5,3,5,1,0,8
472792,523_16_34,CROATIA,18415,8,mario hezonja,27,4,8,50,2,3,66.7,2,5,40,6,6,100,0,8,8,2,2,1,0,0,16
472793,523_16_34,CROATIA,15894,9,dario saric,30,3,7,42.9,3,7,42.9,0,0,0,1,4,25,3,1,4,1,4,3,0,0,7
472794,523_16_34,CROATIA,4585,10,roko ukic,19,1,4,25,0,2,0,1,2,50,1,2,50,0,1,1,4,4,0,0,0,4
472795,523_16_34,CROATIA,12600,12,darko planinic,18,0,1,0,0,1,0,0,0,0,6,6,100,4,5,9,0,3,0,0,0,6
472796,523_16_34,CROATIA,10624,15,miro bilan,21,4,8,50,4,8,50,0,0,0,2,2,100,0,4,4,0,5,2,1,0,10
472797,523_16_34,CROATIA,7991,33,zeljko sakic,0,0,0,0,0,0,0,0,0,0,0,0,0,0,0,0,0,0,0,0,0,0
472798,523_16_34,CROATIA,20277,35,marko arapovic,0,0,0,0,0,0,0,0,0,0,0,0,0,0,0,0,0,0,0,0,0,0
472799,523_16_34,CROATIA,6280,44,bojan bogdanovic,39,7,15,46.7,3,7,42.9,4,8,50,10,12,83.3,0,3,3,2,4,4,0,0,28
472800,523_16_34,CROATIA,0,TOTALS,CROATIA,200,23,51,45.1,16,32,50,7,19,36.8,30,38,78.9,10,29,39,16,28,18,3,0,83
472801,523_16_34,SERBIA,5751,4,milos teodosic,33,2,11,18.2,1,6,16.7,1,5,20,4,5,80,0,2,2,10,5,2,0,0,9
472802,523_16_34,SERBIA,2100,5,marko simonovic,11,0,1,0,0,1,0,0,0,0,0,0,0,0,1,1,0,1,0,0,0,0
472803,523_16_34,SERBIA,17361,7,bogdan bogdanovic,26,7,11,63.6,4,7,57.1,3,4,75,1,1,100,0,1,1,5,5,0,3,0,18
472804,523_16_34,SERBIA,2654,9,stefan markovic,29,4,9,44.4,4,6,66.7,0,3,0,4,5,80,3,1,4,3,3,1,3,0,12
472805,523_16_34,SERBIA,19860,10,nikola kalinic,22,2,7,28.6,2,4,50,0,3,0,2,2,100,1,3,4,0,5,1,1,1,6
472806,523_16_34,SERBIA,15503,11,nemanja nedovic,4,0,1,0,0,0,0,0,1,0,0,0,0,0,0,0,0,1,0,0,0,0
472807,523_16_34,SERBIA,15504,12,stefan bircevic,0,0,0,0,0,0,0,0,0,0,0,0,0,0,0,0,0,0,0,0,0,0
472808,523_16_34,SERBIA,2656,13,miroslav raduljica,18,4,11,36.4,4,11,36.4,0,0,0,4,6,66.7,3,0,3,0,4,2,0,1,12
472809,523_16_34,SERBIA,22978,14,nikola jokic,24,3,8,37.5,2,6,33.3,1,2,50,5,6,83.3,0,3,3,3,2,1,2,0,12
472810,523_16_34,SERBIA,5756,15,vladimir stimac,3,0,0,0,0,0,0,0,0,0,0,0,0,0,2,2,0,0,0,0,0,0
472811,523_16_34,SERBIA,25441,24,stefan jovic,14,4,5,80,3,4,75,1,1,100,0,0,0,2,2,4,1,2,2,0,0,9
472812,523_16_34,SERBIA,6241,25,milan macvan,16,3,7,42.9,1,3,33.3,2,4,50,0,0,0,3,0,3,0,3,0,1,0,8
472813,523_16_34,SERBIA,0,TOTALS,SERBIA,200,29,71,40.8,21,48,43.8,8,23,34.8,20,25,80,14,21,35,22,31,10,10,2,86
472814,523_16_35,SPAIN,61,4,pau gasol,29,9,19,47.4,7,14,50,2,5,40,3,3,100,4,4,8,2,2,3,1,1,23
472815,523_16_35,SPAIN,70,5,rudy fernandez,28,3,7,42.9,2,2,100,1,5,20,2,2,100,2,5,7,2,2,1,3,0,9
472816,523_16_35,SPAIN,1877,6,sergio rodriguez,25,5,11,45.5,4,5,80,1,6,16.7,0,0,0,0,1,1,5,2,2,1,0,11
472817,523_16_35,SPAIN,64,7,juan-carlos navarro,15,3,9,33.3,2,7,28.6,1,2,50,2,2,100,0,3,3,0,0,1,0,0,9
472818,523_16_35,SPAIN,65,8,jose manuel calderon,0,0,0,0,0,0,0,0,0,0,0,0,0,0,0,0,0,0,0,0,0,0
472819,523_16_35,SPAIN,66,9,felipe reyes,16,0,4,0,0,3,0,0,1,0,3,4,75,2,0,2,0,3,0,1,0,3
472820,523_16_35,SPAIN,2628,10,victor claver,13,2,2,100,1,1,100,1,1,100,0,0,0,0,0,0,2,0,0,1,0,5
472821,523_16_35,SPAIN,17609,14,willy hernangomez,11,2,4,50,2,4,50,0,0,0,0,0,0,2,4,6,0,0,0,0,0,4
472822,523_16_35,SPAIN,19988,21,alex abrines,0,0,0,0,0,0,0,0,0,0,0,0,0,0,0,0,0,0,0,0,0,0
472823,523_16_35,SPAIN,1871,23,sergio llull,31,2,5,40,1,3,33.3,1,2,50,0,0,0,0,1,1,2,3,3,0,0,5
472824,523_16_35,SPAIN,17234,44,nikola mirotic,20,2,7,28.6,1,3,33.3,1,4,25,2,3,66.7,1,4,5,0,4,0,0,0,7
472825,523_16_35,SPAIN,6259,79,ricky rubio,14,0,4,0,0,4,0,0,0,0,0,2,0,1,0,1,1,3,0,1,0,0
472826,523_16_35,SPAIN,0,TOTALS,SPAIN,200,28,72,38.9,20,46,43.5,8,26,30.8,12,16,75,14,27,41,14,21,11,8,1,76
472827,523_16_35,USA,30892,4,jimmy butler,14,0,5,0,0,5,0,0,0,0,0,0,0,2,0,2,1,0,0,2,0,0
472828,523_16_35,USA,16599,5,kevin durant,31,6,13,46.2,4,8,50,2,5,40,0,1,0,2,6,8,1,3,3,0,0,14
472829,523_16_35,USA,9017,6,deandre jordan,27,4,6,66.7,4,6,66.7,0,0,0,1,4,25,3,13,16,2,2,2,1,4,9
472830,523_16_35,USA,30893,7,kyle lowry,15,4,6,66.7,3,5,60,1,1,100,0,0,0,2,1,3,3,2,0,0,0,9
472831,523_16_35,USA,30894,8,harrison barnes,0,0,0,0,0,0,0,0,0,0,0,0,0,0,0,0,0,0,0,0,0,0
472832,523_16_35,USA,25452,9,demar derozan,0,0,0,0,0,0,0,0,0,0,0,0,0,0,0,0,0,0,0,0,0,0
472833,523_16_35,USA,16977,10,kyrie irving,25,5,9,55.6,4,6,66.7,1,3,33.3,2,2,100,3,2,5,2,1,2,0,0,13
472834,523_16_35,USA,13751,11,klay thompson,35,8,16,50,4,8,50,4,8,50,2,2,100,0,4,4,3,2,2,1,1,22
472835,523_16_35,USA,25453,12,demarcus cousins,11,1,4,25,1,4,25,0,0,0,0,0,0,2,1,3,0,5,0,0,0,2
472836,523_16_35,USA,30895,13,paul george,16,3,8,37.5,3,5,60,0,3,0,0,0,0,3,3,6,1,3,2,2,0,6
472837,523_16_35,USA,30896,14,draymond green,2,0,1,0,0,0,0,0,1,0,0,0,0,0,0,0,0,0,0,0,0,0
472838,523_16_35,USA,113,15,carmelo anthony,25,2,11,18.2,1,6,16.7,1,5,20,2,5,40,3,2,5,2,2,2,0,1,7
472839,523_16_35,USA,0,TOTALS,USA,200,33,79,41.8,24,53,45.3,9,26,34.6,7,14,50,21,32,53,15,20,13,6,6,82
472840,523_16_36,AUSTRALIA,9039,4,chris goulding,8,0,4,0,0,1,0,0,3,0,0,0,0,0,0,0,0,0,1,0,0,0
472841,523_16_36,AUSTRALIA,9045,5,patty mills,29,6,16,37.5,5,7,71.4,1,9,11.1,0,0,0,0,0,0,2,0,1,1,0,13
472842,523_16_36,AUSTRALIA,135,6,andrew bogut,22,1,4,25,1,4,25,0,0,0,2,4,50,0,1,1,0,4,1,0,2,4
472843,523_16_36,AUSTRALIA,11635,7,joe ingles,30,5,10,50,5,6,83.3,0,4,0,2,2,100,1,6,7,1,3,5,2,0,12
472844,523_16_36,AUSTRALIA,13811,8,matthew dellavedova,22,1,6,16.7,1,4,25,0,2,0,1,2,50,0,2,2,2,2,3,0,0,3
472845,523_16_36,AUSTRALIA,13813,9,ryan broekhoff,22,1,6,16.7,0,0,0,1,6,16.7,3,3,100,1,1,2,4,2,1,1,0,6
472846,523_16_36,AUSTRALIA,25376,10,cameron bairstow,0,0,0,0,0,0,0,0,0,0,0,0,0,0,0,0,0,0,0,0,0,0
472847,523_16_36,AUSTRALIA,30889,11,kevin lisch,10,1,4,25,0,0,0,1,4,25,0,0,0,0,0,0,1,1,0,1,0,3
472848,523_16_36,AUSTRALIA,16519,12,aron baynes,21,2,5,40,2,5,40,0,0,0,3,4,75,5,3,8,2,2,2,0,1,7
472849,523_16_36,AUSTRALIA,142,13,david andersen,16,0,3,0,0,2,0,0,1,0,0,0,0,0,4,4,2,3,1,0,0,0
472850,523_16_36,AUSTRALIA,13814,14,brock motum,11,5,8,62.5,4,6,66.7,1,2,50,2,4,50,2,0,2,0,4,0,0,0,13
472851,523_16_36,AUSTRALIA,16520,15,damian martin,8,0,0,0,0,0,0,0,0,0,0,0,0,1,0,1,0,1,1,1,1,0
472852,523_16_36,AUSTRALIA,0,TOTALS,AUSTRALIA,200,22,66,33.3,18,35,51.4,4,31,12.9,13,19,68.4,13,17,30,14,22,16,6,4,61
472853,523_16_36,SERBIA,5751,4,milos teodosic,22,9,14,64.3,7,10,70,2,4,50,2,3,66.7,0,2,2,5,2,1,0,0,22
472854,523_16_36,SERBIA,2100,5,marko simonovic,7,0,0,0,0,0,0,0,0,0,0,0,0,0,2,2,0,0,1,0,0,0
472855,523_16_36,SERBIA,17361,7,bogdan bogdanovic,24,3,7,42.9,3,3,100,0,4,0,0,0,0,1,5,6,1,3,3,0,0,6
472856,523_16_36,SERBIA,2654,9,stefan markovic,27,5,5,100,3,3,100,2,2,100,2,2,100,0,3,3,5,2,3,0,0,14
472857,523_16_36,SERBIA,19860,10,nikola kalinic,27,2,5,40,2,4,50,0,1,0,2,2,100,2,4,6,3,4,2,2,0,6
472858,523_16_36,SERBIA,15503,11,nemanja nedovic,5,0,0,0,0,0,0,0,0,0,1,2,50,0,0,0,0,0,0,0,0,1
472859,523_16_36,SERBIA,15504,12,stefan bircevic,1,0,1,0,0,1,0,0,0,0,0,0,0,0,0,0,1,0,0,0,0,0
472860,523_16_36,SERBIA,2656,13,miroslav raduljica,22,4,7,57.1,4,7,57.1,0,0,0,3,4,75,2,4,6,3,3,5,2,0,11
472861,523_16_36,SERBIA,22978,14,nikola jokic,24,2,7,28.6,2,7,28.6,0,0,0,5,6,83.3,3,8,11,2,1,1,3,1,9
472862,523_16_36,SERBIA,5756,15,vladimir stimac,2,2,2,100,2,2,100,0,0,0,0,0,0,1,0,1,0,0,0,0,0,4
472863,523_16_36,SERBIA,25441,24,stefan jovic,18,1,3,33.3,1,1,100,0,2,0,0,0,0,0,1,1,1,3,1,0,0,2
472864,523_16_36,SERBIA,6241,25,milan macvan,20,4,9,44.4,3,6,50,1,3,33.3,3,4,75,1,2,3,2,4,0,2,0,12
472865,523_16_36,SERBIA,0,TOTALS,SERBIA,200,32,60,53.3,27,44,61.4,5,16,31.2,18,23,78.3,10,33,43,23,22,18,9,1,87
472866,523_16_37,AUSTRALIA,9039,4,chris goulding,0,0,0,0,0,0,0,0,0,0,0,0,0,0,0,0,0,0,0,0,0,0
472867,523_16_37,AUSTRALIA,9045,5,patty mills,37,11,23,47.8,8,14,57.1,3,9,33.3,5,6,83.3,0,1,1,2,1,4,3,0,30
472868,523_16_37,AUSTRALIA,135,6,andrew bogut,14,1,1,100,1,1,100,0,0,0,0,0,0,2,3,5,3,5,0,0,1,2
472869,523_16_37,AUSTRALIA,11635,7,joe ingles,30,1,3,33.3,1,1,100,0,2,0,2,2,100,0,5,5,1,3,2,0,0,4
472870,523_16_37,AUSTRALIA,13811,8,matthew dellavedova,24,3,6,50,3,6,50,0,0,0,0,0,0,0,4,4,8,4,2,0,0,6
472871,523_16_37,AUSTRALIA,13813,9,ryan broekhoff,17,5,5,100,2,2,100,3,3,100,0,0,0,1,0,1,0,0,0,0,0,13
472872,523_16_37,AUSTRALIA,25376,10,cameron bairstow,0,0,0,0,0,0,0,0,0,0,0,0,0,0,0,0,0,0,0,0,0,0
472873,523_16_37,AUSTRALIA,30889,11,kevin lisch,11,0,2,0,0,2,0,0,0,0,0,0,0,3,3,6,0,0,0,0,0,0
472874,523_16_37,AUSTRALIA,16519,12,aron baynes,24,3,8,37.5,3,8,37.5,0,0,0,0,0,0,1,3,4,1,4,3,0,0,6
472875,523_16_37,AUSTRALIA,142,13,david andersen,27,4,8,50,3,6,50,1,2,50,6,7,85.7,2,3,5,3,4,1,0,1,15
472876,523_16_37,AUSTRALIA,13814,14,brock motum,16,6,8,75,6,7,85.7,0,1,0,0,0,0,2,4,6,1,1,1,1,1,12
472877,523_16_37,AUSTRALIA,16520,15,damian martin,3,0,1,0,0,1,0,0,0,0,0,0,0,0,0,0,1,0,0,0,0,0
472878,523_16_37,AUSTRALIA,0,TOTALS,AUSTRALIA,200,34,65,52.3,27,48,56.2,7,17,41.2,13,15,86.7,11,29,40,20,22,15,4,3,88
472879,523_16_37,SPAIN,61,4,pau gasol,33,12,15,80,11,13,84.6,1,2,50,6,9,66.7,4,7,11,2,1,1,0,1,31
472880,523_16_37,SPAIN,70,5,rudy fernandez,26,3,7,42.9,1,3,33.3,2,4,50,2,3,66.7,0,0,0,2,3,0,1,0,10
472881,523_16_37,SPAIN,1877,6,sergio rodriguez,24,4,11,36.4,3,6,50,1,5,20,2,2,100,0,0,0,5,2,1,0,0,11
472882,523_16_37,SPAIN,64,7,juan-carlos navarro,17,1,4,25,1,1,100,0,3,0,1,1,100,0,1,1,2,3,0,0,0,3
472883,523_16_37,SPAIN,65,8,jose manuel calderon,0,0,0,0,0,0,0,0,0,0,0,0,0,0,0,0,0,0,0,0,0,0
472884,523_16_37,SPAIN,66,9,felipe reyes,11,2,4,50,1,3,33.3,1,1,100,2,4,50,1,2,3,1,1,0,1,0,7
472885,523_16_37,SPAIN,2628,10,victor claver,15,2,3,66.7,0,0,0,2,3,66.7,0,0,0,0,0,0,1,4,1,2,0,6
472886,523_16_37,SPAIN,17609,14,willy hernangomez,5,1,2,50,1,2,50,0,0,0,0,0,0,1,0,1,0,1,1,1,0,2
472887,523_16_37,SPAIN,19988,21,alex abrines,0,0,0,0,0,0,0,0,0,0,0,0,0,0,0,0,0,0,0,0,0,0
472888,523_16_37,SPAIN,1871,23,sergio llull,23,1,9,11.1,1,5,20,0,4,0,0,0,0,1,0,1,2,1,0,1,1,2
472889,523_16_37,SPAIN,17234,44,nikola mirotic,30,5,11,45.5,2,8,25,3,3,100,1,2,50,3,4,7,1,3,1,2,1,14
472890,523_16_37,SPAIN,6259,79,ricky rubio,16,1,4,25,1,2,50,0,2,0,1,1,100,0,3,3,4,3,1,0,0,3
472891,523_16_37,SPAIN,0,TOTALS,SPAIN,200,32,70,45.7,22,43,51.2,10,27,37,15,22,68.2,11,19,30,20,22,7,8,3,89
472892,523_16_38,SERBIA,5751,4,milos teodosic,25,4,11,36.4,4,6,66.7,0,5,0,1,2,50,0,2,2,3,2,3,0,0,9
472893,523_16_38,SERBIA,2100,5,marko simonovic,14,1,5,20,0,1,0,1,4,25,0,0,0,0,2,2,1,1,0,1,0,3
472894,523_16_38,SERBIA,17361,7,bogdan bogdanovic,28,2,12,16.7,2,5,40,0,7,0,3,3,100,0,3,3,3,4,5,4,0,7
472895,523_16_38,SERBIA,2654,9,stefan markovic,19,1,6,16.7,0,4,0,1,2,50,0,0,0,1,1,2,2,3,1,1,0,3
472896,523_16_38,SERBIA,19860,10,nikola kalinic,10,1,2,50,1,2,50,0,0,0,0,0,0,0,1,1,1,5,0,0,0,2
472897,523_16_38,SERBIA,15503,11,nemanja nedovic,16,6,10,60,5,7,71.4,1,3,33.3,1,1,100,0,1,1,2,0,2,2,0,14
472898,523_16_38,SERBIA,15504,12,stefan bircevic,8,0,0,0,0,0,0,0,0,0,1,2,50,0,3,3,0,1,3,0,0,1
472899,523_16_38,SERBIA,2656,13,miroslav raduljica,17,3,6,50,3,6,50,0,0,0,1,2,50,1,2,3,0,3,1,0,1,7
472900,523_16_38,SERBIA,22978,14,nikola jokic,24,3,5,60,3,5,60,0,0,0,0,0,0,1,3,4,2,3,0,2,1,6
472901,523_16_38,SERBIA,5756,15,vladimir stimac,6,0,1,0,0,1,0,0,0,0,0,0,0,1,2,3,1,0,0,0,0,0
472902,523_16_38,SERBIA,25441,24,stefan jovic,17,1,4,25,1,3,33.3,0,1,0,1,2,50,1,0,1,3,1,0,1,0,3
472903,523_16_38,SERBIA,6241,25,milan macvan,16,4,6,66.7,3,4,75,1,2,50,2,2,100,1,1,2,0,0,2,0,0,11
472904,523_16_38,SERBIA,0,TOTALS,SERBIA,200,26,68,38.2,22,44,50,4,24,16.7,10,14,71.4,9,24,33,18,23,18,11,2,66
472905,523_16_38,USA,30892,4,jimmy butler,14,1,3,33.3,1,3,33.3,0,0,0,0,0,0,4,1,5,1,3,0,0,1,2
472906,523_16_38,USA,16599,5,kevin durant,30,10,19,52.6,5,8,62.5,5,11,45.5,5,6,83.3,0,3,3,4,2,2,2,1,30
472907,523_16_38,USA,9017,6,deandre jordan,13,2,3,66.7,2,3,66.7,0,0,0,0,1,0,2,3,5,0,1,1,0,3,4
472908,523_16_38,USA,30893,7,kyle lowry,22,2,5,40,1,2,50,1,3,33.3,0,0,0,0,5,5,5,2,2,2,0,5
472909,523_16_38,USA,30894,8,harrison barnes,6,1,2,50,1,1,100,0,1,0,0,0,0,0,0,0,1,0,1,1,0,2
472910,523_16_38,USA,25452,9,demar derozan,11,3,4,75,3,4,75,0,0,0,0,0,0,0,2,2,2,1,3,0,1,6
472911,523_16_38,USA,16977,10,kyrie irving,17,1,6,16.7,1,4,25,0,2,0,2,2,100,0,3,3,4,4,1,0,0,4
472912,523_16_38,USA,13751,11,klay thompson,22,5,11,45.5,3,5,60,2,6,33.3,0,0,0,2,1,3,1,1,1,2,0,12
472913,523_16_38,USA,25453,12,demarcus cousins,17,3,5,60,3,5,60,0,0,0,7,9,77.8,6,9,15,2,3,0,1,0,13
472914,523_16_38,USA,30895,13,paul george,22,2,9,22.2,1,5,20,1,4,25,4,4,100,2,0,2,2,2,1,3,0,9
472915,523_16_38,USA,30896,14,draymond green,8,1,3,33.3,1,2,50,0,1,0,0,0,0,0,1,1,0,1,3,0,0,2
472916,523_16_38,USA,113,15,carmelo anthony,18,3,7,42.9,2,4,50,1,3,33.3,0,1,0,2,5,7,2,3,1,1,0,7
472917,523_16_38,USA,0,TOTALS,USA,200,34,77,44.2,24,46,52.2,10,31,32.3,18,23,78.3,20,34,54,24,23,16,12,6,96
473906,525_16_01,GREECE,30906,4,giannis athinaiou,17,1,4,25,0,1,0,1,3,33.3,1,2,50,0,1,1,2,4,1,1,0,4
473907,525_16_01,GREECE,12472,8,nick calathes,19,3,5,60,3,5,60,0,0,0,0,0,0,0,0,0,6,0,2,2,1,6
473908,525_16_01,GREECE,5050,9,ioannis bourousis,17,5,11,45.5,4,7,57.1,1,4,25,0,0,0,2,2,4,2,2,2,0,0,11
473909,525_16_01,GREECE,8303,17,evangelos mantzaris,21,1,2,50,0,1,0,1,1,100,0,0,0,0,2,2,4,2,2,2,0,3
473910,525_16_01,GREECE,17670,18,dimitrios agravanis,19,2,5,40,0,0,0,2,5,40,2,2,100,0,5,5,0,2,3,1,1,8
473911,525_16_01,GREECE,15972,19,ioannis papapetrou,21,1,4,25,1,2,50,0,2,0,1,2,50,1,5,6,1,2,1,2,0,3
473912,525_16_01,GREECE,20341,25,vasilis charalampopoulos,7,0,1,0,0,1,0,0,0,0,0,0,0,0,1,1,1,0,0,0,0,0
473913,525_16_01,GREECE,2645,31,georgios bogris,3,0,1,0,0,1,0,0,0,0,0,0,0,0,1,1,0,0,0,1,0,0
473914,525_16_01,GREECE,1057,33,efstratios perperoglou,19,4,5,80,2,2,100,2,3,66.7,2,2,100,0,0,0,2,0,1,3,0,12
473915,525_16_01,GREECE,24314,34,giannis antetokounmpo,19,7,8,87.5,5,5,100,2,3,66.7,0,0,0,0,3,3,2,2,2,2,2,16
473916,525_16_01,GREECE,10607,41,kostas koufos,20,4,8,50,4,8,50,0,0,0,2,5,40,2,2,4,1,1,0,1,0,10
473917,525_16_01,GREECE,30907,43,thanasis antetokounmpo,18,2,6,33.3,2,3,66.7,0,3,0,1,2,50,0,1,1,0,0,0,2,3,5
473918,525_16_01,GREECE,0,TOTALS,GREECE,200,30,60,50,21,36,58.3,9,24,37.5,9,15,60,8,23,31,21,15,15,17,7,78
473919,525_16_01,IRAN,30908,4,adnan doraghi,12,0,3,0,0,1,0,0,2,0,0,0,0,0,1,1,1,2,1,3,0,0
473920,525_16_01,IRAN,14400,5,sajjad mashayekhi,6,0,1,0,0,1,0,0,0,0,0,0,0,0,0,0,1,1,0,0,0,0
473921,525_16_01,IRAN,30909,6,farid aslani,14,0,1,0,0,0,0,0,1,0,0,0,0,0,1,1,1,2,2,0,0,0
473922,525_16_01,IRAN,13743,7,mohammad hassanzadeh,9,1,3,33.3,1,3,33.3,0,0,0,0,0,0,0,1,1,1,0,1,1,0,2
473923,525_16_01,IRAN,22994,8,behnam yakhchali,29,4,8,50,0,0,0,4,8,50,0,0,0,0,2,2,2,3,4,1,0,12
473924,525_16_01,IRAN,14408,9,arman zangeneh,14,1,3,33.3,0,1,0,1,2,50,0,0,0,0,0,0,2,1,1,0,1,3
473925,525_16_01,IRAN,14407,10,amir sedighi,2,0,1,0,0,0,0,0,1,0,0,0,0,0,1,1,0,0,0,0,0,0
473926,525_16_01,IRAN,9690,11,oshin sahakian,31,1,4,25,0,1,0,1,3,33.3,0,0,0,1,7,8,0,2,1,0,0,3
473927,525_16_01,IRAN,16613,12,asghar kardoust,4,1,1,100,1,1,100,0,0,0,0,0,0,0,1,1,0,1,1,0,0,2
473928,525_16_01,IRAN,13739,13,mohammad jamshidijafarabadi,26,5,12,41.7,3,8,37.5,2,4,50,1,2,50,0,1,1,5,2,7,0,0,13
473929,525_16_01,IRAN,13745,14,arsalan kazemi,29,1,2,50,1,2,50,0,0,0,0,0,0,1,4,5,1,2,4,1,0,2
473930,525_16_01,IRAN,9693,15,hamed hadadi,22,6,13,46.2,5,11,45.5,1,2,50,3,4,75,1,3,4,1,4,3,0,0,16
473931,525_16_01,IRAN,0,TOTALS,IRAN,200,20,52,38.5,11,29,37.9,9,23,39.1,4,6,66.7,7,23,30,15,20,27,6,1,53
473932,525_16_02,TUNISIA,9218,1,omar mouhli,0,0,0,0,0,0,0,0,0,0,0,0,0,0,0,0,0,0,0,0,0,0
473933,525_16_02,TUNISIA,7938,2,ziyed chennoufi,13,1,5,20,0,3,0,1,2,50,0,0,0,0,0,0,1,2,0,1,0,3
473934,525_16_02,TUNISIA,28113,3,mehdi seyeh,22,0,5,0,0,2,0,0,3,0,0,0,0,0,2,2,1,5,1,2,0,0
473935,525_16_02,TUNISIA,18347,4,omar abada,3,0,0,0,0,0,0,0,0,0,1,2,50,0,0,0,0,0,0,0,0,1
473936,525_16_02,TUNISIA,18521,7,mourad el mabrouk,24,4,8,50,1,2,50,3,6,50,0,0,0,0,1,1,1,4,2,0,0,11
473937,525_16_02,TUNISIA,13953,11,mohamed mokhtar ghyaza,31,2,6,33.3,2,6,33.3,0,0,0,5,8,62.5,1,4,5,0,1,0,1,1,9
473938,525_16_02,TUNISIA,28114,20,michael brandon roll,34,3,16,18.8,2,9,22.2,1,7,14.3,2,2,100,0,2,2,5,2,1,1,0,9
473939,525_16_02,TUNISIA,30910,23,firas lahiani,12,1,6,16.7,1,5,20,0,1,0,0,0,0,0,2,2,0,1,0,1,0,2
473940,525_16_02,TUNISIA,28112,30,mohamed abbassi,8,0,2,0,0,2,0,0,0,0,0,0,0,0,1,1,0,1,0,0,0,0
473941,525_16_02,TUNISIA,9216,66,nizar knioua,14,0,2,0,0,1,0,0,1,0,0,0,0,0,0,0,1,2,1,0,0,0
473942,525_16_02,TUNISIA,9220,86,hamdi braa,38,2,6,33.3,2,6,33.3,0,0,0,2,4,50,1,8,9,0,2,3,3,0,6
473943,525_16_02,TUNISIA,13954,89,makram ben romdhane,0,0,0,0,0,0,0,0,0,0,0,0,0,0,0,0,0,0,0,0,0,0
473944,525_16_02,TUNISIA,0,TOTALS,TUNISIA,200,13,56,23.2,8,36,22.2,5,20,25,10,16,62.5,3,21,24,9,20,11,9,1,41
473945,525_16_02,ITALY,15270,2,giuseppe poeta,15,1,1,100,1,1,100,0,0,0,1,2,50,0,3,3,2,1,3,0,0,3
473946,525_16_02,ITALY,1272,3,marco belinelli,16,4,7,57.1,1,2,50,3,5,60,0,0,0,0,0,0,0,1,0,1,0,11
473947,525_16_02,ITALY,7944,4,pietro aradori,21,4,6,66.7,1,2,50,3,4,75,2,2,100,0,4,4,2,3,1,1,0,13
473948,525_16_02,ITALY,12988,5,alessandro gentile,18,4,5,80,4,5,80,0,0,0,0,0,0,1,4,5,1,1,4,1,0,8
473949,525_16_02,ITALY,1270,7,andrea bargnani,17,7,12,58.3,7,12,58.3,0,0,0,1,3,33.3,1,5,6,2,0,0,1,0,15
473950,525_16_02,ITALY,2667,8,danilo gallinari,19,2,7,28.6,2,5,40,0,2,0,2,2,100,0,9,9,1,0,2,0,0,6
473951,525_16_02,ITALY,10968,9,nicolo melli,21,1,5,20,1,3,33.3,0,2,0,0,0,0,1,4,5,3,4,1,0,1,2
473952,525_16_02,ITALY,15319,12,marco cusin,16,0,0,0,0,0,0,0,0,0,4,4,100,0,3,3,3,3,1,1,0,4
473953,525_16_02,ITALY,1861,13,luigi datome,19,0,4,0,0,3,0,0,1,0,0,0,0,0,3,3,0,2,2,0,0,0
473954,525_16_02,ITALY,19847,14,riccardo cervi,7,1,1,100,1,1,100,0,0,0,0,0,0,0,5,5,0,0,0,0,2,2
473955,525_16_02,ITALY,10444,23,daniel hackett,21,0,2,0,0,2,0,0,0,0,2,2,100,0,3,3,2,2,2,1,0,2
473956,525_16_02,ITALY,24281,27,stefano tonut,9,1,2,50,1,2,50,0,0,0,0,0,0,0,0,0,1,2,0,1,0,2
473957,525_16_02,ITALY,0,TOTALS,ITALY,200,25,52,48.1,19,38,50,6,14,42.9,12,15,80,5,44,49,17,19,17,7,3,68
473958,525_16_03,IRAN,30908,4,adnan doraghi,8,0,0,0,0,0,0,0,0,0,0,0,0,0,0,0,0,2,0,1,0,0
473959,525_16_03,IRAN,14400,5,sajjad mashayekhi,22,3,7,42.9,2,6,33.3,1,1,100,1,2,50,2,2,4,1,4,2,0,0,8
473960,525_16_03,IRAN,30909,6,farid aslani,7,0,0,0,0,0,0,0,0,0,0,0,0,0,0,0,0,1,1,0,0,0
473961,525_16_03,IRAN,13743,7,mohammad hassanzadeh,18,6,7,85.7,6,7,85.7,0,0,0,0,0,0,1,4,5,0,3,0,0,1,12
473962,525_16_03,IRAN,22994,8,behnam yakhchali,36,6,11,54.5,0,2,0,6,9,66.7,2,3,66.7,0,2,2,3,3,2,1,0,20
473963,525_16_03,IRAN,14408,9,arman zangeneh,0,0,0,0,0,0,0,0,0,0,0,0,0,0,0,0,0,0,0,0,0,0
473964,525_16_03,IRAN,14407,10,amir sedighi,0,0,0,0,0,0,0,0,0,0,0,0,0,0,0,0,0,0,0,0,0,0
473965,525_16_03,IRAN,9690,11,oshin sahakian,30,0,3,0,0,2,0,0,1,0,3,4,75,0,5,5,3,3,2,0,0,3
473966,525_16_03,IRAN,16613,12,asghar kardoust,8,0,1,0,0,1,0,0,0,0,0,4,0,0,1,1,0,0,0,0,0,0
473967,525_16_03,IRAN,13739,13,mohammad jamshidijafarabadi,29,3,9,33.3,2,4,50,1,5,20,2,2,100,1,0,1,2,3,4,0,0,9
473968,525_16_03,IRAN,13745,14,arsalan kazemi,21,2,3,66.7,2,3,66.7,0,0,0,2,2,100,2,7,9,3,4,5,1,1,6
473969,525_16_03,IRAN,9693,15,hamed hadadi,21,3,9,33.3,3,8,37.5,0,1,0,6,10,60,0,8,8,3,2,4,0,1,12
473970,525_16_03,IRAN,0,TOTALS,IRAN,200,23,50,46,15,33,45.5,8,17,47.1,16,27,59.3,6,30,36,15,25,20,3,3,70
473971,525_16_03,MEXICO,16880,4,paul stoll,28,2,7,28.6,0,1,0,2,6,33.3,3,4,75,1,2,3,4,3,1,3,0,9
473972,525_16_03,MEXICO,23812,5,marco ramos,0,0,0,0,0,0,0,0,0,0,0,0,0,0,0,0,0,0,0,0,0,0
473973,525_16_03,MEXICO,28754,6,juan toscano,21,3,9,33.3,3,8,37.5,0,1,0,1,1,100,3,2,5,1,2,1,1,1,7
473974,525_16_03,MEXICO,23756,7,jorge ivan gutierrez,29,6,13,46.2,5,11,45.5,1,2,50,2,3,66.7,1,0,1,2,1,3,3,0,15
473975,525_16_03,MEXICO,25444,8,israel gutierrez,10,0,2,0,0,2,0,0,0,0,1,2,50,2,2,4,1,5,0,1,0,1
473976,525_16_03,MEXICO,23813,9,francisco cruz,21,6,10,60,5,9,55.6,1,1,100,5,6,83.3,1,3,4,2,1,2,1,0,18
473977,525_16_03,MEXICO,21214,10,gabriel giron,7,1,2,50,1,1,100,0,1,0,0,0,0,0,0,0,0,0,0,0,0,2
473978,525_16_03,MEXICO,28774,11,edgar garibay,1,0,0,0,0,0,0,0,0,0,0,0,0,0,0,0,0,0,0,0,0,0
473979,525_16_03,MEXICO,9835,12,hector hernandez,36,2,11,18.2,1,3,33.3,1,8,12.5,0,0,0,0,8,8,1,0,1,0,1,5
473980,525_16_03,MEXICO,21215,13,orlando mendez,15,3,9,33.3,1,3,33.3,2,6,33.3,0,0,0,1,1,2,3,3,1,1,0,8
473981,525_16_03,MEXICO,12110,14,lorenzo mata,21,1,2,50,1,2,50,0,0,0,4,5,80,1,3,4,0,5,2,2,2,6
473982,525_16_03,MEXICO,25446,15,adrian zamora,11,1,3,33.3,1,3,33.3,0,0,0,2,2,100,3,1,4,1,2,1,0,1,4
473983,525_16_03,MEXICO,0,TOTALS,MEXICO,200,25,68,36.8,18,43,41.9,7,25,28,18,23,78.3,14,26,40,15,22,12,12,5,75
473984,525_16_04,ITALY,15270,2,giuseppe poeta,0,0,0,0,0,0,0,0,0,0,0,0,0,0,0,0,0,0,0,0,0,0
473985,525_16_04,ITALY,1272,3,marco belinelli,28,6,15,40,4,9,44.4,2,6,33.3,5,6,83.3,0,1,1,2,3,1,1,0,19
473986,525_16_04,ITALY,7944,4,pietro aradori,17,0,2,0,0,2,0,0,0,0,0,0,0,0,3,3,2,0,0,0,0,0
473987,525_16_04,ITALY,12988,5,alessandro gentile,18,1,8,12.5,1,5,20,0,3,0,1,2,50,2,2,4,4,3,1,1,1,3
473988,525_16_04,ITALY,1270,7,andrea bargnani,22,3,9,33.3,3,9,33.3,0,0,0,2,2,100,0,4,4,0,4,1,1,2,8
473989,525_16_04,ITALY,2667,8,danilo gallinari,29,5,11,45.5,5,9,55.6,0,2,0,2,3,66.7,5,3,8,1,1,0,1,0,12
473990,525_16_04,ITALY,10968,9,nicolo melli,19,2,5,40,2,5,40,0,0,0,3,4,75,2,0,2,0,4,1,0,0,7
473991,525_16_04,ITALY,15319,12,marco cusin,3,0,1,0,0,1,0,0,0,0,0,0,0,0,2,2,0,0,0,0,1,0
473992,525_16_04,ITALY,1861,13,luigi datome,27,2,8,25,1,6,16.7,1,2,50,1,2,50,1,2,3,2,3,0,0,0,6
473993,525_16_04,ITALY,19847,14,riccardo cervi,0,0,0,0,0,0,0,0,0,0,0,0,0,0,0,0,0,0,0,0,0,0
473994,525_16_04,ITALY,10444,23,daniel hackett,35,5,12,41.7,4,9,44.4,1,3,33.3,1,2,50,0,8,8,0,3,0,2,0,12
473995,525_16_04,ITALY,24281,27,stefano tonut,2,0,0,0,0,0,0,0,0,0,0,0,0,0,0,0,0,0,0,0,0,0
473996,525_16_04,ITALY,0,TOTALS,ITALY,200,24,71,33.8,20,55,36.4,4,16,25,15,21,71.4,15,29,44,11,21,6,6,4,67
473997,525_16_04,CROATIA,13759,4,luka babic,23,1,1,100,0,0,0,1,1,100,0,2,0,0,4,4,1,2,1,0,0,3
473998,525_16_04,CROATIA,7990,5,filip kruslin,1,0,0,0,0,0,0,0,0,0,0,0,0,0,1,1,0,0,0,0,0,0
473999,525_16_04,CROATIA,1915,6,rok stipcevic,0,0,0,0,0,0,0,0,0,0,0,0,0,0,0,0,0,0,0,0,0,0
474000,525_16_04,CROATIA,1249,7,krunoslav simon,24,2,5,40,1,1,100,1,4,25,0,2,0,0,2,2,2,1,1,0,0,5
474001,525_16_04,CROATIA,18415,8,mario hezonja,22,3,4,75,2,2,100,1,2,50,0,0,0,1,4,5,1,3,2,0,0,7
474002,525_16_04,CROATIA,15894,9,dario saric,35,4,14,28.6,3,11,27.3,1,3,33.3,2,2,100,4,6,10,3,3,4,0,1,11
474003,525_16_04,CROATIA,4585,10,roko ukic,32,0,4,0,0,1,0,0,3,0,2,2,100,0,6,6,3,1,2,0,0,2
474004,525_16_04,CROATIA,12600,12,darko planinic,13,3,4,75,3,4,75,0,0,0,0,0,0,0,0,0,0,5,1,0,0,6
474005,525_16_04,CROATIA,10624,15,miro bilan,14,0,6,0,0,6,0,0,0,0,0,0,0,2,5,7,0,2,0,0,0,0
474006,525_16_04,CROATIA,7991,33,zeljko sakic,1,0,0,0,0,0,0,0,0,0,0,0,0,0,0,0,0,1,0,0,0,0
474007,525_16_04,CROATIA,20277,35,marko arapovic,0,0,0,0,0,0,0,0,0,0,0,0,0,0,0,0,0,0,0,0,0,0
474008,525_16_04,CROATIA,6280,44,bojan bogdanovic,35,9,23,39.1,7,14,50,2,9,22.2,6,9,66.7,1,5,6,1,5,1,0,0,26
474009,525_16_04,CROATIA,0,TOTALS,CROATIA,200,22,61,36.1,16,39,41,6,22,27.3,10,17,58.8,11,34,45,11,25,13,0,1,60
474010,525_16_05,MEXICO,16880,4,paul stoll,23,3,9,33.3,1,4,25,2,5,40,0,0,0,1,1,2,4,4,2,0,0,8
474011,525_16_05,MEXICO,23812,5,marco ramos,14,1,5,20,1,3,33.3,0,2,0,2,2,100,1,1,2,0,1,0,0,0,4
474012,525_16_05,MEXICO,28754,6,juan toscano,15,1,3,33.3,0,1,0,1,2,50,0,0,0,1,0,1,0,3,0,1,1,3
474013,525_16_05,MEXICO,23756,7,jorge ivan gutierrez,22,3,12,25,2,7,28.6,1,5,20,3,4,75,1,0,1,4,1,3,1,0,10
474014,525_16_05,MEXICO,25444,8,israel gutierrez,25,1,3,33.3,1,3,33.3,0,0,0,0,0,0,4,7,11,0,4,1,0,0,2
474015,525_16_05,MEXICO,23813,9,francisco cruz,30,7,14,50,5,10,50,2,4,50,3,3,100,0,1,1,1,3,3,0,0,19
474016,525_16_05,MEXICO,21214,10,gabriel giron,0,0,0,0,0,0,0,0,0,0,0,0,0,0,0,0,0,0,0,0,0,0
474017,525_16_05,MEXICO,28774,11,edgar garibay,0,0,0,0,0,0,0,0,0,0,0,0,0,0,0,0,0,0,0,0,0,0
474018,525_16_05,MEXICO,9835,12,hector hernandez,33,4,10,40,0,2,0,4,8,50,2,2,100,0,7,7,0,0,1,3,0,14
474019,525_16_05,MEXICO,21215,13,orlando mendez,18,3,6,50,1,3,33.3,2,3,66.7,0,0,0,1,0,1,5,3,0,0,0,8
474020,525_16_05,MEXICO,12110,14,lorenzo mata,14,1,2,50,1,2,50,0,0,0,0,2,0,1,2,3,0,4,0,0,1,2
474021,525_16_05,MEXICO,25446,15,adrian zamora,6,0,0,0,0,0,0,0,0,0,0,0,0,0,0,0,1,1,0,0,0,0
474022,525_16_05,MEXICO,0,TOTALS,MEXICO,200,24,64,37.5,12,35,34.3,12,29,41.4,10,13,76.9,13,19,32,15,25,11,5,2,70
474023,525_16_05,GREECE,30906,4,giannis athinaiou,18,0,1,0,0,0,0,0,1,0,0,0,0,0,1,1,0,1,0,1,0,0
474024,525_16_05,GREECE,12472,8,nick calathes,23,3,5,60,2,3,66.7,1,2,50,0,0,0,0,4,4,7,2,0,1,0,7
474025,525_16_05,GREECE,5050,9,ioannis bourousis,23,5,13,38.5,5,12,41.7,0,1,0,6,7,85.7,3,6,9,2,1,2,0,0,16
474026,525_16_05,GREECE,8303,17,evangelos mantzaris,17,0,2,0,0,1,0,0,1,0,2,3,66.7,0,2,2,3,3,0,1,1,2
474027,525_16_05,GREECE,17670,18,dimitrios agravanis,18,1,2,50,0,0,0,1,2,50,4,4,100,0,1,1,2,1,0,0,0,7
474028,525_16_05,GREECE,15972,19,ioannis papapetrou,23,2,6,33.3,1,2,50,1,4,25,0,0,0,1,4,5,2,1,0,0,0,5
474029,525_16_05,GREECE,20341,25,vasilis charalampopoulos,2,0,1,0,0,0,0,0,1,0,0,0,0,0,0,0,0,0,0,0,0,0
474030,525_16_05,GREECE,2645,31,georgios bogris,2,1,2,50,1,2,50,0,0,0,0,0,0,2,0,2,1,2,0,0,0,2
474031,525_16_05,GREECE,1057,33,efstratios perperoglou,23,2,4,50,1,3,33.3,1,1,100,2,2,100,1,1,2,1,1,1,1,0,7
474032,525_16_05,GREECE,24314,34,giannis antetokounmpo,22,6,10,60,3,5,60,3,5,60,6,6,100,0,5,5,0,2,3,0,2,21
474033,525_16_05,GREECE,10607,41,kostas koufos,15,3,7,42.9,3,7,42.9,0,0,0,1,4,25,0,3,3,0,1,0,0,1,7
474034,525_16_05,GREECE,30907,43,thanasis antetokounmpo,16,4,4,100,4,4,100,0,0,0,4,6,66.7,2,0,2,0,3,0,0,1,12
474035,525_16_05,GREECE,0,TOTALS,GREECE,200,27,57,47.4,20,39,51.3,7,18,38.9,25,32,78.1,11,28,39,18,18,7,4,5,86
474036,525_16_06,CROATIA,13759,4,luka babic,14,1,3,33.3,1,2,50,0,1,0,0,0,0,0,2,2,2,2,1,0,1,2
474037,525_16_06,CROATIA,7990,5,filip kruslin,2,0,0,0,0,0,0,0,0,0,0,0,0,0,1,1,1,0,0,1,0,0
474038,525_16_06,CROATIA,1915,6,rok stipcevic,20,3,6,50,1,1,100,2,5,40,0,0,0,0,2,2,0,4,1,0,0,8
474039,525_16_06,CROATIA,1249,7,krunoslav simon,17,1,4,25,1,1,100,0,3,0,2,2,100,1,3,4,3,1,2,1,0,4
474040,525_16_06,CROATIA,18415,8,mario hezonja,19,1,6,16.7,0,3,0,1,3,33.3,0,0,0,0,2,2,2,1,1,1,0,3
474041,525_16_06,CROATIA,15894,9,dario saric,32,5,10,50,5,7,71.4,0,3,0,1,2,50,1,8,9,3,2,3,1,1,11
474042,525_16_06,CROATIA,4585,10,roko ukic,20,2,5,40,1,2,50,1,3,33.3,0,0,0,0,2,2,3,4,1,0,0,5
474043,525_16_06,CROATIA,12600,12,darko planinic,15,2,5,40,2,5,40,0,0,0,4,4,100,2,3,5,0,0,2,0,0,8
474044,525_16_06,CROATIA,10624,15,miro bilan,25,0,2,0,0,2,0,0,0,0,3,6,50,3,1,4,1,5,1,0,0,3
474045,525_16_06,CROATIA,7991,33,zeljko sakic,2,1,1,100,0,0,0,1,1,100,0,0,0,0,0,0,0,0,0,0,0,3
474046,525_16_06,CROATIA,20277,35,marko arapovic,0,0,0,0,0,0,0,0,0,0,0,0,0,0,0,0,0,0,0,0,0,0
474047,525_16_06,CROATIA,6280,44,bojan bogdanovic,33,6,10,60,5,7,71.4,1,3,33.3,12,12,100,0,3,3,2,2,4,2,0,25
474048,525_16_06,CROATIA,0,TOTALS,CROATIA,200,22,52,42.3,16,30,53.3,6,22,27.3,22,26,84.6,8,29,37,17,21,16,6,2,72
474049,525_16_06,TUNISIA,9218,1,omar mouhli,4,0,1,0,0,0,0,0,1,0,0,0,0,0,1,1,1,1,0,1,0,0
474050,525_16_06,TUNISIA,7938,2,ziyed chennoufi,16,0,2,0,0,1,0,0,1,0,0,0,0,0,1,1,1,3,1,1,1,0
474051,525_16_06,TUNISIA,28113,3,mehdi seyeh,9,1,2,50,0,0,0,1,2,50,0,0,0,0,0,0,0,3,0,0,0,3
474052,525_16_06,TUNISIA,18347,4,omar abada,4,0,1,0,0,1,0,0,0,0,0,0,0,0,0,0,0,1,0,0,0,0
474053,525_16_06,TUNISIA,18521,7,mourad el mabrouk,26,0,6,0,0,1,0,0,5,0,0,0,0,1,1,2,0,3,1,1,0,0
474054,525_16_06,TUNISIA,13953,11,mohamed mokhtar ghyaza,23,0,6,0,0,6,0,0,0,0,0,0,0,2,2,4,1,2,1,0,2,0
474055,525_16_06,TUNISIA,28114,20,michael brandon roll,38,7,14,50,4,6,66.7,3,8,37.5,4,4,100,2,4,6,5,2,2,0,0,21
474056,525_16_06,TUNISIA,30910,23,firas lahiani,5,1,1,100,1,1,100,0,0,0,0,0,0,0,1,1,0,0,2,0,0,2
474057,525_16_06,TUNISIA,28112,30,mohamed abbassi,0,0,0,0,0,0,0,0,0,0,0,0,0,0,0,0,0,0,0,0,0,0
474058,525_16_06,TUNISIA,9216,66,nizar knioua,18,1,1,100,1,1,100,0,0,0,2,2,100,1,0,1,1,3,3,1,0,4
474059,525_16_06,TUNISIA,9220,86,hamdi braa,28,3,9,33.3,3,9,33.3,0,0,0,5,7,71.4,1,3,4,2,3,2,1,0,11
474060,525_16_06,TUNISIA,13954,89,makram ben romdhane,29,4,12,33.3,4,9,44.4,0,3,0,3,4,75,0,9,9,0,4,5,1,0,11
474061,525_16_06,TUNISIA,0,TOTALS,TUNISIA,200,17,55,30.9,13,35,37.1,4,20,20,14,17,82.4,8,23,31,11,25,19,6,3,52
474062,525_16_07,GREECE,30906,4,giannis athinaiou,1,0,0,0,0,0,0,0,0,0,0,0,0,0,0,0,0,2,0,0,0,0
474063,525_16_07,GREECE,12472,8,nick calathes,17,1,7,14.3,0,2,0,1,5,20,0,0,0,1,2,3,3,5,2,2,0,3
474064,525_16_07,GREECE,5050,9,ioannis bourousis,25,3,8,37.5,2,4,50,1,4,25,1,2,50,0,7,7,0,1,1,0,2,8
474065,525_16_07,GREECE,8303,17,evangelos mantzaris,23,1,5,20,0,1,0,1,4,25,0,0,0,1,2,3,1,2,1,1,0,3
474066,525_16_07,GREECE,17670,18,dimitrios agravanis,11,3,4,75,2,3,66.7,1,1,100,0,0,0,1,2,3,0,5,0,0,1,7
474067,525_16_07,GREECE,15972,19,ioannis papapetrou,28,3,10,30,1,4,25,2,6,33.3,1,2,50,1,3,4,1,5,2,0,1,9
474068,525_16_07,GREECE,20341,25,vasilis charalampopoulos,0,0,0,0,0,0,0,0,0,0,0,0,0,0,0,0,0,0,0,0,0,0
474069,525_16_07,GREECE,2645,31,georgios bogris,0,0,0,0,0,0,0,0,0,0,0,0,0,0,0,0,0,0,0,0,0,0
474070,525_16_07,GREECE,1057,33,efstratios perperoglou,34,4,11,36.4,2,4,50,2,7,28.6,3,3,100,0,2,2,3,2,0,0,0,13
474071,525_16_07,GREECE,24314,34,giannis antetokounmpo,33,3,14,21.4,3,7,42.9,0,7,0,3,3,100,3,6,9,4,3,6,0,2,9
474072,525_16_07,GREECE,10607,41,kostas koufos,14,2,4,50,2,4,50,0,0,0,0,0,0,1,2,3,0,1,0,0,0,4
474073,525_16_07,GREECE,30907,43,thanasis antetokounmpo,12,1,1,100,1,1,100,0,0,0,3,4,75,1,1,2,0,3,0,1,0,5
474074,525_16_07,GREECE,0,TOTALS,GREECE,200,21,64,32.8,13,30,43.3,8,34,23.5,11,14,78.6,11,31,42,12,29,12,4,6,61
474075,525_16_07,CROATIA,13759,4,luka babic,2,0,0,0,0,0,0,0,0,0,0,0,0,0,0,0,0,1,0,0,0,0
474076,525_16_07,CROATIA,7990,5,filip kruslin,0,0,0,0,0,0,0,0,0,0,0,0,0,0,0,0,0,0,0,0,0,0
474077,525_16_07,CROATIA,1915,6,rok stipcevic,7,0,0,0,0,0,0,0,0,0,0,0,0,0,0,0,2,0,0,0,0,0
474078,525_16_07,CROATIA,1249,7,krunoslav simon,35,4,15,26.7,1,7,14.3,3,8,37.5,0,2,0,0,8,8,3,3,0,0,0,11
474079,525_16_07,CROATIA,18415,8,mario hezonja,24,1,4,25,1,3,33.3,0,1,0,4,6,66.7,1,3,4,0,2,0,2,0,6
474080,525_16_07,CROATIA,15894,9,dario saric,38,6,11,54.5,6,8,75,0,3,0,4,8,50,2,6,8,1,2,1,0,0,16
474081,525_16_07,CROATIA,4585,10,roko ukic,20,1,4,25,1,1,100,0,3,0,0,0,0,0,2,2,5,2,0,0,0,2
474082,525_16_07,CROATIA,12600,12,darko planinic,16,1,5,20,1,5,20,0,0,0,0,0,0,0,0,0,0,3,1,0,1,2
474083,525_16_07,CROATIA,10624,15,miro bilan,23,2,3,66.7,2,3,66.7,0,0,0,5,6,83.3,1,6,7,0,4,2,0,1,9
474084,525_16_07,CROATIA,7991,33,zeljko sakic,2,0,0,0,0,0,0,0,0,0,0,0,0,0,0,0,0,3,0,0,0,0
474085,525_16_07,CROATIA,20277,35,marko arapovic,0,0,0,0,0,0,0,0,0,0,0,0,0,0,0,0,0,0,0,0,0,0
474086,525_16_07,CROATIA,6280,44,bojan bogdanovic,35,6,17,35.3,4,9,44.4,2,8,25,6,8,75,0,4,4,1,3,2,0,0,20
474087,525_16_07,CROATIA,0,TOTALS,CROATIA,200,21,59,35.6,16,36,44.4,5,23,21.7,19,30,63.3,11,31,42,12,24,7,2,2,66
474088,525_16_08,ITALY,15270,2,giuseppe poeta,12,0,1,0,0,0,0,0,1,0,3,4,75,0,1,1,2,2,1,1,0,3
474089,525_16_08,ITALY,1272,3,marco belinelli,24,5,7,71.4,4,5,80,1,2,50,1,1,100,0,3,3,4,3,3,0,0,12
474090,525_16_08,ITALY,7944,4,pietro aradori,22,4,6,66.7,2,4,50,2,2,100,0,0,0,0,3,3,2,2,0,0,0,10
474091,525_16_08,ITALY,12988,5,alessandro gentile,17,1,4,25,1,4,25,0,0,0,2,4,50,2,2,4,3,1,1,1,0,4
474092,525_16_08,ITALY,1270,7,andrea bargnani,16,4,5,80,4,5,80,0,0,0,0,0,0,0,3,3,1,1,1,0,0,8
474093,525_16_08,ITALY,2667,8,danilo gallinari,21,4,11,36.4,1,6,16.7,3,5,60,4,4,100,1,3,4,1,1,0,1,0,15
474094,525_16_08,ITALY,10968,9,nicolo melli,19,6,7,85.7,6,7,85.7,0,0,0,2,2,100,2,4,6,0,2,0,2,1,14
474095,525_16_08,ITALY,15319,12,marco cusin,8,0,0,0,0,0,0,0,0,0,0,0,0,0,3,3,0,1,1,1,0,0
474096,525_16_08,ITALY,1861,13,luigi datome,28,2,7,28.6,1,4,25,1,3,33.3,4,6,66.7,0,3,3,2,0,1,1,0,9
474097,525_16_08,ITALY,19847,14,riccardo cervi,3,0,1,0,0,1,0,0,0,0,0,0,0,0,0,0,0,0,0,0,0,0
474098,525_16_08,ITALY,10444,23,daniel hackett,20,0,1,0,0,1,0,0,0,0,2,6,33.3,0,4,4,3,3,2,1,0,2
474099,525_16_08,ITALY,24281,27,stefano tonut,11,1,3,33.3,1,2,50,0,1,0,0,2,0,0,1,1,2,0,0,1,0,2
474100,525_16_08,ITALY,0,TOTALS,ITALY,200,27,53,50.9,20,39,51.3,7,14,50,18,29,62.1,6,33,39,20,16,11,9,1,79
474101,525_16_08,MEXICO,16880,4,paul stoll,29,2,10,20,1,4,25,1,6,16.7,1,3,33.3,1,1,2,3,3,2,3,0,6
474102,525_16_08,MEXICO,23812,5,marco ramos,3,0,0,0,0,0,0,0,0,0,0,0,0,0,0,0,0,0,0,0,0,0
474103,525_16_08,MEXICO,28754,6,juan toscano,16,3,5,60,3,5,60,0,0,0,0,0,0,3,1,4,0,3,2,0,0,6
474104,525_16_08,MEXICO,23756,7,jorge ivan gutierrez,28,2,12,16.7,1,10,10,1,2,50,1,2,50,1,3,4,4,5,2,3,0,6
474105,525_16_08,MEXICO,25444,8,israel gutierrez,7,1,2,50,1,2,50,0,0,0,0,0,0,1,0,1,0,2,1,0,0,2
474106,525_16_08,MEXICO,23813,9,francisco cruz,39,9,16,56.2,7,9,77.8,2,7,28.6,0,0,0,0,7,7,0,2,7,1,0,20
474107,525_16_08,MEXICO,21214,10,gabriel giron,4,0,1,0,0,1,0,0,0,0,0,0,0,0,0,0,0,2,1,0,0,0
474108,525_16_08,MEXICO,28774,11,edgar garibay,6,0,1,0,0,1,0,0,0,0,0,0,0,0,0,0,0,0,0,0,1,0
474109,525_16_08,MEXICO,9835,12,hector hernandez,33,3,8,37.5,2,5,40,1,3,33.3,2,2,100,0,5,5,3,1,1,1,1,9
474110,525_16_08,MEXICO,21215,13,orlando mendez,11,1,3,33.3,1,2,50,0,1,0,0,0,0,0,1,1,2,2,1,0,0,2
474111,525_16_08,MEXICO,12110,14,lorenzo mata,10,0,1,0,0,1,0,0,0,0,0,0,0,0,3,3,0,2,0,0,0,0
474112,525_16_08,MEXICO,25446,15,adrian zamora,11,1,2,50,1,2,50,0,0,0,1,2,50,0,0,0,0,5,0,0,0,3
474113,525_16_08,MEXICO,0,TOTALS,MEXICO,200,22,61,36.1,17,42,40.5,5,19,26.3,5,9,55.6,6,23,29,12,27,17,8,2,54
474114,525_16_09,CROATIA,13759,4,luka babic,20,0,1,0,0,0,0,0,1,0,0,0,0,1,1,2,1,1,0,1,0,0
474115,525_16_09,CROATIA,7990,5,filip kruslin,0,0,0,0,0,0,0,0,0,0,0,0,0,0,0,0,0,0,0,0,0,0
474116,525_16_09,CROATIA,1915,6,rok stipcevic,0,0,0,0,0,0,0,0,0,0,0,0,0,0,0,0,0,0,0,0,0,0
474117,525_16_09,CROATIA,1249,7,krunoslav simon,27,6,12,50,0,2,0,6,10,60,3,6,50,0,5,5,0,3,4,0,1,21
474118,525_16_09,CROATIA,18415,8,mario hezonja,29,1,7,14.3,1,3,33.3,0,4,0,0,0,0,0,2,2,4,3,0,2,0,2
474119,525_16_09,CROATIA,15894,9,dario saric,39,5,10,50,4,8,50,1,2,50,7,8,87.5,4,9,13,2,4,5,2,0,18
474120,525_16_09,CROATIA,4585,10,roko ukic,33,2,7,28.6,2,5,40,0,2,0,0,0,0,0,2,2,3,4,1,1,1,4
474121,525_16_09,CROATIA,12600,12,darko planinic,25,5,8,62.5,5,8,62.5,0,0,0,3,6,50,4,1,5,0,2,2,0,0,13
474122,525_16_09,CROATIA,10624,15,miro bilan,10,0,2,0,0,2,0,0,0,0,0,0,0,0,1,1,0,0,0,0,0,0
474123,525_16_09,CROATIA,7991,33,zeljko sakic,0,0,0,0,0,0,0,0,0,0,0,0,0,0,0,0,0,0,0,0,0,0
474124,525_16_09,CROATIA,20277,35,marko arapovic,0,0,0,0,0,0,0,0,0,0,0,0,0,0,0,0,0,0,0,0,0,0
474125,525_16_09,CROATIA,6280,44,bojan bogdanovic,42,6,19,31.6,4,12,33.3,2,7,28.6,12,13,92.3,0,6,6,1,3,2,1,0,26
474126,525_16_09,CROATIA,0,TOTALS,CROATIA,225,25,66,37.9,16,40,40,9,26,34.6,25,33,75.8,12,34,46,11,21,15,7,2,84
474127,525_16_09,ITALY,15270,2,giuseppe poeta,0,0,0,0,0,0,0,0,0,0,0,0,0,0,0,0,0,0,0,0,0,0
474128,525_16_09,ITALY,1272,3,marco belinelli,38,4,15,26.7,2,10,20,2,5,40,8,9,88.9,0,3,3,2,5,4,2,0,18
474129,525_16_09,ITALY,7944,4,pietro aradori,20,1,6,16.7,0,1,0,1,5,20,0,0,0,0,5,5,1,0,0,0,0,3
474130,525_16_09,ITALY,12988,5,alessandro gentile,28,3,8,37.5,3,7,42.9,0,1,0,0,0,0,0,1,1,4,1,5,0,0,6
474131,525_16_09,ITALY,1270,7,andrea bargnani,15,2,7,28.6,2,7,28.6,0,0,0,0,0,0,1,2,3,0,3,1,0,0,4
474132,525_16_09,ITALY,2667,8,danilo gallinari,25,5,13,38.5,5,10,50,0,3,0,2,2,100,1,7,8,4,5,0,1,0,12
474133,525_16_09,ITALY,10968,9,nicolo melli,25,5,8,62.5,5,7,71.4,0,1,0,1,1,100,5,3,8,0,5,1,0,2,11
474134,525_16_09,ITALY,15319,12,marco cusin,12,0,1,0,0,1,0,0,0,0,2,2,100,0,1,1,1,2,1,0,3,2
474135,525_16_09,ITALY,1861,13,luigi datome,28,5,9,55.6,4,6,66.7,1,3,33.3,1,1,100,1,2,3,1,5,0,0,2,12
474136,525_16_09,ITALY,19847,14,riccardo cervi,0,0,0,0,0,0,0,0,0,0,0,0,0,0,0,0,0,0,0,0,0,0
474137,525_16_09,ITALY,10444,23,daniel hackett,31,3,6,50,2,3,66.7,1,3,33.3,3,4,75,1,5,6,4,4,0,2,0,10
474138,525_16_09,ITALY,24281,27,stefano tonut,1,0,0,0,0,0,0,0,0,0,0,0,0,0,0,0,0,0,0,0,0,0
474139,525_16_09,ITALY,0,TOTALS,ITALY,225,28,73,38.4,23,52,44.2,5,21,23.8,17,19,89.5,10,29,39,17,30,12,5,7,78
474140,526_16_01,TURKEY,4572,1,ender arslan,10,0,2,0,0,0,0,0,2,0,0,0,0,0,2,2,1,1,0,0,0,0
474141,526_16_01,TURKEY,7790,3,omer asik,10,1,1,100,1,1,100,0,0,0,2,6,33.3,1,5,6,1,0,1,0,0,4
474142,526_16_01,TURKEY,15304,5,sinan guler,34,6,14,42.9,5,11,45.5,1,3,33.3,1,1,100,0,1,1,3,4,1,3,0,14
474143,526_16_01,TURKEY,20219,6,cedi osman,25,2,8,25,2,4,50,0,4,0,6,8,75,1,4,5,0,1,1,1,0,10
474144,526_16_01,TURKEY,1797,9,semih erden,20,2,6,33.3,2,6,33.3,0,0,0,4,7,57.1,4,4,8,1,3,0,0,1,8
474145,526_16_01,TURKEY,8151,10,melih mahmutoglu,16,3,3,100,0,0,0,3,3,100,0,0,0,0,1,1,0,2,1,0,0,9
474146,526_16_01,TURKEY,1796,11,oguz savas,17,3,5,60,3,4,75,0,1,0,1,1,100,1,0,1,1,4,2,0,0,7
474147,526_16_01,TURKEY,15900,12,samet geyik,18,1,7,14.3,0,3,0,1,4,25,1,4,25,4,2,6,0,2,1,0,0,4
474148,526_16_01,TURKEY,29512,13,ali muhammed,20,0,8,0,0,2,0,0,6,0,1,2,50,0,2,2,1,2,3,1,0,1
474149,526_16_01,TURKEY,6165,15,birkan batuk,16,3,6,50,2,3,66.7,1,3,33.3,1,2,50,1,4,5,1,1,0,1,0,8
474150,526_16_01,TURKEY,24656,21,furkan korkmaz,4,0,0,0,0,0,0,0,0,0,2,3,66.7,0,0,0,1,2,0,0,0,2
474151,526_16_01,TURKEY,15897,25,kenan sipahi,9,1,1,100,1,1,100,0,0,0,0,0,0,0,1,1,1,3,1,0,0,2
474152,526_16_01,TURKEY,0,TOTALS,TURKEY,200,22,61,36.1,16,35,45.7,6,26,23.1,19,34,55.9,12,28,40,11,25,11,6,1,69
474153,526_16_01,CANADA,16951,4,philip scrubb,26,3,6,50,1,2,50,2,4,50,2,2,100,1,4,5,2,2,1,3,0,10
474154,526_16_01,CANADA,30911,5,shai gilgeous-alexander,0,0,0,0,0,0,0,0,0,0,0,0,0,0,0,0,0,0,0,0,0,0
474155,526_16_01,CANADA,8989,6,cory joseph,35,8,17,47.1,7,14,50,1,3,33.3,4,4,100,0,3,3,5,4,1,0,0,21
474156,526_16_01,CANADA,28756,7,melvin ejim,18,2,5,40,1,1,100,1,4,25,2,2,100,0,2,2,2,5,0,1,1,7
474157,526_16_01,CANADA,30912,8,thomas scrubb,29,3,7,42.9,2,4,50,1,3,33.3,2,4,50,0,6,6,1,1,0,1,0,9
474158,526_16_01,CANADA,16953,9,khem birch,11,2,3,66.7,2,3,66.7,0,0,0,0,0,0,1,6,7,1,4,0,1,1,4
474159,526_16_01,CANADA,14713,10,anthony bennett,17,1,2,50,1,1,100,0,1,0,2,2,100,0,3,3,1,3,2,0,1,4
474160,526_16_01,CANADA,21284,11,tyler ennis,17,1,4,25,1,3,33.3,0,1,0,4,4,100,0,3,3,2,4,2,0,0,6
474161,526_16_01,CANADA,23740,12,brady heslip,18,2,4,50,0,1,0,2,3,66.7,0,0,0,0,0,0,0,2,1,0,0,6
474162,526_16_01,CANADA,12214,13,tristan thompson,29,3,11,27.3,3,11,27.3,0,0,0,4,6,66.7,2,4,6,3,2,3,0,0,10
474163,526_16_01,CANADA,498,14,levon kendall,0,0,0,0,0,0,0,0,0,0,0,0,0,0,0,0,0,0,0,0,0,0
474164,526_16_01,CANADA,11679,15,joel anthony,0,0,0,0,0,0,0,0,0,0,0,0,0,0,0,0,0,0,0,0,0,0
474165,526_16_01,CANADA,0,TOTALS,CANADA,200,25,59,42.4,18,40,45,7,19,36.8,20,24,83.3,6,32,38,17,27,11,6,3,77
474166,526_16_02,FRANCE,12495,4,thomas heurtel,15,1,5,20,1,4,25,0,1,0,0,0,0,1,0,1,2,0,1,2,0,2
474167,526_16_02,FRANCE,2588,5,nicolas batum,0,0,0,0,0,0,0,0,0,0,0,0,0,0,0,0,0,0,0,0,0,0
474168,526_16_02,FRANCE,2589,6,antoine diot,8,2,4,50,2,3,66.7,0,1,0,0,0,0,0,0,0,0,0,0,1,0,4
474169,526_16_02,FRANCE,11076,7,joffrey lauvergne,15,5,9,55.6,5,9,55.6,0,0,0,0,0,0,2,0,2,2,2,0,0,0,10
474170,526_16_02,FRANCE,1864,8,charles kahudi,15,1,1,100,1,1,100,0,0,0,0,0,0,0,2,2,0,2,1,0,0,2
474171,526_16_02,FRANCE,5047,9,tony parker,30,7,13,53.8,4,6,66.7,3,7,42.9,4,4,100,0,4,4,6,0,5,1,0,21
474172,526_16_02,FRANCE,4663,11,florent pietrus,9,0,1,0,0,1,0,0,0,0,0,0,0,1,0,1,0,4,1,0,0,0
474173,526_16_02,FRANCE,10428,12,nando de colo,33,9,14,64.3,7,8,87.5,2,6,33.3,7,7,100,0,6,6,2,1,3,3,0,27
474174,526_16_02,FRANCE,4665,13,boris diaw,36,3,6,50,3,5,60,0,1,0,3,4,75,2,7,9,6,1,1,0,0,9
474175,526_16_02,FRANCE,5044,15,mickael gelabale,19,4,7,57.1,4,4,100,0,3,0,0,1,0,2,4,6,0,3,1,1,0,8
474176,526_16_02,FRANCE,7987,17,kim tillie,15,4,6,66.7,4,6,66.7,0,0,0,2,2,100,4,1,5,0,5,1,0,0,10
474177,526_16_02,FRANCE,2594,18,adrien moerman,6,0,1,0,0,0,0,0,1,0,0,0,0,0,0,0,0,1,0,0,0,0
474178,526_16_02,FRANCE,0,TOTALS,FRANCE,200,36,67,53.7,31,47,66,5,20,25,16,18,88.9,14,24,38,18,19,15,8,0,93
474179,526_16_02,PHILIPPINES,25433,1,andray blatche,32,7,14,50,5,10,50,2,4,50,5,6,83.3,4,4,8,0,4,4,3,1,21
474180,526_16_02,PHILIPPINES,28325,2,terrence romeo,25,5,14,35.7,2,9,22.2,3,5,60,6,8,75,1,1,2,1,3,4,0,0,19
474181,526_16_02,PHILIPPINES,30913,3,bobby ray parks,15,1,3,33.3,1,2,50,0,1,0,1,1,100,2,3,5,2,3,3,0,0,3
474182,526_16_02,PHILIPPINES,25432,6,jeff chan,14,3,5,60,0,0,0,3,5,60,0,0,0,0,0,0,0,0,0,0,0,9
474183,526_16_02,PHILIPPINES,23361,7,jayson castro william,26,5,11,45.5,4,7,57.1,1,4,25,3,3,100,0,1,1,3,4,1,0,0,14
474184,526_16_02,PHILIPPINES,9700,10,gabe norwood,31,2,6,33.3,2,4,50,0,2,0,0,0,0,3,1,4,2,2,0,2,0,4
474185,526_16_02,PHILIPPINES,30914,11,ryan reyes,9,1,1,100,0,0,0,1,1,100,0,0,0,0,0,0,1,0,0,0,0,3
474186,526_16_02,PHILIPPINES,23364,12,june mar fajardo,8,0,1,0,0,1,0,0,0,0,0,0,0,0,1,1,1,1,0,0,0,0
474187,526_16_02,PHILIPPINES,23365,15,marc pingris,5,1,1,100,1,1,100,0,0,0,0,0,0,1,0,1,0,2,2,0,0,2
474188,526_16_02,PHILIPPINES,30915,18,troy rosario,19,3,10,30,3,8,37.5,0,2,0,0,0,0,7,2,9,0,1,1,0,1,6
474189,526_16_02,PHILIPPINES,14184,25,japeth aguilar,0,0,0,0,0,0,0,0,0,0,0,0,0,0,0,0,0,0,0,0,0,0
474190,526_16_02,PHILIPPINES,18657,33,ranidel de ocampo,15,1,4,25,0,0,0,1,4,25,0,0,0,0,2,2,1,1,3,0,0,3
474191,526_16_02,PHILIPPINES,0,TOTALS,PHILIPPINES,200,29,70,41.4,18,42,42.9,11,28,39.3,15,18,83.3,19,17,36,11,21,18,5,2,84
474192,526_16_03,CANADA,16951,4,philip scrubb,19,0,5,0,0,1,0,0,4,0,2,2,100,0,1,1,2,2,2,0,0,2
474193,526_16_03,CANADA,30911,5,shai gilgeous-alexander,0,0,0,0,0,0,0,0,0,0,0,0,0,0,0,0,0,0,0,0,0,0
474194,526_16_03,CANADA,8989,6,cory joseph,33,4,12,33.3,4,10,40,0,2,0,5,6,83.3,1,4,5,2,2,1,0,1,13
474195,526_16_03,CANADA,28756,7,melvin ejim,20,3,10,30,2,6,33.3,1,4,25,4,4,100,1,7,8,0,1,1,0,1,11
474196,526_16_03,CANADA,30912,8,thomas scrubb,23,1,3,33.3,1,2,50,0,1,0,0,0,0,2,2,4,0,0,1,1,0,2
474197,526_16_03,CANADA,16953,9,khem birch,0,0,0,0,0,0,0,0,0,0,0,0,0,0,0,0,0,0,0,0,0,0
474198,526_16_03,CANADA,14713,10,anthony bennett,20,3,5,60,2,4,50,1,1,100,0,1,0,1,6,7,1,3,3,0,1,7
474199,526_16_03,CANADA,21284,11,tyler ennis,26,5,12,41.7,5,12,41.7,0,0,0,2,6,33.3,0,1,1,3,2,0,0,0,12
474200,526_16_03,CANADA,23740,12,brady heslip,20,0,7,0,0,2,0,0,5,0,0,0,0,0,1,1,1,2,0,0,0,0
474201,526_16_03,CANADA,12214,13,tristan thompson,31,3,8,37.5,3,8,37.5,0,0,0,1,4,25,5,5,10,1,4,2,0,1,7
474202,526_16_03,CANADA,498,14,levon kendall,0,0,0,0,0,0,0,0,0,0,0,0,0,0,0,0,0,0,0,0,0,0
474203,526_16_03,CANADA,11679,15,joel anthony,9,2,3,66.7,2,3,66.7,0,0,0,0,0,0,1,2,3,0,0,0,0,0,4
474204,526_16_03,CANADA,0,TOTALS,CANADA,200,21,65,32.3,19,48,39.6,2,17,11.8,14,23,60.9,15,31,46,10,16,12,1,4,58
474205,526_16_03,SENEGAL,25449,1,maurice ndour,30,5,15,33.3,1,7,14.3,4,8,50,2,2,100,1,9,10,2,5,1,0,5,16
474206,526_16_03,SENEGAL,14054,3,el hadji ndiaye,12,0,4,0,0,3,0,0,1,0,0,2,0,2,0,2,1,1,4,1,0,0
474207,526_16_03,SENEGAL,11764,4,thierno niang,26,1,3,33.3,1,3,33.3,0,0,0,0,0,0,1,4,5,4,3,5,1,0,2
474208,526_16_03,SENEGAL,11760,5,louis adams,11,1,3,33.3,0,1,0,1,2,50,0,0,0,0,1,1,0,3,2,0,0,3
474209,526_16_03,SENEGAL,23085,6,ibrahima thomas,10,1,4,25,0,1,0,1,3,33.3,2,2,100,1,5,6,0,1,0,0,0,5
474210,526_16_03,SENEGAL,13966,8,antoine mendy,20,0,4,0,0,2,0,0,2,0,0,0,0,0,2,2,0,1,0,0,0,0
474211,526_16_03,SENEGAL,3592,9,maleye ndoye,22,2,6,33.3,0,2,0,2,4,50,0,0,0,1,3,4,1,1,0,0,0,6
474212,526_16_03,SENEGAL,28148,10,cheikh mbodj,18,2,9,22.2,2,8,25,0,1,0,2,2,100,3,3,6,0,3,2,0,3,6
474213,526_16_03,SENEGAL,30916,11,clevin hannah,27,6,17,35.3,5,10,50,1,7,14.3,0,0,0,1,2,3,4,4,1,0,0,13
474214,526_16_03,SENEGAL,11967,12,serigne gueye,3,0,1,0,0,0,0,0,1,0,0,0,0,1,0,1,0,0,0,0,0,0
474215,526_16_03,SENEGAL,23089,13,hamady ndiaye,22,1,3,33.3,1,3,33.3,0,0,0,2,4,50,3,3,6,0,2,1,1,0,4
474216,526_16_03,SENEGAL,22962,15,abdoulaye ndoye,0,0,0,0,0,0,0,0,0,0,0,0,0,0,0,0,0,0,0,0,0,0
474217,526_16_03,SENEGAL,0,TOTALS,SENEGAL,200,19,69,27.5,10,40,25,9,29,31,8,12,66.7,18,35,53,12,24,16,3,8,55
474218,526_16_04,PHILIPPINES,25433,1,andray blatche,35,10,19,52.6,6,12,50,4,7,57.1,6,9,66.7,1,6,7,2,3,3,0,1,30
474219,526_16_04,PHILIPPINES,28325,2,terrence romeo,14,2,7,28.6,1,3,33.3,1,4,25,0,0,0,0,2,2,0,3,0,2,0,5
474220,526_16_04,PHILIPPINES,30913,3,bobby ray parks,15,0,3,0,0,3,0,0,0,0,1,2,50,0,2,2,2,2,1,0,0,1
474221,526_16_04,PHILIPPINES,25432,6,jeff chan,24,3,5,60,1,1,100,2,4,50,3,3,100,0,2,2,0,3,1,0,0,11
474222,526_16_04,PHILIPPINES,23361,7,jayson castro william,25,5,13,38.5,2,8,25,3,5,60,0,0,0,1,1,2,3,2,2,1,0,13
474223,526_16_04,PHILIPPINES,9700,10,gabe norwood,28,0,2,0,0,1,0,0,1,0,0,0,0,4,3,7,3,3,3,0,0,0
474224,526_16_04,PHILIPPINES,30914,11,ryan reyes,11,1,3,33.3,1,1,100,0,2,0,0,0,0,0,0,0,0,1,0,0,0,2
474225,526_16_04,PHILIPPINES,23364,12,june mar fajardo,17,3,4,75,3,4,75,0,0,0,5,5,100,2,2,4,0,3,1,0,0,11
474226,526_16_04,PHILIPPINES,23365,15,marc pingris,7,0,0,0,0,0,0,0,0,0,0,0,0,1,0,1,0,0,1,0,1,0
474227,526_16_04,PHILIPPINES,30915,18,troy rosario,21,2,7,28.6,1,4,25,1,3,33.3,2,2,100,1,4,5,0,4,0,0,0,7
474228,526_16_04,PHILIPPINES,14184,25,japeth aguilar,3,0,0,0,0,0,0,0,0,0,0,0,0,0,0,0,0,2,1,0,0,0
474229,526_16_04,PHILIPPINES,18657,33,ranidel de ocampo,1,0,1,0,0,0,0,0,1,0,0,0,0,0,0,0,0,0,0,0,0,0
474230,526_16_04,PHILIPPINES,0,TOTALS,PHILIPPINES,200,26,64,40.6,15,37,40.5,11,27,40.7,17,21,81,14,22,36,10,26,14,3,2,80
474231,526_16_04,NEW ZEALAND,21056,0,tai jack webster,32,7,15,46.7,6,11,54.5,1,4,25,10,11,90.9,3,8,11,3,2,4,0,0,25
474232,526_16_04,NEW ZEALAND,30799,3,shea ili,18,1,1,100,1,1,100,0,0,0,0,0,0,0,3,3,4,0,0,1,0,2
474233,526_16_04,NEW ZEALAND,21055,5,everard bartlett,8,1,3,33.3,1,2,50,0,1,0,0,0,0,0,0,0,0,0,0,0,0,2
474234,526_16_04,NEW ZEALAND,6773,7,mika vukona,19,2,3,66.7,2,3,66.7,0,0,0,2,3,66.7,1,2,3,1,5,1,1,1,6
474235,526_16_04,NEW ZEALAND,22922,8,derone raukawa,0,0,0,0,0,0,0,0,0,0,0,0,0,0,0,0,0,0,0,0,0,0
474236,526_16_04,NEW ZEALAND,11656,9,corey webster,31,7,14,50,4,6,66.7,3,8,37.5,6,6,100,0,0,0,0,0,2,1,1,23
474237,526_16_04,NEW ZEALAND,16523,10,thomas abercrombie,36,6,12,50,5,7,71.4,1,5,20,0,0,0,1,6,7,0,3,0,3,1,13
474238,526_16_04,NEW ZEALAND,16524,11,benny anthony,7,0,1,0,0,1,0,0,0,0,0,0,0,1,0,1,0,3,1,0,1,0
474239,526_16_04,NEW ZEALAND,25442,12,isaac fotu,28,6,10,60,3,6,50,3,4,75,2,4,50,2,3,5,3,4,0,1,0,17
474240,526_16_04,NEW ZEALAND,13832,14,robert loe,22,0,3,0,0,1,0,0,2,0,1,2,50,1,2,3,1,4,1,0,1,1
474241,526_16_04,NEW ZEALAND,16555,20,jordan ngatai,0,0,0,0,0,0,0,0,0,0,0,0,0,0,0,0,0,0,0,0,0,0
474242,526_16_04,NEW ZEALAND,16548,44,michael karena,1,0,0,0,0,0,0,0,0,0,0,0,0,0,0,0,0,0,0,0,0,0
474243,526_16_04,NEW ZEALAND,0,TOTALS,NEW ZEALAND,200,30,62,48.4,22,38,57.9,8,24,33.3,21,26,80.8,11,25,36,12,21,11,7,5,89
474244,526_16_05,SENEGAL,25449,1,maurice ndour,36,6,13,46.2,4,8,50,2,5,40,0,3,0,2,9,11,0,3,4,0,0,14
474245,526_16_05,SENEGAL,14054,3,el hadji ndiaye,7,0,1,0,0,0,0,0,1,0,2,2,100,0,0,0,0,0,2,1,0,2
474246,526_16_05,SENEGAL,11764,4,thierno niang,28,4,6,66.7,4,5,80,0,1,0,0,0,0,0,3,3,3,4,1,1,0,8
474247,526_16_05,SENEGAL,11760,5,louis adams,3,0,0,0,0,0,0,0,0,0,0,0,0,0,0,0,1,0,0,0,0,0
474248,526_16_05,SENEGAL,23085,6,ibrahima thomas,5,0,3,0,0,1,0,0,2,0,0,0,0,0,0,0,1,1,0,0,0,0
474249,526_16_05,SENEGAL,13966,8,antoine mendy,29,4,13,30.8,3,7,42.9,1,6,16.7,2,2,100,4,5,9,3,3,1,0,0,11
474250,526_16_05,SENEGAL,3592,9,maleye ndoye,33,5,10,50,2,2,100,3,8,37.5,2,2,100,3,6,9,0,2,2,1,0,15
474251,526_16_05,SENEGAL,28148,10,cheikh mbodj,13,0,3,0,0,3,0,0,0,0,2,2,100,3,1,4,0,3,1,1,1,2
474252,526_16_05,SENEGAL,30916,11,clevin hannah,19,2,6,33.3,0,2,0,2,4,50,0,0,0,0,2,2,4,4,4,0,0,6
474253,526_16_05,SENEGAL,11967,12,serigne gueye,4,1,2,50,1,2,50,0,0,0,0,0,0,0,1,1,0,1,0,0,0,2
474254,526_16_05,SENEGAL,23089,13,hamady ndiaye,18,1,2,50,1,2,50,0,0,0,0,0,0,2,5,7,0,5,3,0,1,2
474255,526_16_05,SENEGAL,22962,15,abdoulaye ndoye,3,0,3,0,0,3,0,0,0,0,0,0,0,0,1,1,0,2,0,0,0,0
474256,526_16_05,SENEGAL,0,TOTALS,SENEGAL,200,23,62,37.1,15,35,42.9,8,27,29.6,8,11,72.7,15,36,51,12,29,19,4,2,62
474257,526_16_05,TURKEY,4572,1,ender arslan,0,0,0,0,0,0,0,0,0,0,0,0,0,0,0,0,0,0,0,0,0,0
474258,526_16_05,TURKEY,7790,3,omer asik,24,2,5,40,2,5,40,0,0,0,3,6,50,3,3,6,0,4,1,0,0,7
474259,526_16_05,TURKEY,15304,5,sinan guler,27,3,7,42.9,1,3,33.3,2,4,50,0,1,0,0,4,4,3,4,1,0,0,8
474260,526_16_05,TURKEY,20219,6,cedi osman,0,0,0,0,0,0,0,0,0,0,0,0,0,0,0,0,0,0,0,0,0,0
474261,526_16_05,TURKEY,1797,9,semih erden,27,4,8,50,4,8,50,0,0,0,6,13,46.2,4,7,11,2,3,5,3,1,14
474262,526_16_05,TURKEY,8151,10,melih mahmutoglu,28,3,6,50,1,1,100,2,5,40,0,2,0,1,0,1,2,1,1,0,0,8
474263,526_16_05,TURKEY,1796,11,oguz savas,7,0,2,0,0,2,0,0,0,0,0,0,0,1,1,2,0,0,1,0,0,0
474264,526_16_05,TURKEY,15900,12,samet geyik,5,0,2,0,0,1,0,0,1,0,0,0,0,1,1,2,0,1,0,0,0,0
474265,526_16_05,TURKEY,29512,13,ali muhammed,33,6,21,28.6,3,9,33.3,3,12,25,8,8,100,1,6,7,4,1,1,1,0,23
474266,526_16_05,TURKEY,6165,15,birkan batuk,14,1,6,16.7,0,1,0,1,5,20,0,0,0,0,1,1,0,2,0,2,0,3
474267,526_16_05,TURKEY,24656,21,furkan korkmaz,21,2,5,40,1,3,33.3,1,2,50,0,0,0,0,1,1,1,2,1,0,0,5
474268,526_16_05,TURKEY,15897,25,kenan sipahi,14,0,2,0,0,2,0,0,0,0,0,0,0,0,1,1,1,1,0,1,0,0
474269,526_16_05,TURKEY,0,TOTALS,TURKEY,200,21,64,32.8,12,35,34.3,9,29,31,17,30,56.7,15,25,40,13,19,11,7,1,68
474270,526_16_06,NEW ZEALAND,21056,0,tai jack webster,24,3,7,42.9,2,4,50,1,3,33.3,2,2,100,2,6,8,2,4,1,2,0,9
474271,526_16_06,NEW ZEALAND,30799,3,shea ili,17,2,4,50,2,4,50,0,0,0,0,0,0,0,4,4,2,4,2,0,0,4
474272,526_16_06,NEW ZEALAND,21055,5,everard bartlett,7,1,2,50,0,1,0,1,1,100,0,0,0,0,0,0,0,0,0,0,0,3
474273,526_16_06,NEW ZEALAND,6773,7,mika vukona,26,0,6,0,0,6,0,0,0,0,2,4,50,6,6,12,1,5,5,0,0,2
474274,526_16_06,NEW ZEALAND,22922,8,derone raukawa,0,0,0,0,0,0,0,0,0,0,0,0,0,0,0,0,0,0,0,0,0,0
474275,526_16_06,NEW ZEALAND,11656,9,corey webster,31,7,22,31.8,2,7,28.6,5,15,33.3,2,2,100,2,2,4,3,1,1,1,0,21
474276,526_16_06,NEW ZEALAND,16523,10,thomas abercrombie,32,2,11,18.2,0,6,0,2,5,40,0,0,0,2,4,6,1,3,3,0,2,6
474277,526_16_06,NEW ZEALAND,16524,11,benny anthony,3,0,1,0,0,1,0,0,0,0,0,0,0,0,0,0,0,0,0,0,0,0
474278,526_16_06,NEW ZEALAND,25442,12,isaac fotu,31,3,11,27.3,3,10,30,0,1,0,2,2,100,8,2,10,2,2,2,0,0,8
474279,526_16_06,NEW ZEALAND,13832,14,robert loe,20,2,2,100,0,0,0,2,2,100,0,2,0,0,1,1,1,1,2,0,0,6
474280,526_16_06,NEW ZEALAND,16555,20,jordan ngatai,8,0,0,0,0,0,0,0,0,0,0,0,0,0,0,0,0,0,0,0,0,0
474281,526_16_06,NEW ZEALAND,16548,44,michael karena,0,0,0,0,0,0,0,0,0,0,0,0,0,0,0,0,0,0,0,0,0,0
474282,526_16_06,NEW ZEALAND,0,TOTALS,NEW ZEALAND,200,20,66,30.3,9,39,23.1,11,27,40.7,8,12,66.7,20,27,47,12,20,18,3,2,59
474283,526_16_06,FRANCE,12495,4,thomas heurtel,19,2,7,28.6,1,4,25,1,3,33.3,2,2,100,0,3,3,4,2,0,1,0,7
474284,526_16_06,FRANCE,2588,5,nicolas batum,0,0,0,0,0,0,0,0,0,0,0,0,0,0,0,0,0,0,0,0,0,0
474285,526_16_06,FRANCE,2589,6,antoine diot,15,1,4,25,1,2,50,0,2,0,0,0,0,1,0,1,2,2,2,1,0,2
474286,526_16_06,FRANCE,11076,7,joffrey lauvergne,17,3,9,33.3,3,8,37.5,0,1,0,1,2,50,1,2,3,0,2,1,0,0,7
474287,526_16_06,FRANCE,1864,8,charles kahudi,16,2,6,33.3,2,3,66.7,0,3,0,0,0,0,1,4,5,0,2,1,0,0,4
474288,526_16_06,FRANCE,5047,9,tony parker,25,2,5,40,2,3,66.7,0,2,0,2,4,50,0,1,1,1,1,2,1,0,6
474289,526_16_06,FRANCE,4663,11,florent pietrus,11,1,1,100,1,1,100,0,0,0,0,0,0,0,0,0,1,1,0,2,0,2
474290,526_16_06,FRANCE,10428,12,nando de colo,25,3,7,42.9,3,6,50,0,1,0,1,2,50,0,5,5,1,2,0,1,0,7
474291,526_16_06,FRANCE,4665,13,boris diaw,29,3,6,50,3,6,50,0,0,0,4,4,100,1,5,6,1,3,1,1,0,10
474292,526_16_06,FRANCE,5044,15,mickael gelabale,20,4,7,57.1,3,4,75,1,3,33.3,2,2,100,1,4,5,1,1,1,1,0,11
474293,526_16_06,FRANCE,7987,17,kim tillie,17,4,5,80,3,4,75,1,1,100,1,1,100,1,1,2,0,2,2,0,0,10
474294,526_16_06,FRANCE,2594,18,adrien moerman,5,0,3,0,0,2,0,0,1,0,0,0,0,0,0,0,0,0,0,0,0,0
474295,526_16_06,FRANCE,0,TOTALS,FRANCE,200,25,60,41.7,22,43,51.2,3,17,17.6,13,17,76.5,8,28,36,11,18,10,8,0,66
474296,526_16_07,CANADA,16951,4,philip scrubb,18,1,5,20,1,3,33.3,0,2,0,1,2,50,1,2,3,1,3,0,0,1,3
474297,526_16_07,CANADA,30911,5,shai gilgeous-alexander,0,0,0,0,0,0,0,0,0,0,0,0,0,0,0,0,0,0,0,0,0,0
474298,526_16_07,CANADA,8989,6,cory joseph,31,9,20,45,8,16,50,1,4,25,4,4,100,1,4,5,4,4,5,2,0,23
474299,526_16_07,CANADA,28756,7,melvin ejim,24,5,9,55.6,4,8,50,1,1,100,2,4,50,3,4,7,1,3,3,1,2,13
474300,526_16_07,CANADA,30912,8,thomas scrubb,21,2,9,22.2,1,5,20,1,4,25,0,0,0,2,3,5,1,1,1,0,0,5
474301,526_16_07,CANADA,16953,9,khem birch,11,2,2,100,2,2,100,0,0,0,2,5,40,4,1,5,1,0,0,0,1,6
474302,526_16_07,CANADA,14713,10,anthony bennett,21,4,8,50,3,3,100,1,5,20,0,0,0,1,4,5,0,1,2,0,0,9
474303,526_16_07,CANADA,21284,11,tyler ennis,25,2,6,33.3,2,5,40,0,1,0,0,3,0,0,2,2,1,1,1,1,0,4
474304,526_16_07,CANADA,23740,12,brady heslip,21,1,5,20,1,2,50,0,3,0,0,0,0,0,2,2,1,1,0,0,0,2
474305,526_16_07,CANADA,12214,13,tristan thompson,29,4,5,80,4,5,80,0,0,0,5,7,71.4,5,5,10,0,0,0,0,0,13
474306,526_16_07,CANADA,498,14,levon kendall,0,0,0,0,0,0,0,0,0,0,0,0,0,0,0,0,0,0,0,0,0,0
474307,526_16_07,CANADA,11679,15,joel anthony,0,0,0,0,0,0,0,0,0,0,0,0,0,0,0,0,0,0,0,0,0,0
474308,526_16_07,CANADA,0,TOTALS,CANADA,200,30,69,43.5,26,49,53.1,4,20,20,14,25,56,18,29,47,10,14,12,4,4,78
474309,526_16_07,NEW ZEALAND,21056,0,tai jack webster,30,6,14,42.9,4,10,40,2,4,50,1,2,50,4,6,10,4,4,1,1,1,15
474310,526_16_07,NEW ZEALAND,30799,3,shea ili,24,2,9,22.2,2,6,33.3,0,3,0,1,1,100,0,4,4,3,3,1,2,0,5
474311,526_16_07,NEW ZEALAND,21055,5,everard bartlett,11,0,0,0,0,0,0,0,0,0,0,0,0,0,1,1,1,0,0,0,1,0
474312,526_16_07,NEW ZEALAND,6773,7,mika vukona,31,3,5,60,3,5,60,0,0,0,0,0,0,5,3,8,2,5,3,1,0,6
474313,526_16_07,NEW ZEALAND,22922,8,derone raukawa,0,0,0,0,0,0,0,0,0,0,0,0,0,0,0,0,0,0,0,0,0,0
474314,526_16_07,NEW ZEALAND,11656,9,corey webster,32,8,18,44.4,5,10,50,3,8,37.5,2,2,100,0,2,2,1,3,2,1,0,21
474315,526_16_07,NEW ZEALAND,16523,10,thomas abercrombie,34,6,12,50,3,7,42.9,3,5,60,1,2,50,1,5,6,2,4,3,0,0,16
474316,526_16_07,NEW ZEALAND,16524,11,benny anthony,6,0,1,0,0,0,0,0,1,0,0,0,0,0,0,0,0,2,2,0,0,0
474317,526_16_07,NEW ZEALAND,25442,12,isaac fotu,9,1,3,33.3,0,1,0,1,2,50,0,0,0,1,0,1,1,0,0,0,0,3
474318,526_16_07,NEW ZEALAND,13832,14,robert loe,19,2,8,25,0,2,0,2,6,33.3,0,0,0,0,1,1,4,5,1,0,0,6
474319,526_16_07,NEW ZEALAND,16555,20,jordan ngatai,4,0,1,0,0,1,0,0,0,0,0,0,0,0,1,1,0,1,0,0,0,0
474320,526_16_07,NEW ZEALAND,16548,44,michael karena,0,0,0,0,0,0,0,0,0,0,0,0,0,0,0,0,0,0,0,0,0,0
474321,526_16_07,NEW ZEALAND,0,TOTALS,NEW ZEALAND,200,28,71,39.4,17,42,40.5,11,29,37.9,5,7,71.4,14,28,42,18,27,13,5,2,72
474322,526_16_08,FRANCE,12495,4,thomas heurtel,21,7,11,63.6,5,8,62.5,2,3,66.7,1,2,50,0,1,1,4,3,1,1,0,17
474323,526_16_08,FRANCE,2588,5,nicolas batum,21,0,3,0,0,1,0,0,2,0,3,3,100,0,0,0,2,3,1,2,0,3
474324,526_16_08,FRANCE,2589,6,antoine diot,18,4,7,57.1,2,3,66.7,2,4,50,0,0,0,1,0,1,0,0,1,0,0,10
474325,526_16_08,FRANCE,11076,7,joffrey lauvergne,16,5,7,71.4,5,5,100,0,2,0,1,1,100,2,3,5,1,3,0,0,0,11
474326,526_16_08,FRANCE,1864,8,charles kahudi,4,0,1,0,0,1,0,0,0,0,0,0,0,0,0,0,0,0,0,0,0,0
474327,526_16_08,FRANCE,5047,9,tony parker,19,1,4,25,1,1,100,0,3,0,0,0,0,0,2,2,3,0,2,1,0,2
474328,526_16_08,FRANCE,4663,11,florent pietrus,12,2,3,66.7,2,2,100,0,1,0,0,0,0,0,0,0,0,3,0,0,0,4
474329,526_16_08,FRANCE,10428,12,nando de colo,25,4,8,50,1,1,100,3,7,42.9,2,2,100,0,3,3,3,3,5,2,0,13
474330,526_16_08,FRANCE,4665,13,boris diaw,27,2,5,40,2,5,40,0,0,0,0,0,0,2,5,7,2,2,1,2,2,4
474331,526_16_08,FRANCE,5044,15,mickael gelabale,18,2,3,66.7,2,3,66.7,0,0,0,1,1,100,1,5,6,1,3,0,0,0,5
474332,526_16_08,FRANCE,7987,17,kim tillie,16,2,4,50,2,3,66.7,0,1,0,0,0,0,0,0,0,2,2,0,1,1,4
474333,526_16_08,FRANCE,2594,18,adrien moerman,3,1,2,50,1,2,50,0,0,0,0,0,0,1,0,1,0,0,1,0,0,2
474334,526_16_08,FRANCE,0,TOTALS,FRANCE,200,30,58,51.7,23,35,65.7,7,23,30.4,8,9,88.9,10,19,29,18,22,13,9,3,75
474335,526_16_08,TURKEY,4572,1,ender arslan,14,1,4,25,0,0,0,1,4,25,1,3,33.3,0,2,2,5,1,1,1,0,4
474336,526_16_08,TURKEY,7790,3,omer asik,28,8,11,72.7,8,11,72.7,0,0,0,3,3,100,4,1,5,1,2,3,1,0,19
474337,526_16_08,TURKEY,15304,5,sinan guler,22,0,0,0,0,0,0,0,0,0,1,2,50,0,1,1,1,3,3,2,0,1
474338,526_16_08,TURKEY,20219,6,cedi osman,24,2,7,28.6,2,3,66.7,0,4,0,3,4,75,2,4,6,2,1,1,0,0,7
474339,526_16_08,TURKEY,1797,9,semih erden,32,4,9,44.4,4,9,44.4,0,0,0,3,4,75,3,4,7,2,2,4,1,0,11
474340,526_16_08,TURKEY,8151,10,melih mahmutoglu,15,1,5,20,1,1,100,0,4,0,0,0,0,0,0,0,1,2,1,0,0,2
474341,526_16_08,TURKEY,1796,11,oguz savas,0,0,0,0,0,0,0,0,0,0,0,0,0,0,0,0,0,0,0,0,0,0
474342,526_16_08,TURKEY,15900,12,samet geyik,3,0,1,0,0,0,0,0,1,0,0,0,0,0,0,0,1,0,0,0,0,0
474343,526_16_08,TURKEY,29512,13,ali muhammed,31,4,11,36.4,3,6,50,1,5,20,2,2,100,1,3,4,4,2,2,0,0,11
474344,526_16_08,TURKEY,6165,15,birkan batuk,16,2,4,50,1,2,50,1,2,50,0,0,0,0,2,2,1,1,0,0,0,5
474345,526_16_08,TURKEY,24656,21,furkan korkmaz,12,0,1,0,0,1,0,0,0,0,3,3,100,1,0,1,0,3,1,0,0,3
474346,526_16_08,TURKEY,15897,25,kenan sipahi,4,0,0,0,0,0,0,0,0,0,0,0,0,0,0,0,0,0,0,0,0,0
474347,526_16_08,TURKEY,0,TOTALS,TURKEY,200,22,53,41.5,19,33,57.6,3,20,15,16,21,76.2,14,19,33,18,17,16,5,0,63
474348,526_16_09,CANADA,16951,4,philip scrubb,23,1,5,20,1,3,33.3,0,2,0,0,0,0,1,1,2,4,0,0,0,0,2
474349,526_16_09,CANADA,30911,5,shai gilgeous-alexander,0,0,0,0,0,0,0,0,0,0,0,0,0,0,0,0,0,0,0,0,0,0
474350,526_16_09,CANADA,8989,6,cory joseph,36,9,16,56.2,9,13,69.2,0,3,0,2,3,66.7,1,3,4,6,1,7,3,0,20
474351,526_16_09,CANADA,28756,7,melvin ejim,26,7,10,70,3,6,50,4,4,100,1,2,50,3,0,3,0,5,1,0,0,19
474352,526_16_09,CANADA,30912,8,thomas scrubb,18,2,7,28.6,1,3,33.3,1,4,25,0,0,0,1,2,3,2,0,1,0,1,5
474353,526_16_09,CANADA,16953,9,khem birch,13,1,2,50,1,2,50,0,0,0,0,0,0,0,3,3,0,1,0,0,1,2
474354,526_16_09,CANADA,14713,10,anthony bennett,19,2,3,66.7,1,1,100,1,2,50,2,3,66.7,0,5,5,0,2,2,0,0,7
474355,526_16_09,CANADA,21284,11,tyler ennis,28,4,9,44.4,3,7,42.9,1,2,50,0,0,0,0,2,2,2,4,3,1,0,9
474356,526_16_09,CANADA,23740,12,brady heslip,11,1,3,33.3,1,1,100,0,2,0,0,0,0,0,1,1,0,0,1,0,0,2
474357,526_16_09,CANADA,12214,13,tristan thompson,27,4,6,66.7,4,6,66.7,0,0,0,0,0,0,4,3,7,0,4,3,0,0,8
474358,526_16_09,CANADA,498,14,levon kendall,0,0,0,0,0,0,0,0,0,0,0,0,0,0,0,0,0,0,0,0,0,0
474359,526_16_09,CANADA,11679,15,joel anthony,0,0,0,0,0,0,0,0,0,0,0,0,0,0,0,0,0,0,0,0,0,0
474360,526_16_09,CANADA,0,TOTALS,CANADA,200,31,61,50.8,24,42,57.1,7,19,36.8,5,8,62.5,13,22,35,14,17,21,4,2,74
474361,526_16_09,FRANCE,12495,4,thomas heurtel,14,2,5,40,1,1,100,1,4,25,0,0,0,0,1,1,2,1,1,1,0,5
474362,526_16_09,FRANCE,2588,5,nicolas batum,25,3,4,75,2,2,100,1,2,50,0,0,0,2,2,4,1,3,2,0,1,7
474363,526_16_09,FRANCE,2589,6,antoine diot,8,1,4,25,0,1,0,1,3,33.3,0,0,0,1,0,1,0,1,0,0,0,3
474364,526_16_09,FRANCE,11076,7,joffrey lauvergne,17,1,3,33.3,1,2,50,0,1,0,2,2,100,1,2,3,0,4,2,0,0,4
474365,526_16_09,FRANCE,1864,8,charles kahudi,10,2,2,100,2,2,100,0,0,0,1,1,100,1,0,1,0,1,0,1,0,5
474366,526_16_09,FRANCE,5047,9,tony parker,28,9,14,64.3,6,9,66.7,3,5,60,5,7,71.4,0,4,4,4,0,3,1,0,26
474367,526_16_09,FRANCE,4663,11,florent pietrus,6,0,0,0,0,0,0,0,0,0,0,0,0,0,1,1,0,2,2,0,0,0
474368,526_16_09,FRANCE,10428,12,nando de colo,30,8,12,66.7,8,10,80,0,2,0,6,7,85.7,1,4,5,3,1,0,3,0,22
474369,526_16_09,FRANCE,4665,13,boris diaw,36,3,13,23.1,0,4,0,3,9,33.3,0,0,0,0,2,2,4,1,2,2,1,9
474370,526_16_09,FRANCE,5044,15,mickael gelabale,14,1,4,25,1,3,33.3,0,1,0,0,0,0,0,0,0,0,2,0,1,0,2
474371,526_16_09,FRANCE,7987,17,kim tillie,12,0,0,0,0,0,0,0,0,0,0,0,0,1,1,2,0,2,3,0,0,0
474372,526_16_09,FRANCE,2594,18,adrien moerman,0,0,0,0,0,0,0,0,0,0,0,0,0,0,0,0,0,0,0,0,0,0
474373,526_16_09,FRANCE,0,TOTALS,FRANCE,200,30,61,49.2,21,34,61.8,9,27,33.3,14,17,82.4,8,18,26,14,18,16,9,2,83
474374,527_16_01,JAPAN,28341,0,yuta tabuse,18,1,4,25,1,3,33.3,0,1,0,0,0,0,1,2,3,4,1,0,2,0,2
474375,527_16_01,JAPAN,23325,3,naoto tsuji,19,3,8,37.5,1,4,25,2,4,50,3,3,100,0,0,0,1,2,2,0,0,11
474376,527_16_01,JAPAN,23322,6,makoto hiejima,25,4,12,33.3,4,9,44.4,0,3,0,1,1,100,0,2,2,1,3,2,1,0,9
474377,527_16_01,JAPAN,18625,8,atsuya ota,14,1,1,100,1,1,100,0,0,0,0,0,0,0,3,3,0,1,0,0,0,2
474378,527_16_01,JAPAN,3875,10,kosuke takeuchi,32,5,7,71.4,4,6,66.7,1,1,100,1,2,50,3,1,4,0,2,0,1,1,12
474379,527_16_01,JAPAN,28342,11,ryoma hashimoto,11,0,2,0,0,1,0,0,1,0,0,0,0,0,0,0,1,3,1,0,0,0
474380,527_16_01,JAPAN,23323,12,yuta watanabe,18,1,6,16.7,1,4,25,0,2,0,2,2,100,0,1,1,1,2,3,0,0,4
474381,527_16_01,JAPAN,3875,15,joji takeuchi,18,3,9,33.3,3,9,33.3,0,0,0,0,0,0,2,2,4,0,1,2,0,0,6
474382,527_16_01,JAPAN,18621,16,keijuro matsui,8,0,4,0,0,1,0,0,3,0,0,0,0,0,1,1,0,2,0,0,0,0
474383,527_16_01,JAPAN,28344,25,takatoshi furukawa,11,0,4,0,0,1,0,0,3,0,0,0,0,0,4,4,0,0,0,0,0,0
474384,527_16_01,JAPAN,25620,34,ryumo ono,16,0,5,0,0,3,0,0,2,0,2,2,100,2,2,4,1,1,2,1,0,2
474385,527_16_01,JAPAN,18623,42,kenta hirose,9,0,1,0,0,1,0,0,0,0,0,0,0,0,0,0,1,2,2,0,0,0
474386,527_16_01,JAPAN,0,TOTALS,JAPAN,200,18,63,28.6,15,43,34.9,3,20,15,9,10,90,9,20,29,10,20,14,5,1,48
474387,527_16_01,LATVIA,19755,5,mareks mejeris,22,3,8,37.5,3,7,42.9,0,1,0,0,2,0,4,2,6,0,0,0,2,1,6
474388,527_16_01,LATVIA,5029,7,janis blums,17,6,8,75,1,1,100,5,7,71.4,0,0,0,0,0,0,1,1,3,0,0,17
474389,527_16_01,LATVIA,15922,8,janis berzins,18,1,7,14.3,1,4,25,0,3,0,0,0,0,2,6,8,6,0,2,1,0,2
474390,527_16_01,LATVIA,6271,9,dairis bertans,18,8,10,80,5,5,100,3,5,60,1,1,100,1,2,3,4,1,0,2,0,20
474391,527_16_01,LATVIA,12927,10,janis timma,21,3,7,42.9,1,1,100,2,6,33.3,0,0,0,0,5,5,4,2,2,1,2,8
474392,527_16_01,LATVIA,10585,13,janis strelnieks,17,0,1,0,0,0,0,0,1,0,0,0,0,0,1,1,5,1,2,1,0,0
474393,527_16_01,LATVIA,1002,14,kaspars berzins,21,3,4,75,3,3,100,0,1,0,3,4,75,1,5,6,2,1,0,0,1,9
474394,527_16_01,LATVIA,15926,15,ojars silins,18,2,5,40,1,2,50,1,3,33.3,0,0,0,2,3,5,1,2,0,1,3,5
474395,527_16_01,LATVIA,29525,21,aigars skele,17,3,5,60,2,2,100,1,3,33.3,1,4,25,0,2,2,0,1,1,2,0,8
474396,527_16_01,LATVIA,24412,32,anzejs pasecniks,10,2,4,50,2,3,66.7,0,1,0,1,2,50,1,2,3,0,1,0,0,2,5
474397,527_16_01,LATVIA,15602,33,martins meiers,9,2,5,40,2,5,40,0,0,0,2,2,100,2,2,4,0,2,1,0,0,6
474398,527_16_01,LATVIA,19994,41,ingus jakovics,12,0,0,0,0,0,0,0,0,0,2,2,100,0,0,0,0,1,2,0,0,2
474399,527_16_01,LATVIA,0,TOTALS,LATVIA,200,33,64,51.6,21,33,63.6,12,31,38.7,10,17,58.8,14,34,48,23,13,13,10,9,88
474400,527_16_02,SERBIA,5751,4,milos teodosic,21,3,10,30,1,3,33.3,2,7,28.6,1,2,50,0,3,3,6,3,3,0,0,9
474401,527_16_02,SERBIA,2100,5,marko simonovic,15,2,3,66.7,2,2,100,0,1,0,0,0,0,0,0,0,1,3,1,2,0,4
474402,527_16_02,SERBIA,16637,6,nemanja dangubic,3,0,1,0,0,0,0,0,1,0,0,0,0,0,0,0,0,0,0,0,0,0
474403,527_16_02,SERBIA,17361,7,bogdan bogdanovic,26,5,13,38.5,3,5,60,2,8,25,0,1,0,0,7,7,5,1,1,0,0,12
474404,527_16_02,SERBIA,2654,9,stefan markovic,22,1,2,50,1,1,100,0,1,0,0,2,0,1,1,2,3,3,3,1,0,2
474405,527_16_02,SERBIA,19860,10,nikola kalinic,23,3,4,75,2,3,66.7,1,1,100,5,5,100,3,1,4,3,3,2,4,0,12
474406,527_16_02,SERBIA,15503,11,nemanja nedovic,20,6,10,60,4,6,66.7,2,4,50,0,0,0,2,0,2,1,4,1,0,0,14
474407,527_16_02,SERBIA,15504,12,stefan bircevic,11,5,7,71.4,3,4,75,2,3,66.7,0,0,0,1,0,1,0,2,2,0,0,12
474408,527_16_02,SERBIA,2656,13,miroslav raduljica,6,1,3,33.3,1,3,33.3,0,0,0,0,0,0,0,0,0,0,5,0,0,0,2
474409,527_16_02,SERBIA,22978,14,nikola jokic,21,5,9,55.6,5,8,62.5,0,1,0,2,4,50,2,6,8,2,1,1,0,0,12
474410,527_16_02,SERBIA,5756,15,vladimir stimac,13,4,5,80,4,5,80,0,0,0,0,2,0,2,2,4,0,2,1,1,0,8
474411,527_16_02,SERBIA,25441,24,stefan jovic,18,0,2,0,0,2,0,0,0,0,0,2,0,0,1,1,4,1,0,1,0,0
474412,527_16_02,SERBIA,0,TOTALS,SERBIA,200,35,69,50.7,26,42,61.9,9,27,33.3,8,18,44.4,11,23,34,25,29,15,9,0,87
474413,527_16_02,PUERTO RICO,23748,1,ramon clemente,17,2,3,66.7,2,3,66.7,0,0,0,1,2,50,1,2,3,1,1,0,1,0,5
474414,527_16_02,PUERTO RICO,14636,2,guillermo diaz,6,0,1,0,0,0,0,0,1,0,0,0,0,0,0,0,2,0,0,0,0,0
474415,527_16_02,PUERTO RICO,472,5,j.j. barea,25,3,11,27.3,2,6,33.3,1,5,20,3,4,75,0,1,1,3,1,1,0,0,10
474416,527_16_02,PUERTO RICO,100,7,carlos arroyo,21,3,4,75,3,3,100,0,1,0,1,2,50,0,1,1,2,0,2,0,0,7
474417,527_16_02,PUERTO RICO,3479,8,angel vassallo colon,17,3,7,42.9,0,0,0,3,7,42.9,1,2,50,1,3,4,0,0,2,0,0,10
474418,527_16_02,PUERTO RICO,8997,10,jorge bryan diaz,12,1,1,100,1,1,100,0,0,0,0,0,0,1,3,4,1,2,2,0,0,2
474419,527_16_02,PUERTO RICO,481,11,ricky sanchez rosa,22,3,5,60,2,2,100,1,3,33.3,1,2,50,0,3,3,0,4,2,1,0,8
474420,527_16_02,PUERTO RICO,16592,13,renaldo balkman,13,0,4,0,0,3,0,0,1,0,0,0,0,0,2,2,0,4,1,3,1,0
474421,527_16_02,PUERTO RICO,3478,15,alexander galindo,6,1,3,33.3,0,0,0,1,3,33.3,0,2,0,1,0,1,0,3,0,3,0,3
474422,527_16_02,PUERTO RICO,19067,23,john holland,23,6,11,54.5,4,7,57.1,2,4,50,7,8,87.5,2,3,5,1,3,3,4,0,21
474423,527_16_02,PUERTO RICO,7435,33,david huertas,23,1,4,25,0,2,0,1,2,50,2,2,100,0,0,0,1,3,4,1,0,5
474424,527_16_02,PUERTO RICO,104,36,peter ramos,16,4,7,57.1,4,7,57.1,0,0,0,2,3,66.7,2,5,7,0,2,3,0,0,10
474425,527_16_02,PUERTO RICO,0,TOTALS,PUERTO RICO,200,27,61,44.3,18,34,52.9,9,27,33.3,18,27,66.7,13,27,40,11,23,21,13,1,81
474426,527_16_03,PUERTO RICO,23748,1,ramon clemente,19,1,3,33.3,1,3,33.3,0,0,0,5,6,83.3,1,3,4,2,4,1,2,2,7
474427,527_16_03,PUERTO RICO,14636,2,guillermo diaz,9,0,3,0,0,2,0,0,1,0,0,2,0,0,0,0,0,2,0,1,0,0
474428,527_16_03,PUERTO RICO,472,5,j.j. barea,25,4,7,57.1,2,4,50,2,3,66.7,8,10,80,1,4,5,7,1,3,1,0,18
474429,527_16_03,PUERTO RICO,100,7,carlos arroyo,19,6,7,85.7,2,3,66.7,4,4,100,2,2,100,0,2,2,5,1,0,1,0,18
474430,527_16_03,PUERTO RICO,3479,8,angel vassallo colon,16,3,7,42.9,1,2,50,2,5,40,0,0,0,0,2,2,1,2,1,0,0,8
474431,527_16_03,PUERTO RICO,8997,10,jorge bryan diaz,19,2,4,50,2,4,50,0,0,0,4,6,66.7,1,3,4,2,1,1,0,0,8
474432,527_16_03,PUERTO RICO,481,11,ricky sanchez rosa,18,2,3,66.7,1,1,100,1,2,50,0,0,0,0,5,5,0,4,1,1,0,5
474433,527_16_03,PUERTO RICO,16592,13,renaldo balkman,16,3,5,60,3,4,75,0,1,0,0,0,0,1,3,4,2,0,1,0,2,6
474434,527_16_03,PUERTO RICO,3478,15,alexander galindo,10,0,2,0,0,0,0,0,2,0,0,0,0,0,0,0,0,2,1,0,0,0
474435,527_16_03,PUERTO RICO,19067,23,john holland,17,1,5,20,0,3,0,1,2,50,8,8,100,2,3,5,3,3,3,0,0,11
474436,527_16_03,PUERTO RICO,7435,33,david huertas,18,2,4,50,1,1,100,1,3,33.3,1,1,100,1,0,1,0,1,2,0,0,6
474437,527_16_03,PUERTO RICO,104,36,peter ramos,13,2,5,40,2,5,40,0,0,0,0,0,0,0,1,1,0,5,3,0,2,4
474438,527_16_03,PUERTO RICO,0,TOTALS,PUERTO RICO,200,26,55,47.3,15,32,46.9,11,23,47.8,28,35,80,7,28,35,22,26,19,6,6,91
474439,527_16_03,ANGOLA,30917,2,gerson domingos,14,1,3,33.3,0,1,0,1,2,50,0,2,0,0,1,1,2,1,2,0,0,3
474440,527_16_03,ANGOLA,30918,3,gerson goncalves,12,0,2,0,0,1,0,0,1,0,0,0,0,0,1,1,2,1,2,1,0,0
474441,527_16_03,ANGOLA,3420,6,carlos morais,32,8,15,53.3,5,7,71.4,3,8,37.5,2,2,100,1,0,1,1,3,3,1,0,21
474442,527_16_03,ANGOLA,11834,8,hermenegildo santos,17,1,4,25,0,1,0,1,3,33.3,0,0,0,1,1,2,2,3,2,0,0,3
474443,527_16_03,ANGOLA,11630,9,leonel paulo,28,5,10,50,5,10,50,0,0,0,4,6,66.7,3,2,5,0,5,1,2,0,14
474444,527_16_03,ANGOLA,25497,10,silvio sousa,13,3,6,50,3,6,50,0,0,0,3,5,60,1,3,4,0,1,1,0,0,9
474445,527_16_03,ANGOLA,25504,11,bruno fernandes,7,1,2,50,1,2,50,0,0,0,2,4,50,2,2,4,0,3,1,0,0,4
474446,527_16_03,ANGOLA,9123,12,felizardo ambrosio,22,2,6,33.3,2,5,40,0,1,0,0,0,0,1,5,6,0,3,2,1,0,4
474447,527_16_03,ANGOLA,13822,13,islando manuel,6,3,5,60,3,4,75,0,1,0,0,2,0,3,0,3,1,3,0,1,0,6
474448,527_16_03,ANGOLA,13818,14,edson ndoniema,4,0,1,0,0,0,0,0,1,0,0,0,0,0,0,0,0,3,1,0,0,0
474449,527_16_03,ANGOLA,7039,15,valdelicio joaquim,15,0,6,0,0,4,0,0,2,0,0,0,0,1,2,3,2,0,0,0,0,0
474450,527_16_03,ANGOLA,23104,23,reggie moore,30,6,13,46.2,4,6,66.7,2,7,28.6,3,3,100,2,4,6,1,0,1,1,0,17
474451,527_16_03,ANGOLA,0,TOTALS,ANGOLA,200,30,73,41.1,23,47,48.9,7,26,26.9,14,24,58.3,19,23,42,11,26,16,7,0,81
474452,527_16_04,LATVIA,19755,5,mareks mejeris,12,0,1,0,0,0,0,0,1,0,0,0,0,0,1,1,1,1,2,2,0,0
474453,527_16_04,LATVIA,5029,7,janis blums,17,1,5,20,0,1,0,1,4,25,0,0,0,0,2,2,2,0,1,0,0,3
474454,527_16_04,LATVIA,15922,8,janis berzins,11,0,2,0,0,0,0,0,2,0,2,2,100,0,0,0,0,0,1,2,0,2
474455,527_16_04,LATVIA,6271,9,dairis bertans,33,4,12,33.3,2,5,40,2,7,28.6,8,9,88.9,0,5,5,2,3,2,0,0,18
474456,527_16_04,LATVIA,12927,10,janis timma,30,4,7,57.1,4,5,80,0,2,0,5,5,100,0,4,4,1,3,2,0,0,13
474457,527_16_04,LATVIA,10585,13,janis strelnieks,30,4,9,44.4,3,5,60,1,4,25,2,2,100,1,4,5,5,2,2,2,0,11
474458,527_16_04,LATVIA,1002,14,kaspars berzins,17,2,8,25,2,6,33.3,0,2,0,0,0,0,2,2,4,2,5,3,1,0,4
474459,527_16_04,LATVIA,15926,15,ojars silins,17,1,4,25,1,3,33.3,0,1,0,3,4,75,0,4,4,0,4,0,2,0,5
474460,527_16_04,LATVIA,29525,21,aigars skele,1,0,0,0,0,0,0,0,0,0,0,0,0,0,0,0,0,0,0,0,0,0
474461,527_16_04,LATVIA,24412,32,anzejs pasecniks,21,3,9,33.3,2,5,40,1,4,25,0,2,0,2,3,5,0,2,0,0,0,7
474462,527_16_04,LATVIA,15602,33,martins meiers,11,3,4,75,3,4,75,0,0,0,2,2,100,0,5,5,0,5,1,0,1,8
474463,527_16_04,LATVIA,19994,41,ingus jakovics,1,0,0,0,0,0,0,0,0,0,0,0,0,0,0,0,0,0,0,1,0,0
474464,527_16_04,LATVIA,0,TOTALS,LATVIA,200,22,61,36.1,17,34,50,5,27,18.5,22,26,84.6,9,33,42,13,26,14,10,1,71
474465,527_16_04,CZECH REPUBLIC,4677,4,petr benda,27,4,10,40,4,8,50,0,2,0,1,2,50,2,0,2,0,3,1,0,0,9
474466,527_16_04,CZECH REPUBLIC,29502,5,patrik auda,13,0,2,0,0,2,0,0,0,0,2,4,50,1,2,3,1,0,0,1,0,2
474467,527_16_04,CZECH REPUBLIC,5478,6,pavel pumprla,27,4,7,57.1,3,5,60,1,2,50,0,0,0,0,2,2,4,3,2,2,1,9
474468,527_16_04,CZECH REPUBLIC,10700,7,vojtech hruban,16,2,6,33.3,2,5,40,0,1,0,0,0,0,1,3,4,1,3,1,0,0,4
474469,527_16_04,CZECH REPUBLIC,8325,8,tomas satoransky,36,2,7,28.6,2,5,40,0,2,0,1,2,50,2,6,8,8,4,3,0,0,5
474470,527_16_04,CZECH REPUBLIC,4774,9,jiri welsch,20,3,6,50,3,6,50,0,0,0,2,5,40,1,4,5,0,4,3,2,0,8
474471,527_16_04,CZECH REPUBLIC,1096,10,pavel houska,11,1,5,20,1,2,50,0,3,0,0,0,0,0,1,1,0,2,2,0,1,2
474472,527_16_04,CZECH REPUBLIC,10702,11,lukas palyza,4,0,0,0,0,0,0,0,0,0,0,0,0,0,2,2,0,2,0,0,0,0
474473,527_16_04,CZECH REPUBLIC,10484,13,jakub sirina,1,0,0,0,0,0,0,0,0,0,0,0,0,0,1,1,0,0,0,0,0,0
474474,527_16_04,CZECH REPUBLIC,29503,21,blake schilb,28,4,11,36.4,3,6,50,1,5,20,1,3,33.3,0,7,7,4,1,1,1,0,10
474475,527_16_04,CZECH REPUBLIC,6362,24,jan vesely,17,3,6,50,3,6,50,0,0,0,4,7,57.1,2,1,3,1,5,2,0,1,10
474476,527_16_04,CZECH REPUBLIC,12851,31,martin kriz,1,0,1,0,0,1,0,0,0,0,0,0,0,1,0,1,0,0,0,0,0,0
474477,527_16_04,CZECH REPUBLIC,0,TOTALS,CZECH REPUBLIC,200,23,61,37.7,21,46,45.7,2,15,13.3,11,23,47.8,12,29,41,19,27,16,6,3,59
474478,527_16_05,ANGOLA,30917,2,gerson domingos,6,0,2,0,0,1,0,0,1,0,0,2,0,0,0,0,2,0,0,0,0,0
474479,527_16_05,ANGOLA,30918,3,gerson goncalves,16,1,7,14.3,1,5,20,0,2,0,0,0,0,1,3,4,1,1,0,1,0,2
474480,527_16_05,ANGOLA,3420,6,carlos morais,28,3,11,27.3,2,6,33.3,1,5,20,0,0,0,0,2,2,1,2,7,4,0,7
474481,527_16_05,ANGOLA,11834,8,hermenegildo santos,26,3,5,60,0,1,0,3,4,75,0,0,0,0,2,2,2,3,5,1,0,9
474482,527_16_05,ANGOLA,11630,9,leonel paulo,9,0,2,0,0,2,0,0,0,0,0,0,0,0,1,1,1,2,2,0,0,0
474483,527_16_05,ANGOLA,25497,10,silvio sousa,10,1,2,50,1,2,50,0,0,0,0,0,0,1,1,2,0,4,1,0,0,2
474484,527_16_05,ANGOLA,25504,11,bruno fernandes,7,1,5,20,1,5,20,0,0,0,1,2,50,5,1,6,0,2,1,0,0,3
474485,527_16_05,ANGOLA,9123,12,felizardo ambrosio,27,3,6,50,3,5,60,0,1,0,1,2,50,2,2,4,1,3,1,0,1,7
474486,527_16_05,ANGOLA,13822,13,islando manuel,20,1,3,33.3,0,0,0,1,3,33.3,0,2,0,2,3,5,0,2,0,0,0,3
474487,527_16_05,ANGOLA,13818,14,edson ndoniema,12,2,4,50,0,1,0,2,3,66.7,2,2,100,0,2,2,0,2,1,0,0,8
474488,527_16_05,ANGOLA,7039,15,valdelicio joaquim,16,4,8,50,3,5,60,1,3,33.3,0,0,0,1,0,1,1,3,0,0,1,9
474489,527_16_05,ANGOLA,23104,23,reggie moore,23,4,8,50,2,2,100,2,6,33.3,0,0,0,0,1,1,0,2,0,0,1,10
474490,527_16_05,ANGOLA,0,TOTALS,ANGOLA,200,23,63,36.5,13,35,37.1,10,28,35.7,4,10,40,16,21,37,9,26,21,6,3,60
474491,527_16_05,SERBIA,5751,4,milos teodosic,24,2,4,50,0,1,0,2,3,66.7,2,2,100,0,2,2,6,3,4,0,0,8
474492,527_16_05,SERBIA,2100,5,marko simonovic,10,0,2,0,0,0,0,0,2,0,0,0,0,1,2,3,0,3,0,0,1,0
474493,527_16_05,SERBIA,16637,6,nemanja dangubic,9,0,1,0,0,1,0,0,0,0,0,0,0,0,2,2,0,0,3,0,1,0
474494,527_16_05,SERBIA,17361,7,bogdan bogdanovic,26,4,6,66.7,0,1,0,4,5,80,0,0,0,0,4,4,8,1,1,1,0,12
474495,527_16_05,SERBIA,2654,9,stefan markovic,19,3,5,60,0,0,0,3,5,60,3,4,75,0,0,0,2,2,0,1,0,12
474496,527_16_05,SERBIA,19860,10,nikola kalinic,18,0,1,0,0,1,0,0,0,0,0,0,0,0,0,0,2,2,1,0,0,0
474497,527_16_05,SERBIA,15503,11,nemanja nedovic,14,2,5,40,1,1,100,1,4,25,0,0,0,0,2,2,1,0,1,0,0,5
474498,527_16_05,SERBIA,15504,12,stefan bircevic,12,3,4,75,3,3,100,0,1,0,0,0,0,0,2,2,1,1,0,0,0,6
474499,527_16_05,SERBIA,2656,13,miroslav raduljica,21,6,11,54.5,6,11,54.5,0,0,0,1,3,33.3,0,2,2,2,2,4,1,0,13
474500,527_16_05,SERBIA,22978,14,nikola jokic,18,6,9,66.7,6,9,66.7,0,0,0,5,7,71.4,1,5,6,1,4,0,2,1,17
474501,527_16_05,SERBIA,5756,15,vladimir stimac,7,1,1,100,1,1,100,0,0,0,1,3,33.3,0,1,1,1,0,0,0,1,3
474502,527_16_05,SERBIA,25441,24,stefan jovic,20,3,6,50,3,4,75,0,2,0,1,1,100,0,1,1,0,2,1,3,1,7
474503,527_16_05,SERBIA,0,TOTALS,SERBIA,200,30,55,54.5,20,33,60.6,10,22,45.5,13,20,65,4,27,31,24,20,16,8,5,83
474504,527_16_06,CZECH REPUBLIC,4677,4,petr benda,23,4,8,50,4,8,50,0,0,0,0,2,0,3,2,5,2,2,0,0,0,8
474505,527_16_06,CZECH REPUBLIC,29502,5,patrik auda,19,4,7,57.1,4,5,80,0,2,0,0,0,0,1,5,6,5,2,0,1,1,8
474506,527_16_06,CZECH REPUBLIC,5478,6,pavel pumprla,14,4,6,66.7,4,5,80,0,1,0,1,1,100,1,3,4,3,3,1,1,0,9
474507,527_16_06,CZECH REPUBLIC,10700,7,vojtech hruban,15,3,6,50,2,3,66.7,1,3,33.3,0,1,0,0,1,1,0,2,1,0,0,7
474508,527_16_06,CZECH REPUBLIC,8325,8,tomas satoransky,28,5,10,50,4,6,66.7,1,4,25,0,0,0,0,4,4,7,1,2,0,1,11
474509,527_16_06,CZECH REPUBLIC,4774,9,jiri welsch,20,3,6,50,3,6,50,0,0,0,1,4,25,2,3,5,6,1,0,1,0,7
474510,527_16_06,CZECH REPUBLIC,1096,10,pavel houska,5,1,2,50,1,2,50,0,0,0,0,0,0,0,1,1,0,0,0,0,0,2
474511,527_16_06,CZECH REPUBLIC,10702,11,lukas palyza,23,7,16,43.8,1,2,50,6,14,42.9,2,2,100,1,4,5,1,1,0,0,1,22
474512,527_16_06,CZECH REPUBLIC,10484,13,jakub sirina,3,0,1,0,0,0,0,0,1,0,0,0,0,0,0,0,1,0,1,0,0,0
474513,527_16_06,CZECH REPUBLIC,29503,21,blake schilb,18,2,4,50,1,1,100,1,3,33.3,0,0,0,0,0,0,2,1,0,0,0,5
474514,527_16_06,CZECH REPUBLIC,6362,24,jan vesely,30,4,8,50,4,8,50,0,0,0,0,0,0,0,4,4,2,3,1,1,3,8
474515,527_16_06,CZECH REPUBLIC,12851,31,martin kriz,3,0,1,0,0,1,0,0,0,0,0,2,0,0,0,0,0,0,0,0,0,0
474516,527_16_06,CZECH REPUBLIC,0,TOTALS,CZECH REPUBLIC,200,37,75,49.3,28,47,59.6,9,28,32.1,4,12,33.3,13,30,43,29,16,6,4,6,87
474517,527_16_06,JAPAN,28341,0,yuta tabuse,24,0,4,0,0,2,0,0,2,0,0,0,0,0,3,3,6,2,0,0,0,0
474518,527_16_06,JAPAN,23325,3,naoto tsuji,21,6,9,66.7,1,1,100,5,8,62.5,1,2,50,0,0,0,0,3,0,1,0,18
474519,527_16_06,JAPAN,23322,6,makoto hiejima,27,6,15,40,4,11,36.4,2,4,50,2,2,100,0,2,2,3,4,1,0,0,16
474520,527_16_06,JAPAN,18625,8,atsuya ota,20,0,2,0,0,2,0,0,0,0,2,2,100,2,3,5,1,2,1,0,0,2
474521,527_16_06,JAPAN,3875,10,kosuke takeuchi,20,1,6,16.7,1,6,16.7,0,0,0,2,2,100,0,5,5,0,1,1,0,0,4
474522,527_16_06,JAPAN,28342,11,ryoma hashimoto,2,0,0,0,0,0,0,0,0,0,0,0,0,0,0,0,0,0,0,0,0,0
474523,527_16_06,JAPAN,23323,12,yuta watanabe,28,4,7,57.1,4,6,66.7,0,1,0,2,2,100,1,6,7,1,2,3,3,3,10
474524,527_16_06,JAPAN,3875,15,joji takeuchi,32,6,10,60,6,9,66.7,0,1,0,1,4,25,4,3,7,2,2,2,0,0,13
474525,527_16_06,JAPAN,18621,16,keijuro matsui,9,2,5,40,0,0,0,2,5,40,0,0,0,0,1,1,0,1,0,0,0,6
474526,527_16_06,JAPAN,28344,25,takatoshi furukawa,8,0,2,0,0,0,0,0,2,0,0,0,0,0,1,1,0,1,0,0,0,0
474527,527_16_06,JAPAN,25620,34,ryumo ono,8,1,2,50,1,2,50,0,0,0,0,0,0,0,0,0,1,1,0,0,0,2
474528,527_16_06,JAPAN,18623,42,kenta hirose,1,0,0,0,0,0,0,0,0,0,0,0,0,0,1,1,0,0,0,0,0,0
474529,527_16_06,JAPAN,0,TOTALS,JAPAN,200,26,62,41.9,17,39,43.6,9,23,39.1,10,14,71.4,7,28,35,14,19,10,4,3,71
474530,527_16_07,LATVIA,19755,5,mareks mejeris,7,0,1,0,0,1,0,0,0,0,0,0,0,0,0,0,1,2,0,0,0,0
474531,527_16_07,LATVIA,5029,7,janis blums,12,0,2,0,0,0,0,0,2,0,1,2,50,0,0,0,1,0,0,0,0,1
474532,527_16_07,LATVIA,15922,8,janis berzins,12,1,4,25,1,3,33.3,0,1,0,1,2,50,3,2,5,1,1,2,0,0,3
474533,527_16_07,LATVIA,6271,9,dairis bertans,33,4,10,40,3,4,75,1,6,16.7,2,4,50,0,2,2,7,1,0,1,0,11
474534,527_16_07,LATVIA,12927,10,janis timma,31,7,17,41.2,7,13,53.8,0,4,0,2,3,66.7,2,6,8,2,5,2,0,1,16
474535,527_16_07,LATVIA,10585,13,janis strelnieks,28,2,8,25,1,4,25,1,4,25,3,3,100,0,3,3,2,1,2,0,0,8
474536,527_16_07,LATVIA,1002,14,kaspars berzins,14,2,6,33.3,2,5,40,0,1,0,0,0,0,2,3,5,2,3,0,0,1,4
474537,527_16_07,LATVIA,15926,15,ojars silins,25,5,11,45.5,4,5,80,1,6,16.7,2,3,66.7,0,4,4,0,0,0,1,0,13
474538,527_16_07,LATVIA,29525,21,aigars skele,9,1,2,50,1,2,50,0,0,0,0,0,0,1,2,3,2,1,0,0,0,2
474539,527_16_07,LATVIA,24412,32,anzejs pasecniks,25,6,8,75,6,6,100,0,2,0,0,1,0,2,7,9,1,1,1,0,2,12
474540,527_16_07,LATVIA,15602,33,martins meiers,4,0,1,0,0,1,0,0,0,0,0,0,0,0,0,0,0,1,0,0,0,0
474541,527_16_07,LATVIA,19994,41,ingus jakovics,0,0,0,0,0,0,0,0,0,0,0,0,0,0,0,0,0,0,0,0,0,0
474542,527_16_07,LATVIA,0,TOTALS,LATVIA,200,28,70,40,25,44,56.8,3,26,11.5,11,18,61.1,10,32,42,19,16,7,2,4,70
474543,527_16_07,PUERTO RICO,23748,1,ramon clemente,18,1,4,25,1,4,25,0,0,0,0,0,0,3,4,7,0,1,2,1,0,2
474544,527_16_07,PUERTO RICO,14636,2,guillermo diaz,0,0,0,0,0,0,0,0,0,0,0,0,0,0,0,0,0,0,0,0,0,0
474545,527_16_07,PUERTO RICO,472,5,j.j. barea,34,5,13,38.5,3,7,42.9,2,6,33.3,2,3,66.7,0,7,7,5,1,2,0,0,14
474546,527_16_07,PUERTO RICO,100,7,carlos arroyo,23,5,10,50,3,6,50,2,4,50,2,4,50,0,4,4,5,3,0,1,0,14
474547,527_16_07,PUERTO RICO,3479,8,angel vassallo colon,17,0,4,0,0,2,0,0,2,0,0,0,0,0,2,2,0,1,0,0,0,0
474548,527_16_07,PUERTO RICO,8997,10,jorge bryan diaz,14,5,7,71.4,5,7,71.4,0,0,0,0,0,0,3,0,3,0,2,0,0,0,10
474549,527_16_07,PUERTO RICO,481,11,ricky sanchez rosa,18,1,6,16.7,0,3,0,1,3,33.3,0,0,0,1,3,4,0,4,0,0,0,3
474550,527_16_07,PUERTO RICO,16592,13,renaldo balkman,29,5,10,50,5,10,50,0,0,0,2,6,33.3,3,7,10,1,3,1,0,1,12
474551,527_16_07,PUERTO RICO,3478,15,alexander galindo,0,0,0,0,0,0,0,0,0,0,0,0,0,0,0,0,0,0,0,0,0,0
474552,527_16_07,PUERTO RICO,19067,23,john holland,30,7,14,50,6,9,66.7,1,5,20,0,0,0,0,3,3,0,3,0,3,0,15
474553,527_16_07,PUERTO RICO,7435,33,david huertas,12,1,2,50,0,0,0,1,2,50,2,2,100,0,0,0,0,1,0,0,0,5
474554,527_16_07,PUERTO RICO,104,36,peter ramos,5,1,3,33.3,1,3,33.3,0,0,0,0,0,0,0,0,0,1,0,0,0,0,2
474555,527_16_07,PUERTO RICO,0,TOTALS,PUERTO RICO,200,31,73,42.5,24,51,47.1,7,22,31.8,8,15,53.3,12,35,47,12,19,5,5,1,77
474556,527_16_08,SERBIA,5751,4,milos teodosic,26,6,14,42.9,2,4,50,4,10,40,0,0,0,0,0,0,6,2,4,3,0,16
474557,527_16_08,SERBIA,2100,5,marko simonovic,3,1,1,100,0,0,0,1,1,100,0,0,0,0,2,2,0,0,0,0,0,3
474558,527_16_08,SERBIA,16637,6,nemanja dangubic,3,0,0,0,0,0,0,0,0,0,0,0,0,0,0,0,0,0,0,0,0,0
474559,527_16_08,SERBIA,17361,7,bogdan bogdanovic,27,8,12,66.7,5,8,62.5,3,4,75,2,2,100,2,6,8,3,2,3,1,0,21
474560,527_16_08,SERBIA,2654,9,stefan markovic,17,1,4,25,1,1,100,0,3,0,2,2,100,1,0,1,2,2,0,1,0,4
474561,527_16_08,SERBIA,19860,10,nikola kalinic,22,3,6,50,1,4,25,2,2,100,0,0,0,0,1,1,0,4,0,3,0,8
474562,527_16_08,SERBIA,15503,11,nemanja nedovic,20,1,4,25,1,3,33.3,0,1,0,2,2,100,0,1,1,5,1,0,1,0,4
474563,527_16_08,SERBIA,15504,12,stefan bircevic,18,2,5,40,1,3,33.3,1,2,50,0,0,0,3,2,5,3,3,0,0,0,5
474564,527_16_08,SERBIA,2656,13,miroslav raduljica,22,4,4,100,4,4,100,0,0,0,4,4,100,0,2,2,6,2,0,0,0,12
474565,527_16_08,SERBIA,22978,14,nikola jokic,21,7,9,77.8,7,7,100,0,2,0,5,6,83.3,3,5,8,2,2,0,0,0,19
474566,527_16_08,SERBIA,5756,15,vladimir stimac,4,1,2,50,1,2,50,0,0,0,0,0,0,0,0,0,0,0,0,0,0,2
474567,527_16_08,SERBIA,25441,24,stefan jovic,17,1,3,33.3,1,3,33.3,0,0,0,0,0,0,1,4,5,1,1,1,1,0,2
474568,527_16_08,SERBIA,0,TOTALS,SERBIA,200,35,64,54.7,24,39,61.5,11,25,44,15,16,93.8,11,24,35,28,19,8,10,0,96
474569,527_16_08,CZECH REPUBLIC,4677,4,petr benda,25,2,3,66.7,1,2,50,1,1,100,0,0,0,1,1,2,2,3,1,0,1,5
474570,527_16_08,CZECH REPUBLIC,29502,5,patrik auda,21,4,6,66.7,2,3,66.7,2,3,66.7,0,1,0,2,1,3,2,2,3,0,1,10
474571,527_16_08,CZECH REPUBLIC,5478,6,pavel pumprla,17,1,2,50,1,1,100,0,1,0,0,0,0,0,0,0,2,1,0,0,1,2
474572,527_16_08,CZECH REPUBLIC,10700,7,vojtech hruban,17,2,10,20,1,4,25,1,6,16.7,2,2,100,2,1,3,0,3,0,0,1,7
474573,527_16_08,CZECH REPUBLIC,8325,8,tomas satoransky,37,6,12,50,4,9,44.4,2,3,66.7,0,0,0,0,7,7,7,2,4,2,0,14
474574,527_16_08,CZECH REPUBLIC,4774,9,jiri welsch,23,4,6,66.7,2,4,50,2,2,100,0,0,0,0,1,1,5,2,1,1,0,10
474575,527_16_08,CZECH REPUBLIC,1096,10,pavel houska,8,1,3,33.3,1,1,100,0,2,0,0,0,0,0,1,1,1,0,0,0,0,2
474576,527_16_08,CZECH REPUBLIC,10702,11,lukas palyza,8,2,6,33.3,1,2,50,1,4,25,0,0,0,0,2,2,1,2,0,0,0,5
474577,527_16_08,CZECH REPUBLIC,10484,13,jakub sirina,1,0,1,0,0,0,0,0,1,0,0,0,0,0,0,0,0,0,0,0,0,0
474578,527_16_08,CZECH REPUBLIC,29503,21,blake schilb,14,1,1,100,0,0,0,1,1,100,0,0,0,0,1,1,2,0,4,0,0,3
474579,527_16_08,CZECH REPUBLIC,6362,24,jan vesely,26,5,9,55.6,5,9,55.6,0,0,0,2,7,28.6,2,2,4,1,3,2,3,0,12
474580,527_16_08,CZECH REPUBLIC,12851,31,martin kriz,3,1,1,100,1,1,100,0,0,0,0,0,0,0,0,0,0,0,0,0,0,2
474581,527_16_08,CZECH REPUBLIC,0,TOTALS,CZECH REPUBLIC,200,29,60,48.3,19,36,52.8,10,24,41.7,4,10,40,10,18,28,23,18,15,6,4,72
474582,527_16_09,SERBIA,5751,4,milos teodosic,9,1,3,33.3,0,0,0,1,3,33.3,0,0,0,0,0,0,4,2,1,1,0,3
474583,527_16_09,SERBIA,2100,5,marko simonovic,23,4,7,57.1,3,5,60,1,2,50,2,2,100,1,1,2,0,2,1,2,2,11
474584,527_16_09,SERBIA,16637,6,nemanja dangubic,6,0,2,0,0,1,0,0,1,0,0,0,0,0,0,0,0,0,0,0,0,0
474585,527_16_09,SERBIA,17361,7,bogdan bogdanovic,24,9,14,64.3,3,4,75,6,10,60,2,2,100,0,2,2,8,0,1,0,0,26
474586,527_16_09,SERBIA,2654,9,stefan markovic,16,0,0,0,0,0,0,0,0,0,2,2,100,2,2,4,5,3,0,1,0,2
474587,527_16_09,SERBIA,19860,10,nikola kalinic,26,4,5,80,3,3,100,1,2,50,6,6,100,0,1,1,2,1,1,0,0,15
474588,527_16_09,SERBIA,15503,11,nemanja nedovic,13,1,2,50,0,0,0,1,2,50,2,2,100,0,1,1,1,2,2,1,0,5
474589,527_16_09,SERBIA,15504,12,stefan bircevic,16,4,4,100,2,2,100,2,2,100,3,4,75,0,3,3,2,3,1,1,0,13
474590,527_16_09,SERBIA,2656,13,miroslav raduljica,12,1,3,33.3,1,3,33.3,0,0,0,2,4,50,0,5,5,3,1,3,0,0,4
474591,527_16_09,SERBIA,22978,14,nikola jokic,22,11,15,73.3,11,14,78.6,0,1,0,1,2,50,2,6,8,6,2,3,1,0,23
474592,527_16_09,SERBIA,5756,15,vladimir stimac,8,2,5,40,2,5,40,0,0,0,0,0,0,3,2,5,0,3,1,0,0,4
474593,527_16_09,SERBIA,25441,24,stefan jovic,24,0,3,0,0,1,0,0,2,0,2,2,100,0,3,3,6,3,1,2,0,2
474594,527_16_09,SERBIA,0,TOTALS,SERBIA,200,37,63,58.7,25,38,65.8,12,25,48,22,26,84.6,9,29,38,37,22,15,9,2,108
474595,527_16_09,PUERTO RICO,23748,1,ramon clemente,18,1,4,25,1,3,33.3,0,1,0,2,2,100,3,0,3,2,1,0,1,0,4
474596,527_16_09,PUERTO RICO,14636,2,guillermo diaz,9,0,1,0,0,1,0,0,0,0,3,4,75,0,0,0,0,1,0,0,0,3
474597,527_16_09,PUERTO RICO,472,5,j.j. barea,27,7,19,36.8,3,11,27.3,4,8,50,4,4,100,0,0,0,2,4,3,1,0,22
474598,527_16_09,PUERTO RICO,100,7,carlos arroyo,30,5,10,50,3,7,42.9,2,3,66.7,2,2,100,1,2,3,6,2,6,0,0,14
474599,527_16_09,PUERTO RICO,3479,8,angel vassallo colon,15,2,6,33.3,0,2,0,2,4,50,0,0,0,2,2,4,3,1,3,0,0,6
474600,527_16_09,PUERTO RICO,8997,10,jorge bryan diaz,22,3,4,75,3,4,75,0,0,0,1,2,50,0,2,2,0,1,0,2,0,7
474601,527_16_09,PUERTO RICO,481,11,ricky sanchez rosa,24,3,6,50,1,2,50,2,4,50,2,2,100,1,2,3,1,4,0,3,0,10
474602,527_16_09,PUERTO RICO,16592,13,renaldo balkman,17,1,3,33.3,1,3,33.3,0,0,0,2,2,100,1,0,1,0,2,1,0,0,4
474603,527_16_09,PUERTO RICO,3478,15,alexander galindo,8,0,1,0,0,0,0,0,1,0,0,0,0,0,2,2,0,3,0,0,0,0
474604,527_16_09,PUERTO RICO,19067,23,john holland,14,1,2,50,1,2,50,0,0,0,0,0,0,1,1,2,1,2,3,2,0,2
474605,527_16_09,PUERTO RICO,7435,33,david huertas,13,1,6,16.7,0,2,0,1,4,25,2,2,100,0,4,4,1,1,1,0,0,5
474606,527_16_09,PUERTO RICO,104,36,peter ramos,3,0,1,0,0,1,0,0,0,0,0,0,0,0,0,0,0,1,1,1,0,0
474607,527_16_09,PUERTO RICO,0,TOTALS,PUERTO RICO,200,24,63,38.1,13,38,34.2,11,25,44,18,20,90,11,17,28,16,24,18,10,0,77
